FIPS,State,County,EmploymentStatus,Year,UnemploymentRate,Employed,TotalLaborForce,Unemployed
0,US,United States,,2007,4.6,145156133,152191050,7034917
0,US,United States,,2008,5.8,144860349,153761037,8900688
0,US,United States,,2009,9.3,139594699,153825454,14230755
0,US,United States,,2010,9.6,139393814,154254521,14860707
0,US,United States,,2011,9,140688861,154520678,13831817
0,US,United States,,2012,8.1,142527201,155038121,12510920
0,US,United States,,2013,7.4,143905037,155362278,11457241
0,US,United States,,2014,6.2,146318952,155936159,9617207
0,US,United States,,2015,5.3,148554918,156840649,8285731
0,US,United States,,2016,4.9,150949349,158674951,7725602
0,US,United States,,2017,4.4,153744181,160744592,7000411
0,US,United States,,2018,3.9,155727518,162039458,6311940
0,US,United States,,2019,3.7,157805900,163815890,6009990
0,US,United States,,2020,8.1,148183367,161207103,13023736
0,US,United States,,2021,5.4,153099687,161758337,8658650
1000,AL,Alabama,,2007,4.1,2092030,2180448,88418
1000,AL,Alabama,,2008,5.8,2049579,2176854,127275
1000,AL,Alabama,,2009,10.1,1938784,2156593,217809
1000,AL,Alabama,,2010,10.4,1968824,2197028,228204
1000,AL,Alabama,,2011,9.6,1991379,2202337,210958
1000,AL,Alabama,,2012,8.2,2000848,2178508,177660
1000,AL,Alabama,,2013,7.3,2012828,2172102,159274
1000,AL,Alabama,,2014,6.7,2018705,2164715,146010
1000,AL,Alabama,,2015,6.1,2020443,2152295,131852
1000,AL,Alabama,,2016,5.9,2029157,2155729,126572
1000,AL,Alabama,,2017,4.5,2103873,2203458,99585
1000,AL,Alabama,,2018,3.9,2153080,2240477,87397
1000,AL,Alabama,,2019,3.2,2199868,2271892,72024
1000,AL,Alabama,,2020,6.5,2121149,2268309,147160
1000,AL,Alabama,,2021,3.4,2169721,2246993,77272
1001,AL,Autauga,,2007,3.4,23610,24434,824
1001,AL,Autauga,,2008,5.3,23376,24687,1311
1001,AL,Autauga,,2009,8.9,22464,24660,2196
1001,AL,Autauga,,2010,8.8,23481,25749,2268
1001,AL,Autauga,,2011,8.3,23688,25845,2157
1001,AL,Autauga,,2012,7.1,23932,25762,1830
1001,AL,Autauga,,2013,6.3,24155,25783,1628
1001,AL,Autauga,,2014,5.8,24150,25639,1489
1001,AL,Autauga,,2015,5.2,24206,25541,1335
1001,AL,Autauga,,2016,5.1,24395,25710,1315
1001,AL,Autauga,,2017,4,25224,26269,1045
1001,AL,Autauga,,2018,3.6,25524,26475,951
1001,AL,Autauga,,2019,2.9,25920,26684,764
1001,AL,Autauga,,2020,5.4,24985,26405,1420
1001,AL,Autauga,,2021,2.8,25599,26341,742
1003,AL,Baldwin,,2007,3.2,80213,82829,2616
1003,AL,Baldwin,,2008,4.8,79222,83205,3983
1003,AL,Baldwin,,2009,8.9,74950,82314,7364
1003,AL,Baldwin,,2010,9.9,75283,83551,8268
1003,AL,Baldwin,,2011,9,77459,85077,7618
1003,AL,Baldwin,,2012,7.7,77973,84507,6534
1003,AL,Baldwin,,2013,6.7,79466,85206,5740
1003,AL,Baldwin,,2014,6.1,81265,86546,5281
1003,AL,Baldwin,,2015,5.6,82619,87493,4874
1003,AL,Baldwin,,2016,5.4,84972,89778,4806
1003,AL,Baldwin,,2017,4.2,89286,93152,3866
1003,AL,Baldwin,,2018,3.6,92769,96252,3483
1003,AL,Baldwin,,2019,2.9,96044,98921,2877
1003,AL,Baldwin,,2020,6.2,92751,98910,6159
1003,AL,Baldwin,,2021,3,96481,99427,2946
1005,AL,Barbour,,2007,6.4,9698,10363,665
1005,AL,Barbour,,2008,9.1,9249,10175,926
1005,AL,Barbour,,2009,13.2,8635,9944,1309
1005,AL,Barbour,,2010,12.1,8978,10219,1241
1005,AL,Barbour,,2011,11.4,8716,9843,1127
1005,AL,Barbour,,2012,11.8,8273,9377,1104
1005,AL,Barbour,,2013,10.4,8152,9096,944
1005,AL,Barbour,,2014,10.5,7930,8859,929
1005,AL,Barbour,,2015,8.9,7823,8590,767
1005,AL,Barbour,,2016,8.4,7638,8334,696
1005,AL,Barbour,,2017,6,7914,8415,501
1005,AL,Barbour,,2018,5.1,8071,8505,434
1005,AL,Barbour,,2019,4,8292,8637,345
1005,AL,Barbour,,2020,7.8,8004,8680,676
1005,AL,Barbour,,2021,5.7,7728,8197,469
1007,AL,Bibb,,2007,4.2,8443,8810,367
1007,AL,Bibb,,2008,6,8225,8751,526
1007,AL,Bibb,,2009,12.2,7637,8696,1059
1007,AL,Bibb,,2010,11.2,7931,8936,1005
1007,AL,Bibb,,2011,10.4,8000,8932,932
1007,AL,Bibb,,2012,8.8,8037,8808,771
1007,AL,Bibb,,2013,8,8000,8699,699
1007,AL,Bibb,,2014,7.2,7959,8573,614
1007,AL,Bibb,,2015,6.7,7983,8552,569
1007,AL,Bibb,,2016,6.5,7986,8539,553
1007,AL,Bibb,,2017,4.5,8261,8648,387
1007,AL,Bibb,,2018,4,8354,8698,344
1007,AL,Bibb,,2019,3.2,8488,8772,284
1007,AL,Bibb,,2020,7.3,8073,8712,639
1007,AL,Bibb,,2021,3.5,8262,8560,298
1009,AL,Blount,,2007,3.2,25816,26683,867
1009,AL,Blount,,2008,4.8,25405,26693,1288
1009,AL,Blount,,2009,9.2,24005,26426,2421
1009,AL,Blount,,2010,9.7,22509,24928,2419
1009,AL,Blount,,2011,8.6,22951,25124,2173
1009,AL,Blount,,2012,7.1,23216,24978,1762
1009,AL,Blount,,2013,6.4,23277,24860,1583
1009,AL,Blount,,2014,6.1,23074,24571,1497
1009,AL,Blount,,2015,5.4,23089,24416,1327
1009,AL,Blount,,2016,5.4,23061,24380,1319
1009,AL,Blount,,2017,4.1,23979,25009,1030
1009,AL,Blount,,2018,3.5,24454,25337,883
1009,AL,Blount,,2019,2.8,24861,25582,721
1009,AL,Blount,,2020,4.6,23973,25116,1143
1009,AL,Blount,,2021,2.4,24529,25127,598
1011,AL,Bullock,,2007,9.6,3313,3666,353
1011,AL,Bullock,,2008,10.9,3244,3641,397
1011,AL,Bullock,,2009,14.4,3179,3713,534
1011,AL,Bullock,,2010,11.7,4365,4941,576
1011,AL,Bullock,,2011,11.5,4274,4829,555
1011,AL,Bullock,,2012,10.6,4240,4742,502
1011,AL,Bullock,,2013,9.5,4322,4774,452
1011,AL,Bullock,,2014,8.8,4323,4738,415
1011,AL,Bullock,,2015,8,4385,4765,380
1011,AL,Bullock,,2016,6.9,4457,4785,328
1011,AL,Bullock,,2017,5,4644,4890,246
1011,AL,Bullock,,2018,4.6,4619,4844,225
1011,AL,Bullock,,2019,3.9,4673,4861,188
1011,AL,Bullock,,2020,6,4582,4877,295
1011,AL,Bullock,,2021,4,4422,4606,184
1013,AL,Butler,,2007,6.3,8551,9124,573
1013,AL,Butler,,2008,8.8,8263,9063,800
1013,AL,Butler,,2009,15.1,7671,9033,1362
1013,AL,Butler,,2010,13.4,8015,9252,1237
1013,AL,Butler,,2011,12.4,8046,9180,1134
1013,AL,Butler,,2012,11.8,8029,9103,1074
1013,AL,Butler,,2013,10.4,8189,9144,955
1013,AL,Butler,,2014,8.5,8496,9285,789
1013,AL,Butler,,2015,7.6,8417,9113,696
1013,AL,Butler,,2016,6.9,8484,9116,632
1013,AL,Butler,,2017,5.6,8536,9046,510
1013,AL,Butler,,2018,4.7,8642,9070,428
1013,AL,Butler,,2019,3.9,8956,9317,361
1013,AL,Butler,,2020,9.6,8345,9236,891
1013,AL,Butler,,2021,5.3,8328,8796,468
1015,AL,Calhoun,,2007,4,52782,54983,2201
1015,AL,Calhoun,,2008,5.9,51371,54574,3203
1015,AL,Calhoun,,2009,10.2,48278,53760,5482
1015,AL,Calhoun,,2010,11.2,45798,51577,5779
1015,AL,Calhoun,,2011,10.3,45986,51271,5285
1015,AL,Calhoun,,2012,9.1,45196,49717,4521
1015,AL,Calhoun,,2013,8.9,44068,48381,4313
1015,AL,Calhoun,,2014,7.9,43562,47321,3759
1015,AL,Calhoun,,2015,7.1,42566,45808,3242
1015,AL,Calhoun,,2016,6.6,42470,45450,2980
1015,AL,Calhoun,,2017,5.1,43960,46304,2344
1015,AL,Calhoun,,2018,4.6,44652,46805,2153
1015,AL,Calhoun,,2019,3.7,45064,46804,1740
1015,AL,Calhoun,,2020,7.8,43367,47022,3655
1015,AL,Calhoun,,2021,4.1,44212,46118,1906
1017,AL,Chambers,,2007,6.6,14489,15517,1028
1017,AL,Chambers,,2008,14.9,12823,15066,2243
1017,AL,Chambers,,2009,18.1,11863,14487,2624
1017,AL,Chambers,,2010,14.6,12581,14734,2153
1017,AL,Chambers,,2011,11.8,13386,15185,1799
1017,AL,Chambers,,2012,10.1,13630,15160,1530
1017,AL,Chambers,,2013,8.1,14028,15263,1235
1017,AL,Chambers,,2014,6.7,14308,15329,1021
1017,AL,Chambers,,2015,6.1,14031,14939,908
1017,AL,Chambers,,2016,5.5,14044,14858,814
1017,AL,Chambers,,2017,4.2,14734,15375,641
1017,AL,Chambers,,2018,3.9,14929,15530,601
1017,AL,Chambers,,2019,3.1,15502,15992,490
1017,AL,Chambers,,2020,7.5,14884,16093,1209
1017,AL,Chambers,,2021,3.7,15173,15752,579
1019,AL,Cherokee,,2007,4.3,11500,12012,512
1019,AL,Cherokee,,2008,5.9,11287,11999,712
1019,AL,Cherokee,,2009,10.7,10460,11715,1255
1019,AL,Cherokee,,2010,10.5,10267,11466,1199
1019,AL,Cherokee,,2011,9.6,10369,11473,1104
1019,AL,Cherokee,,2012,8.2,10350,11278,928
1019,AL,Cherokee,,2013,6.7,10627,11392,765
1019,AL,Cherokee,,2014,5.8,10748,11407,659
1019,AL,Cherokee,,2015,5.5,10521,11132,611
1019,AL,Cherokee,,2016,5.1,10671,11241,570
1019,AL,Cherokee,,2017,4.2,10993,11470,477
1019,AL,Cherokee,,2018,3.5,11394,11813,419
1019,AL,Cherokee,,2019,3,11546,11906,360
1019,AL,Cherokee,,2020,5.1,11073,11672,599
1019,AL,Cherokee,,2021,2.5,11512,11808,296
1021,AL,Chilton,,2007,3.5,19093,19777,684
1021,AL,Chilton,,2008,5.2,18583,19609,1026
1021,AL,Chilton,,2009,9.8,17501,19393,1892
1021,AL,Chilton,,2010,10.1,17502,19474,1972
1021,AL,Chilton,,2011,9.1,17761,19536,1775
1021,AL,Chilton,,2012,7.4,17960,19396,1436
1021,AL,Chilton,,2013,6.7,18052,19339,1287
1021,AL,Chilton,,2014,6.2,17938,19130,1192
1021,AL,Chilton,,2015,5.7,18005,19089,1084
1021,AL,Chilton,,2016,5.5,17982,19029,1047
1021,AL,Chilton,,2017,4.2,18667,19478,811
1021,AL,Chilton,,2018,3.6,19121,19834,713
1021,AL,Chilton,,2019,2.9,19567,20145,578
1021,AL,Chilton,,2020,5.5,18839,19936,1097
1021,AL,Chilton,,2021,2.9,19246,19811,565
1023,AL,Choctaw,,2007,6.1,4882,5197,315
1023,AL,Choctaw,,2008,8.6,4638,5076,438
1023,AL,Choctaw,,2009,12.4,4474,5106,632
1023,AL,Choctaw,,2010,13,4225,4857,632
1023,AL,Choctaw,,2011,13,4140,4760,620
1023,AL,Choctaw,,2012,10.5,4292,4798,506
1023,AL,Choctaw,,2013,9.4,4261,4701,440
1023,AL,Choctaw,,2014,9,4098,4501,403
1023,AL,Choctaw,,2015,9.2,3969,4369,400
1023,AL,Choctaw,,2016,8.5,3926,4292,366
1023,AL,Choctaw,,2017,6.5,4172,4460,288
1023,AL,Choctaw,,2018,5.4,4539,4800,261
1023,AL,Choctaw,,2019,4.9,4490,4722,232
1023,AL,Choctaw,,2020,7.4,4351,4699,348
1023,AL,Choctaw,,2021,4.4,4391,4591,200
1025,AL,Clarke,,2007,6.2,9744,10386,642
1025,AL,Clarke,,2008,9.3,9401,10366,965
1025,AL,Clarke,,2009,15.2,8728,10298,1570
1025,AL,Clarke,,2010,19.5,7316,9088,1772
1025,AL,Clarke,,2011,18.6,7185,8827,1642
1025,AL,Clarke,,2012,15.4,7107,8397,1290
1025,AL,Clarke,,2013,14,7130,8286,1156
1025,AL,Clarke,,2014,12.1,7177,8166,989
1025,AL,Clarke,,2015,11.8,7036,7976,940
1025,AL,Clarke,,2016,10.9,7030,7889,859
1025,AL,Clarke,,2017,8.7,7153,7832,679
1025,AL,Clarke,,2018,7.4,7170,7742,572
1025,AL,Clarke,,2019,6,7251,7715,464
1025,AL,Clarke,,2020,9.9,7116,7899,783
1025,AL,Clarke,,2021,6,7264,7726,462
1027,AL,Clay,,2007,5.6,5784,6130,346
1027,AL,Clay,,2008,8.2,5269,5739,470
1027,AL,Clay,,2009,15.4,4737,5596,859
1027,AL,Clay,,2010,14.2,5016,5844,828
1027,AL,Clay,,2011,11.7,4937,5593,656
1027,AL,Clay,,2012,9.6,4899,5419,520
1027,AL,Clay,,2013,8.5,4933,5390,457
1027,AL,Clay,,2014,7.1,5128,5521,393
1027,AL,Clay,,2015,6.2,5194,5535,341
1027,AL,Clay,,2016,6,5247,5579,332
1027,AL,Clay,,2017,4.4,5603,5863,260
1027,AL,Clay,,2018,3.8,5845,6076,231
1027,AL,Clay,,2019,3.1,5969,6161,192
1027,AL,Clay,,2020,4.5,5865,6140,275
1027,AL,Clay,,2021,2.7,5930,6095,165
1029,AL,Cleburne,,2007,3.7,6255,6497,242
1029,AL,Cleburne,,2008,5.2,6213,6557,344
1029,AL,Cleburne,,2009,9.3,5893,6499,606
1029,AL,Cleburne,,2010,9.8,5441,6035,594
1029,AL,Cleburne,,2011,9.6,5367,5939,572
1029,AL,Cleburne,,2012,8.4,5351,5842,491
1029,AL,Cleburne,,2013,7.8,5372,5825,453
1029,AL,Cleburne,,2014,6.6,5479,5864,385
1029,AL,Cleburne,,2015,6.1,5321,5664,343
1029,AL,Cleburne,,2016,6,5394,5738,344
1029,AL,Cleburne,,2017,4.6,5525,5792,267
1029,AL,Cleburne,,2018,4.2,5610,5857,247
1029,AL,Cleburne,,2019,3.3,5669,5863,194
1029,AL,Cleburne,,2020,5.1,5556,5852,296
1029,AL,Cleburne,,2021,2.6,5739,5890,151
1031,AL,Coffee,,2007,3.9,20304,21124,820
1031,AL,Coffee,,2008,5,19859,20908,1049
1031,AL,Coffee,,2009,7.8,19755,21423,1668
1031,AL,Coffee,,2010,8.5,19313,21099,1786
1031,AL,Coffee,,2011,8.1,19068,20745,1677
1031,AL,Coffee,,2012,7.2,19135,20625,1490
1031,AL,Coffee,,2013,7,19065,20495,1430
1031,AL,Coffee,,2014,6.6,18926,20264,1338
1031,AL,Coffee,,2015,6,19010,20222,1212
1031,AL,Coffee,,2016,5.9,19227,20429,1202
1031,AL,Coffee,,2017,4.5,20179,21128,949
1031,AL,Coffee,,2018,3.9,20403,21233,830
1031,AL,Coffee,,2019,3,21405,22076,671
1031,AL,Coffee,,2020,4.9,20938,22008,1070
1031,AL,Coffee,,2021,2.8,21243,21853,610
1033,AL,Colbert,,2007,4.7,24250,25446,1196
1033,AL,Colbert,,2008,6.7,23478,25171,1693
1033,AL,Colbert,,2009,10.7,22625,25324,2699
1033,AL,Colbert,,2010,11.3,21499,24229,2730
1033,AL,Colbert,,2011,10.1,21915,24385,2470
1033,AL,Colbert,,2012,9,21895,24057,2162
1033,AL,Colbert,,2013,8.3,21891,23879,1988
1033,AL,Colbert,,2014,8.3,22082,24069,1987
1033,AL,Colbert,,2015,8,21673,23550,1877
1033,AL,Colbert,,2016,7,21640,23261,1621
1033,AL,Colbert,,2017,5.3,22273,23525,1252
1033,AL,Colbert,,2018,4.6,22713,23798,1085
1033,AL,Colbert,,2019,3.9,23131,24079,948
1033,AL,Colbert,,2020,7.3,22152,23895,1743
1033,AL,Colbert,,2021,4,22524,23460,936
1035,AL,Conecuh,,2007,6.5,4653,4979,326
1035,AL,Conecuh,,2008,9.7,4413,4886,473
1035,AL,Conecuh,,2009,18.4,3959,4853,894
1035,AL,Conecuh,,2010,16.9,4140,4982,842
1035,AL,Conecuh,,2011,15,4059,4778,719
1035,AL,Conecuh,,2012,12.2,4077,4643,566
1035,AL,Conecuh,,2013,10.9,4183,4694,511
1035,AL,Conecuh,,2014,10.3,4239,4724,485
1035,AL,Conecuh,,2015,9.3,4238,4671,433
1035,AL,Conecuh,,2016,8.4,4131,4512,381
1035,AL,Conecuh,,2017,6.3,4257,4541,284
1035,AL,Conecuh,,2018,5.2,4325,4560,235
1035,AL,Conecuh,,2019,4.2,4380,4570,190
1035,AL,Conecuh,,2020,8,4214,4582,368
1035,AL,Conecuh,,2021,4.8,4164,4376,212
1037,AL,Coosa,,2007,5.9,4421,4698,277
1037,AL,Coosa,,2008,8.5,4266,4664,398
1037,AL,Coosa,,2009,14.8,3884,4557,673
1037,AL,Coosa,,2010,15.1,3946,4648,702
1037,AL,Coosa,,2011,12.3,3920,4472,552
1037,AL,Coosa,,2012,9.6,4025,4451,426
1037,AL,Coosa,,2013,9.3,4036,4449,413
1037,AL,Coosa,,2014,8.8,4082,4474,392
1037,AL,Coosa,,2015,6.7,4119,4416,297
1037,AL,Coosa,,2016,6,4084,4344,260
1037,AL,Coosa,,2017,4.8,4218,4430,212
1037,AL,Coosa,,2018,4.1,4291,4475,184
1037,AL,Coosa,,2019,3.1,4432,4575,143
1037,AL,Coosa,,2020,6.1,4156,4428,272
1037,AL,Coosa,,2021,3.1,4209,4343,134
1039,AL,Covington,,2007,4,16432,17108,676
1039,AL,Covington,,2008,6.1,15773,16805,1032
1039,AL,Covington,,2009,9.9,15021,16672,1651
1039,AL,Covington,,2010,10.2,14753,16428,1675
1039,AL,Covington,,2011,9.8,14772,16372,1600
1039,AL,Covington,,2012,8.6,14960,16364,1404
1039,AL,Covington,,2013,8.2,14737,16055,1318
1039,AL,Covington,,2014,7.7,14706,15940,1234
1039,AL,Covington,,2015,7.2,14314,15422,1108
1039,AL,Covington,,2016,6.8,14325,15366,1041
1039,AL,Covington,,2017,5.3,15054,15901,847
1039,AL,Covington,,2018,4.5,15101,15820,719
1039,AL,Covington,,2019,3.6,15218,15788,570
1039,AL,Covington,,2020,5.5,14500,15342,842
1039,AL,Covington,,2021,3,14756,15215,459
1041,AL,Crenshaw,,2007,4.4,6273,6562,289
1041,AL,Crenshaw,,2008,5.7,6093,6464,371
1041,AL,Crenshaw,,2009,9.6,5810,6424,614
1041,AL,Crenshaw,,2010,10,5658,6290,632
1041,AL,Crenshaw,,2011,9.8,5801,6432,631
1041,AL,Crenshaw,,2012,8.5,5725,6257,532
1041,AL,Crenshaw,,2013,7.8,5817,6306,489
1041,AL,Crenshaw,,2014,6.9,5875,6310,435
1041,AL,Crenshaw,,2015,6,5957,6339,382
1041,AL,Crenshaw,,2016,5.9,6024,6401,377
1041,AL,Crenshaw,,2017,4.6,6177,6477,300
1041,AL,Crenshaw,,2018,4,6177,6436,259
1041,AL,Crenshaw,,2019,3,6340,6534,194
1041,AL,Crenshaw,,2020,6.3,5971,6371,400
1041,AL,Crenshaw,,2021,3.3,5931,6133,202
1043,AL,Cullman,,2007,3.4,38100,39449,1349
1043,AL,Cullman,,2008,5,37118,39092,1974
1043,AL,Cullman,,2009,9.4,34838,38449,3611
1043,AL,Cullman,,2010,10.3,32272,35983,3711
1043,AL,Cullman,,2011,9.5,32295,35673,3378
1043,AL,Cullman,,2012,7.9,32795,35607,2812
1043,AL,Cullman,,2013,6.8,33333,35750,2417
1043,AL,Cullman,,2014,6,33812,35984,2172
1043,AL,Cullman,,2015,5.3,34376,36296,1920
1043,AL,Cullman,,2016,5,35720,37594,1874
1043,AL,Cullman,,2017,3.8,36792,38258,1466
1043,AL,Cullman,,2018,3.3,37263,38519,1256
1043,AL,Cullman,,2019,2.7,38061,39130,1069
1043,AL,Cullman,,2020,4.8,36992,38862,1870
1043,AL,Cullman,,2021,2.4,37943,38858,915
1045,AL,Dale,,2007,4,19477,20295,818
1045,AL,Dale,,2008,5.6,18724,19834,1110
1045,AL,Dale,,2009,8.8,18232,20000,1768
1045,AL,Dale,,2010,8.7,20167,22099,1932
1045,AL,Dale,,2011,8.3,20197,22020,1823
1045,AL,Dale,,2012,7.6,19757,21388,1631
1045,AL,Dale,,2013,7.5,19180,20732,1552
1045,AL,Dale,,2014,7,18919,20351,1432
1045,AL,Dale,,2015,6.4,18524,19789,1265
1045,AL,Dale,,2016,5.8,18648,19796,1148
1045,AL,Dale,,2017,4.6,19243,20166,923
1045,AL,Dale,,2018,4.2,19627,20478,851
1045,AL,Dale,,2019,3.3,20232,20920,688
1045,AL,Dale,,2020,5.4,19793,20928,1135
1045,AL,Dale,,2021,3.1,20257,20915,658
1047,AL,Dallas,,2007,8.5,14279,15605,1326
1047,AL,Dallas,,2008,11.5,13732,15508,1776
1047,AL,Dallas,,2009,19.6,12607,15671,3064
1047,AL,Dallas,,2010,16.6,14839,17782,2943
1047,AL,Dallas,,2011,15,14874,17493,2619
1047,AL,Dallas,,2012,13.2,14565,16780,2215
1047,AL,Dallas,,2013,12.4,14270,16290,2020
1047,AL,Dallas,,2014,11.2,14234,16026,1792
1047,AL,Dallas,,2015,9.6,14056,15555,1499
1047,AL,Dallas,,2016,9.2,13880,15293,1413
1047,AL,Dallas,,2017,7.7,14046,15211,1165
1047,AL,Dallas,,2018,6.4,14073,15043,970
1047,AL,Dallas,,2019,5.7,14044,14897,853
1047,AL,Dallas,,2020,11.8,13091,14836,1745
1047,AL,Dallas,,2021,7.4,12924,13959,1035
1049,AL,DeKalb,,2007,4.4,29731,31084,1353
1049,AL,DeKalb,,2008,6,28841,30689,1848
1049,AL,DeKalb,,2009,13.1,25834,29733,3899
1049,AL,DeKalb,,2010,12.4,27084,30918,3834
1049,AL,DeKalb,,2011,11.7,26292,29778,3486
1049,AL,DeKalb,,2012,9.3,26193,28868,2675
1049,AL,DeKalb,,2013,7.7,26768,29011,2243
1049,AL,DeKalb,,2014,6.8,27014,28997,1983
1049,AL,DeKalb,,2015,6.1,26949,28700,1751
1049,AL,DeKalb,,2016,6.1,27232,28996,1764
1049,AL,DeKalb,,2017,4.6,28541,29915,1374
1049,AL,DeKalb,,2018,3.8,29457,30616,1159
1049,AL,DeKalb,,2019,2.9,30695,31627,932
1049,AL,DeKalb,,2020,5,29721,31289,1568
1049,AL,DeKalb,,2021,2.5,30308,31097,789
1051,AL,Elmore,,2007,3.4,34669,35880,1211
1051,AL,Elmore,,2008,5.3,34306,36219,1913
1051,AL,Elmore,,2009,8.7,33185,36337,3152
1051,AL,Elmore,,2010,9,33435,36732,3297
1051,AL,Elmore,,2011,8.4,33538,36611,3073
1051,AL,Elmore,,2012,7.1,34045,36657,2612
1051,AL,Elmore,,2013,6.2,34585,36888,2303
1051,AL,Elmore,,2014,5.7,34530,36610,2080
1051,AL,Elmore,,2015,5.1,34803,36655,1852
1051,AL,Elmore,,2016,4.8,35161,36921,1760
1051,AL,Elmore,,2017,3.8,36222,37642,1420
1051,AL,Elmore,,2018,3.4,36692,37993,1301
1051,AL,Elmore,,2019,2.7,36767,37806,1039
1051,AL,Elmore,,2020,5.3,35657,37662,2005
1051,AL,Elmore,,2021,2.7,36560,37582,1022
1053,AL,Escambia,,2007,5.4,13549,14324,775
1053,AL,Escambia,,2008,7.8,13295,14424,1129
1053,AL,Escambia,,2009,12.4,12863,14683,1820
1053,AL,Escambia,,2010,11.6,13266,15000,1734
1053,AL,Escambia,,2011,10.7,13361,14967,1606
1053,AL,Escambia,,2012,9.4,13358,14749,1391
1053,AL,Escambia,,2013,8.7,13037,14281,1244
1053,AL,Escambia,,2014,8,13244,14389,1145
1053,AL,Escambia,,2015,7.1,13535,14564,1029
1053,AL,Escambia,,2016,6.7,13472,14433,961
1053,AL,Escambia,,2017,5.1,13868,14613,745
1053,AL,Escambia,,2018,4.5,13924,14581,657
1053,AL,Escambia,,2019,3.7,14293,14843,550
1053,AL,Escambia,,2020,6.8,13611,14604,993
1053,AL,Escambia,,2021,4.1,13425,14000,575
1055,AL,Etowah,,2007,4.6,43491,45565,2074
1055,AL,Etowah,,2008,6.2,42914,45741,2827
1055,AL,Etowah,,2009,10.5,40128,44839,4711
1055,AL,Etowah,,2010,10.8,39278,44018,4740
1055,AL,Etowah,,2011,10,40258,44723,4465
1055,AL,Etowah,,2012,8.5,40540,44283,3743
1055,AL,Etowah,,2013,7.7,40453,43830,3377
1055,AL,Etowah,,2014,7,40729,43798,3069
1055,AL,Etowah,,2015,6.2,39936,42586,2650
1055,AL,Etowah,,2016,5.9,40372,42914,2542
1055,AL,Etowah,,2017,4.7,41517,43562,2045
1055,AL,Etowah,,2018,4.1,41935,43714,1779
1055,AL,Etowah,,2019,3.5,41603,43127,1524
1055,AL,Etowah,,2020,8.5,37912,41417,3505
1055,AL,Etowah,,2021,4.1,37658,39262,1604
1057,AL,Fayette,,2007,4.8,7049,7405,356
1057,AL,Fayette,,2008,7.5,6591,7123,532
1057,AL,Fayette,,2009,12.9,6037,6930,893
1057,AL,Fayette,,2010,12.8,5955,6827,872
1057,AL,Fayette,,2011,11,5899,6627,728
1057,AL,Fayette,,2012,8.8,5936,6511,575
1057,AL,Fayette,,2013,8.4,5862,6401,539
1057,AL,Fayette,,2014,7.8,5863,6359,496
1057,AL,Fayette,,2015,7.1,5954,6406,452
1057,AL,Fayette,,2016,6.8,6100,6542,442
1057,AL,Fayette,,2017,4.8,6309,6629,320
1057,AL,Fayette,,2018,4,6333,6600,267
1057,AL,Fayette,,2019,3.3,6466,6685,219
1057,AL,Fayette,,2020,5.6,6294,6664,370
1057,AL,Fayette,,2021,3.1,6449,6653,204
1059,AL,Franklin,,2007,4.7,13126,13774,648
1059,AL,Franklin,,2008,7.7,12363,13389,1026
1059,AL,Franklin,,2009,12.3,11547,13171,1624
1059,AL,Franklin,,2010,10.5,12752,14252,1500
1059,AL,Franklin,,2011,9.5,12992,14351,1359
1059,AL,Franklin,,2012,8.6,12790,13989,1199
1059,AL,Franklin,,2013,8.2,12552,13668,1116
1059,AL,Franklin,,2014,7.7,12681,13737,1056
1059,AL,Franklin,,2015,6.5,12746,13628,882
1059,AL,Franklin,,2016,5.9,12941,13752,811
1059,AL,Franklin,,2017,4.4,13516,14134,618
1059,AL,Franklin,,2018,3.7,13911,14445,534
1059,AL,Franklin,,2019,2.9,14384,14815,431
1059,AL,Franklin,,2020,5,13844,14567,723
1059,AL,Franklin,,2021,2.5,13941,14304,363
1061,AL,Geneva,,2007,3.5,11153,11559,406
1061,AL,Geneva,,2008,5.7,10697,11338,641
1061,AL,Geneva,,2009,9.9,10043,11143,1100
1061,AL,Geneva,,2010,10.2,10385,11564,1179
1061,AL,Geneva,,2011,9.2,10434,11485,1051
1061,AL,Geneva,,2012,7.8,10408,11283,875
1061,AL,Geneva,,2013,7.1,10255,11035,780
1061,AL,Geneva,,2014,6.7,10093,10813,720
1061,AL,Geneva,,2015,6,10120,10761,641
1061,AL,Geneva,,2016,5.8,10097,10720,623
1061,AL,Geneva,,2017,4.4,10423,10908,485
1061,AL,Geneva,,2018,3.9,10559,10991,432
1061,AL,Geneva,,2019,3.1,10755,11100,345
1061,AL,Geneva,,2020,4.6,10520,11029,509
1061,AL,Geneva,,2021,2.8,10684,10993,309
1063,AL,Greene,,2007,6.5,3080,3293,213
1063,AL,Greene,,2008,8.8,2995,3284,289
1063,AL,Greene,,2009,14.1,2672,3110,438
1063,AL,Greene,,2010,17,2741,3302,561
1063,AL,Greene,,2011,17.1,2669,3220,551
1063,AL,Greene,,2012,13.9,2698,3132,434
1063,AL,Greene,,2013,13,2608,2996,388
1063,AL,Greene,,2014,12.4,2619,2990,371
1063,AL,Greene,,2015,11.1,2552,2872,320
1063,AL,Greene,,2016,10,2564,2848,284
1063,AL,Greene,,2017,7.7,2662,2885,223
1063,AL,Greene,,2018,6.6,2700,2891,191
1063,AL,Greene,,2019,5.9,2765,2937,172
1063,AL,Greene,,2020,11.8,2728,3094,366
1063,AL,Greene,,2021,6.9,2698,2897,199
1065,AL,Hale,,2007,5.5,6611,6994,383
1065,AL,Hale,,2008,7.7,6461,6997,536
1065,AL,Hale,,2009,13.1,5933,6828,895
1065,AL,Hale,,2010,14.8,5485,6439,954
1065,AL,Hale,,2011,13.7,5428,6288,860
1065,AL,Hale,,2012,11.7,5492,6223,731
1065,AL,Hale,,2013,11.8,5475,6206,731
1065,AL,Hale,,2014,9.8,5448,6041,593
1065,AL,Hale,,2015,7.8,5562,6034,472
1065,AL,Hale,,2016,7.7,5478,5933,455
1065,AL,Hale,,2017,6.1,5650,6016,366
1065,AL,Hale,,2018,5,5739,6043,304
1065,AL,Hale,,2019,4.1,5915,6171,256
1065,AL,Hale,,2020,10.3,5529,6165,636
1065,AL,Hale,,2021,5.7,5553,5888,335
1067,AL,Henry,,2007,5.5,7144,7559,415
1067,AL,Henry,,2008,8,6794,7383,589
1067,AL,Henry,,2009,10.3,6380,7109,729
1067,AL,Henry,,2010,10.8,6483,7265,782
1067,AL,Henry,,2011,9.7,6566,7269,703
1067,AL,Henry,,2012,8.5,6439,7037,598
1067,AL,Henry,,2013,7.8,6407,6950,543
1067,AL,Henry,,2014,7.5,6281,6788,507
1067,AL,Henry,,2015,6.8,6243,6702,459
1067,AL,Henry,,2016,6.5,6231,6666,435
1067,AL,Henry,,2017,5,6453,6791,338
1067,AL,Henry,,2018,4.4,6600,6904,304
1067,AL,Henry,,2019,3.8,6725,6990,265
1067,AL,Henry,,2020,5.4,6535,6909,374
1067,AL,Henry,,2021,3.2,6662,6881,219
1069,AL,Houston,,2007,3.4,45671,47278,1607
1069,AL,Houston,,2008,5.1,44096,46447,2351
1069,AL,Houston,,2009,8.5,41941,45841,3900
1069,AL,Houston,,2010,9,42261,46463,4202
1069,AL,Houston,,2011,8.6,42767,46794,4027
1069,AL,Houston,,2012,7.8,42525,46100,3575
1069,AL,Houston,,2013,7,42463,45669,3206
1069,AL,Houston,,2014,6.7,42172,45224,3052
1069,AL,Houston,,2015,6.3,41655,44440,2785
1069,AL,Houston,,2016,5.8,41621,44185,2564
1069,AL,Houston,,2017,4.5,43200,45221,2021
1069,AL,Houston,,2018,4,44221,46072,1851
1069,AL,Houston,,2019,3.2,45523,47014,1491
1069,AL,Houston,,2020,6,44396,47221,2825
1069,AL,Houston,,2021,3.4,45286,46880,1594
1071,AL,Jackson,,2007,4.6,25835,27084,1249
1071,AL,Jackson,,2008,6.4,25153,26866,1713
1071,AL,Jackson,,2009,11.7,23173,26247,3074
1071,AL,Jackson,,2010,11.6,21514,24347,2833
1071,AL,Jackson,,2011,10.2,21692,24160,2468
1071,AL,Jackson,,2012,8.8,21669,23760,2091
1071,AL,Jackson,,2013,8,21776,23669,1893
1071,AL,Jackson,,2014,7.2,21792,23489,1697
1071,AL,Jackson,,2015,6.7,21840,23407,1567
1071,AL,Jackson,,2016,6.3,21911,23390,1479
1071,AL,Jackson,,2017,4.9,22231,23377,1146
1071,AL,Jackson,,2018,4.1,22702,23665,963
1071,AL,Jackson,,2019,3.5,22867,23691,824
1071,AL,Jackson,,2020,5.9,21727,23091,1364
1071,AL,Jackson,,2021,2.9,22316,22975,659
1073,AL,Jefferson,,2007,3.9,303023,315430,12407
1073,AL,Jefferson,,2008,5.6,294233,311643,17410
1073,AL,Jefferson,,2009,9.9,276008,306180,30172
1073,AL,Jefferson,,2010,10.2,286248,318651,32403
1073,AL,Jefferson,,2011,9.2,290057,319586,29529
1073,AL,Jefferson,,2012,7.6,292662,316771,24109
1073,AL,Jefferson,,2013,6.8,293809,315102,21293
1073,AL,Jefferson,,2014,6.3,293144,312706,19562
1073,AL,Jefferson,,2015,5.8,292165,310158,17993
1073,AL,Jefferson,,2016,5.7,290887,308632,17745
1073,AL,Jefferson,,2017,4.4,300153,313828,13675
1073,AL,Jefferson,,2018,3.7,307423,319219,11796
1073,AL,Jefferson,,2019,3,311970,321691,9721
1073,AL,Jefferson,,2020,6.9,298447,320394,21947
1073,AL,Jefferson,,2021,3.6,305782,317359,11577
1075,AL,Lamar,,2007,6.4,5496,5871,375
1075,AL,Lamar,,2008,8.3,5227,5698,471
1075,AL,Lamar,,2009,14.7,4692,5503,811
1075,AL,Lamar,,2010,13,5046,5797,751
1075,AL,Lamar,,2011,9.6,5262,5821,559
1075,AL,Lamar,,2012,7.7,5363,5810,447
1075,AL,Lamar,,2013,7.1,5383,5795,412
1075,AL,Lamar,,2014,6.9,5244,5634,390
1075,AL,Lamar,,2015,6.4,5246,5602,356
1075,AL,Lamar,,2016,5.7,5324,5643,319
1075,AL,Lamar,,2017,4.3,5558,5807,249
1075,AL,Lamar,,2018,3.8,5586,5805,219
1075,AL,Lamar,,2019,3.2,5700,5891,191
1075,AL,Lamar,,2020,5.4,5474,5788,314
1075,AL,Lamar,,2021,3,5521,5691,170
1077,AL,Lauderdale,,2007,4.4,41447,43357,1910
1077,AL,Lauderdale,,2008,5.9,40330,42878,2548
1077,AL,Lauderdale,,2009,9.8,39087,43319,4232
1077,AL,Lauderdale,,2010,10,39278,43622,4344
1077,AL,Lauderdale,,2011,9.1,40045,44046,4001
1077,AL,Lauderdale,,2012,7.9,40035,43451,3416
1077,AL,Lauderdale,,2013,7.2,39999,43109,3110
1077,AL,Lauderdale,,2014,7.2,40434,43551,3117
1077,AL,Lauderdale,,2015,7,39577,42544,2967
1077,AL,Lauderdale,,2016,6.4,39490,42180,2690
1077,AL,Lauderdale,,2017,4.7,40520,42539,2019
1077,AL,Lauderdale,,2018,4.2,41068,42848,1780
1077,AL,Lauderdale,,2019,3.5,41623,43111,1488
1077,AL,Lauderdale,,2020,6.2,40026,42649,2623
1077,AL,Lauderdale,,2021,3.2,40745,42080,1335
1079,AL,Lawrence,,2007,4.2,15181,15843,662
1079,AL,Lawrence,,2008,6.7,14809,15874,1065
1079,AL,Lawrence,,2009,12.5,13734,15702,1968
1079,AL,Lawrence,,2010,12.4,13052,14892,1840
1079,AL,Lawrence,,2011,10.8,13183,14775,1592
1079,AL,Lawrence,,2012,9.2,13078,14408,1330
1079,AL,Lawrence,,2013,8.5,13066,14273,1207
1079,AL,Lawrence,,2014,8.2,12896,14046,1150
1079,AL,Lawrence,,2015,7.8,12582,13642,1060
1079,AL,Lawrence,,2016,6.9,12665,13607,942
1079,AL,Lawrence,,2017,5,13099,13795,696
1079,AL,Lawrence,,2018,4.1,13610,14196,586
1079,AL,Lawrence,,2019,3.3,13973,14452,479
1079,AL,Lawrence,,2020,5.5,13736,14528,792
1079,AL,Lawrence,,2021,2.9,13956,14378,422
1081,AL,Lee,,2007,3.7,63037,65467,2430
1081,AL,Lee,,2008,5.4,61678,65191,3513
1081,AL,Lee,,2009,8.6,59215,64799,5584
1081,AL,Lee,,2010,8.9,60891,66841,5950
1081,AL,Lee,,2011,8,62842,68331,5489
1081,AL,Lee,,2012,7,64169,68967,4798
1081,AL,Lee,,2013,6,66242,70447,4205
1081,AL,Lee,,2014,5.6,67506,71478,3972
1081,AL,Lee,,2015,5.3,66958,70690,3732
1081,AL,Lee,,2016,5.2,67995,71759,3764
1081,AL,Lee,,2017,4.1,71292,74311,3019
1081,AL,Lee,,2018,3.6,73298,76047,2749
1081,AL,Lee,,2019,2.9,75315,77544,2229
1081,AL,Lee,,2020,5.8,72090,76533,4443
1081,AL,Lee,,2021,2.8,74478,76658,2180
1083,AL,Limestone,,2007,3.4,35171,36415,1244
1083,AL,Limestone,,2008,4.9,35596,37419,1823
1083,AL,Limestone,,2009,9,34795,38219,3424
1083,AL,Limestone,,2010,9.5,34700,38356,3656
1083,AL,Limestone,,2011,8.6,35648,38994,3346
1083,AL,Limestone,,2012,7,36267,39017,2750
1083,AL,Limestone,,2013,6.3,36891,39391,2500
1083,AL,Limestone,,2014,6.1,37244,39648,2404
1083,AL,Limestone,,2015,5.5,37653,39848,2195
1083,AL,Limestone,,2016,5.3,38229,40349,2120
1083,AL,Limestone,,2017,4.1,40275,42005,1730
1083,AL,Limestone,,2018,3.5,41904,43437,1533
1083,AL,Limestone,,2019,2.8,43686,44948,1262
1083,AL,Limestone,,2020,4.7,43726,45890,2164
1083,AL,Limestone,,2021,2.5,45430,46572,1142
1085,AL,Lowndes,,2007,7.7,4406,4772,366
1085,AL,Lowndes,,2008,11.3,4313,4861,548
1085,AL,Lowndes,,2009,17.8,3999,4867,868
1085,AL,Lowndes,,2010,18.1,3555,4342,787
1085,AL,Lowndes,,2011,17.5,3491,4233,742
1085,AL,Lowndes,,2012,15.8,3448,4093,645
1085,AL,Lowndes,,2013,14.3,3436,4010,574
1085,AL,Lowndes,,2014,12.8,3384,3879,495
1085,AL,Lowndes,,2015,11.6,3376,3819,443
1085,AL,Lowndes,,2016,10.6,3371,3770,399
1085,AL,Lowndes,,2017,8.4,3393,3704,311
1085,AL,Lowndes,,2018,7.3,3389,3654,265
1085,AL,Lowndes,,2019,6,3342,3557,215
1085,AL,Lowndes,,2020,14.5,3182,3723,541
1085,AL,Lowndes,,2021,9.2,3248,3578,330
1087,AL,Macon,,2007,5.5,8397,8888,491
1087,AL,Macon,,2008,7.7,8410,9112,702
1087,AL,Macon,,2009,11.2,8263,9308,1045
1087,AL,Macon,,2010,14.5,7635,8928,1293
1087,AL,Macon,,2011,13.9,7321,8502,1181
1087,AL,Macon,,2012,11,7388,8299,911
1087,AL,Macon,,2013,9.8,7587,8410,823
1087,AL,Macon,,2014,9.1,7502,8250,748
1087,AL,Macon,,2015,8.1,7307,7951,644
1087,AL,Macon,,2016,7.6,7208,7803,595
1087,AL,Macon,,2017,5.9,7508,7979,471
1087,AL,Macon,,2018,5.4,7520,7947,427
1087,AL,Macon,,2019,4.4,7627,7982,355
1087,AL,Macon,,2020,10.5,7327,8186,859
1087,AL,Macon,,2021,6,7471,7948,477
1089,AL,Madison,,2007,3.1,160439,165619,5180
1089,AL,Madison,,2008,4.3,161020,168276,7256
1089,AL,Madison,,2009,7.4,156443,168854,12411
1089,AL,Madison,,2010,8.2,155994,169944,13950
1089,AL,Madison,,2011,8.2,157588,171679,14091
1089,AL,Madison,,2012,7.1,158207,170324,12117
1089,AL,Madison,,2013,6.4,160213,171178,10965
1089,AL,Madison,,2014,6.1,159923,170377,10454
1089,AL,Madison,,2015,5.5,161071,170473,9402
1089,AL,Madison,,2016,5.1,163288,172125,8837
1089,AL,Madison,,2017,4,170808,177879,7071
1089,AL,Madison,,2018,3.4,177181,183502,6321
1089,AL,Madison,,2019,2.7,182655,187759,5104
1089,AL,Madison,,2020,5.1,179871,189632,9761
1089,AL,Madison,,2021,2.7,187100,192204,5104
1091,AL,Marengo,,2007,5.4,7728,8170,442
1091,AL,Marengo,,2008,7.7,7374,7985,611
1091,AL,Marengo,,2009,13.1,7000,8052,1052
1091,AL,Marengo,,2010,13.5,7036,8130,1094
1091,AL,Marengo,,2011,12.4,6888,7867,979
1091,AL,Marengo,,2012,10.4,6865,7661,796
1091,AL,Marengo,,2013,9,6940,7628,688
1091,AL,Marengo,,2014,7.9,7031,7636,605
1091,AL,Marengo,,2015,7.7,6820,7387,567
1091,AL,Marengo,,2016,7.2,7063,7608,545
1091,AL,Marengo,,2017,5.7,7338,7785,447
1091,AL,Marengo,,2018,4.9,7313,7691,378
1091,AL,Marengo,,2019,3.7,7513,7802,289
1091,AL,Marengo,,2020,6.9,7319,7864,545
1091,AL,Marengo,,2021,4.2,7384,7709,325
1093,AL,Marion,,2007,5.3,12314,13007,693
1093,AL,Marion,,2008,8.2,11679,12727,1048
1093,AL,Marion,,2009,15.3,10386,12259,1873
1093,AL,Marion,,2010,13.3,11448,13203,1755
1093,AL,Marion,,2011,11.1,11155,12546,1391
1093,AL,Marion,,2012,9.1,11326,12465,1139
1093,AL,Marion,,2013,8,11475,12477,1002
1093,AL,Marion,,2014,7.9,11342,12311,969
1093,AL,Marion,,2015,7,11583,12453,870
1093,AL,Marion,,2016,6.6,11572,12394,822
1093,AL,Marion,,2017,4.9,12041,12663,622
1093,AL,Marion,,2018,4,12241,12757,516
1093,AL,Marion,,2019,3.7,12472,12948,476
1093,AL,Marion,,2020,5.6,12545,13291,746
1093,AL,Marion,,2021,2.8,12941,13320,379
1095,AL,Marshall,,2007,3.5,39946,41398,1452
1095,AL,Marshall,,2008,4.9,39645,41694,2049
1095,AL,Marshall,,2009,9.3,36871,40653,3782
1095,AL,Marshall,,2010,9.5,37721,41688,3967
1095,AL,Marshall,,2011,9.4,37235,41097,3862
1095,AL,Marshall,,2012,8,37477,40730,3253
1095,AL,Marshall,,2013,6.9,37762,40573,2811
1095,AL,Marshall,,2014,6.6,37321,39974,2653
1095,AL,Marshall,,2015,5.8,37944,40290,2346
1095,AL,Marshall,,2016,5.3,39034,41240,2206
1095,AL,Marshall,,2017,3.9,40878,42557,1679
1095,AL,Marshall,,2018,3.4,41930,43385,1455
1095,AL,Marshall,,2019,2.6,43565,44730,1165
1095,AL,Marshall,,2020,4.7,42700,44783,2083
1095,AL,Marshall,,2021,2.4,43644,44714,1070
1097,AL,Mobile,,2007,4.1,177341,184901,7560
1097,AL,Mobile,,2008,5.9,176287,187300,11013
1097,AL,Mobile,,2009,10.4,166932,186230,19298
1097,AL,Mobile,,2010,11.1,171314,192800,21486
1097,AL,Mobile,,2011,10.7,173055,193845,20790
1097,AL,Mobile,,2012,9.4,171102,188890,17788
1097,AL,Mobile,,2013,8.7,170729,186932,16203
1097,AL,Mobile,,2014,7.7,171332,185640,14308
1097,AL,Mobile,,2015,6.9,173586,186483,12897
1097,AL,Mobile,,2016,6.6,173856,186230,12374
1097,AL,Mobile,,2017,5.3,178966,189017,10051
1097,AL,Mobile,,2018,4.6,182174,191050,8876
1097,AL,Mobile,,2019,3.9,184234,191722,7488
1097,AL,Mobile,,2020,8.7,178158,195089,16931
1097,AL,Mobile,,2021,4.7,182672,191711,9039
1099,AL,Monroe,,2007,6.6,8381,8971,590
1099,AL,Monroe,,2008,10.5,7881,8806,925
1099,AL,Monroe,,2009,18,7029,8573,1544
1099,AL,Monroe,,2010,17.8,7147,8694,1547
1099,AL,Monroe,,2011,15.5,7020,8312,1292
1099,AL,Monroe,,2012,12.8,6963,7988,1025
1099,AL,Monroe,,2013,12,6829,7764,935
1099,AL,Monroe,,2014,11,6787,7625,838
1099,AL,Monroe,,2015,10.1,6583,7324,741
1099,AL,Monroe,,2016,9.1,6596,7255,659
1099,AL,Monroe,,2017,6.9,6800,7302,502
1099,AL,Monroe,,2018,6.1,6823,7265,442
1099,AL,Monroe,,2019,5.1,7064,7440,376
1099,AL,Monroe,,2020,9,6943,7626,683
1099,AL,Monroe,,2021,5.6,6942,7356,414
1101,AL,Montgomery,,2007,4.2,101939,106395,4456
1101,AL,Montgomery,,2008,6.1,99685,106185,6500
1101,AL,Montgomery,,2009,9.6,94765,104848,10083
1101,AL,Montgomery,,2010,9.9,98105,108868,10763
1101,AL,Montgomery,,2011,9.7,98539,109098,10559
1101,AL,Montgomery,,2012,8.3,98546,107436,8890
1101,AL,Montgomery,,2013,7.4,98405,106274,7869
1101,AL,Montgomery,,2014,6.8,98012,105193,7181
1101,AL,Montgomery,,2015,6.1,98376,104799,6423
1101,AL,Montgomery,,2016,5.7,98929,104883,5954
1101,AL,Montgomery,,2017,4.4,102209,106956,4747
1101,AL,Montgomery,,2018,4,102844,107096,4252
1101,AL,Montgomery,,2019,3.2,104224,107721,3497
1101,AL,Montgomery,,2020,8.6,99047,108329,9282
1101,AL,Montgomery,,2021,4.9,101486,106663,5177
1103,AL,Morgan,,2007,3.6,54729,56760,2031
1103,AL,Morgan,,2008,5.4,53912,56997,3085
1103,AL,Morgan,,2009,9.9,50661,56231,5570
1103,AL,Morgan,,2010,10.6,51711,57844,6133
1103,AL,Morgan,,2011,9.4,52836,58319,5483
1103,AL,Morgan,,2012,8,52866,57472,4606
1103,AL,Morgan,,2013,7,52979,56951,3972
1103,AL,Morgan,,2014,6.6,52450,56135,3685
1103,AL,Morgan,,2015,5.9,51538,54782,3244
1103,AL,Morgan,,2016,5.5,51395,54413,3018
1103,AL,Morgan,,2017,4.2,53328,55665,2337
1103,AL,Morgan,,2018,3.5,55769,57773,2004
1103,AL,Morgan,,2019,2.7,57574,59179,1605
1103,AL,Morgan,,2020,5,56771,59737,2966
1103,AL,Morgan,,2021,2.6,57716,59256,1540
1105,AL,Perry,,2007,8.6,3248,3554,306
1105,AL,Perry,,2008,11.7,3180,3600,420
1105,AL,Perry,,2009,18.4,3043,3727,684
1105,AL,Perry,,2010,16.5,3243,3885,642
1105,AL,Perry,,2011,16.3,3229,3860,631
1105,AL,Perry,,2012,13.6,3188,3691,503
1105,AL,Perry,,2013,13.7,3077,3566,489
1105,AL,Perry,,2014,12,3073,3494,421
1105,AL,Perry,,2015,10,3129,3478,349
1105,AL,Perry,,2016,10.3,3083,3438,355
1105,AL,Perry,,2017,8,3202,3479,277
1105,AL,Perry,,2018,6.5,3225,3448,223
1105,AL,Perry,,2019,5.5,3248,3436,188
1105,AL,Perry,,2020,12,3038,3452,414
1105,AL,Perry,,2021,8.3,2948,3215,267
1107,AL,Pickens,,2007,5.1,7624,8034,410
1107,AL,Pickens,,2008,7.4,7345,7931,586
1107,AL,Pickens,,2009,12.6,6992,7997,1005
1107,AL,Pickens,,2010,12.9,6701,7696,995
1107,AL,Pickens,,2011,11.9,6666,7564,898
1107,AL,Pickens,,2012,10.4,6701,7477,776
1107,AL,Pickens,,2013,9.5,6713,7415,702
1107,AL,Pickens,,2014,8.1,7139,7770,631
1107,AL,Pickens,,2015,6.8,7445,7987,542
1107,AL,Pickens,,2016,6.9,7172,7702,530
1107,AL,Pickens,,2017,5.5,7380,7808,428
1107,AL,Pickens,,2018,4.6,7472,7829,357
1107,AL,Pickens,,2019,3.7,7732,8028,296
1107,AL,Pickens,,2020,7.3,7128,7688,560
1107,AL,Pickens,,2021,4.1,7194,7501,307
1109,AL,Pike,,2007,4.1,14967,15609,642
1109,AL,Pike,,2008,5,15005,15803,798
1109,AL,Pike,,2009,8.7,14404,15777,1373
1109,AL,Pike,,2010,9.4,14229,15698,1469
1109,AL,Pike,,2011,8.9,14077,15447,1370
1109,AL,Pike,,2012,8.2,13802,15034,1232
1109,AL,Pike,,2013,7.8,13755,14911,1156
1109,AL,Pike,,2014,7.3,13877,14975,1098
1109,AL,Pike,,2015,6.6,13918,14904,986
1109,AL,Pike,,2016,6.5,13860,14825,965
1109,AL,Pike,,2017,5,14700,15469,769
1109,AL,Pike,,2018,4.5,14731,15424,693
1109,AL,Pike,,2019,3.4,15033,15570,537
1109,AL,Pike,,2020,5.5,14976,15841,865
1109,AL,Pike,,2021,3.2,15504,16017,513
1111,AL,Randolph,,2007,5.2,9017,9510,493
1111,AL,Randolph,,2008,7.6,8888,9616,728
1111,AL,Randolph,,2009,13.7,8072,9354,1282
1111,AL,Randolph,,2010,13.1,8428,9701,1273
1111,AL,Randolph,,2011,11.3,8378,9440,1062
1111,AL,Randolph,,2012,9.4,8294,9154,860
1111,AL,Randolph,,2013,7.9,8480,9205,725
1111,AL,Randolph,,2014,6.7,8669,9291,622
1111,AL,Randolph,,2015,5.9,8852,9410,558
1111,AL,Randolph,,2016,5.6,8827,9350,523
1111,AL,Randolph,,2017,4.5,9163,9594,431
1111,AL,Randolph,,2018,4,9299,9685,386
1111,AL,Randolph,,2019,3.2,9333,9644,311
1111,AL,Randolph,,2020,5.3,9063,9570,507
1111,AL,Randolph,,2021,2.7,9150,9408,258
1113,AL,Russell,,2007,6.2,20442,21792,1350
1113,AL,Russell,,2008,8.3,19921,21717,1796
1113,AL,Russell,,2009,11.3,19041,21477,2436
1113,AL,Russell,,2010,10.7,21271,23828,2557
1113,AL,Russell,,2011,10.2,22088,24601,2513
1113,AL,Russell,,2012,9,22697,24945,2248
1113,AL,Russell,,2013,7.4,23160,24999,1839
1113,AL,Russell,,2014,6.5,23197,24812,1615
1113,AL,Russell,,2015,6,22614,24051,1437
1113,AL,Russell,,2016,5.6,22038,23338,1300
1113,AL,Russell,,2017,4.4,22613,23660,1047
1113,AL,Russell,,2018,4,23308,24279,971
1113,AL,Russell,,2019,3.1,23324,24075,751
1113,AL,Russell,,2020,5.8,22447,23819,1372
1113,AL,Russell,,2021,3.1,22566,23281,715
1115,AL,St. Clair,,2007,3.5,34862,36117,1255
1115,AL,St. Clair,,2008,5.2,34586,36480,1894
1115,AL,St. Clair,,2009,10,33003,36664,3661
1115,AL,St. Clair,,2010,10,34472,38296,3824
1115,AL,St. Clair,,2011,8.7,35152,38508,3356
1115,AL,St. Clair,,2012,7,35827,38544,2717
1115,AL,St. Clair,,2013,6.2,36379,38792,2413
1115,AL,St. Clair,,2014,5.7,36367,38577,2210
1115,AL,St. Clair,,2015,5.2,36452,38470,2018
1115,AL,St. Clair,,2016,5.2,36745,38757,2012
1115,AL,St. Clair,,2017,4.1,38024,39635,1611
1115,AL,St. Clair,,2018,3.5,39146,40548,1402
1115,AL,St. Clair,,2019,2.8,40148,41322,1174
1115,AL,St. Clair,,2020,5.4,39149,41389,2240
1115,AL,St. Clair,,2021,2.6,40108,41195,1087
1117,AL,Shelby,,2007,2.7,97177,99839,2662
1117,AL,Shelby,,2008,3.9,97190,101102,3912
1117,AL,Shelby,,2009,7.1,92685,99778,7093
1117,AL,Shelby,,2010,7,95317,102466,7149
1117,AL,Shelby,,2011,6.2,97774,104209,6435
1117,AL,Shelby,,2012,5.2,100036,105474,5438
1117,AL,Shelby,,2013,4.7,101840,106861,5021
1117,AL,Shelby,,2014,4.5,102624,107413,4789
1117,AL,Shelby,,2015,4.2,103362,107932,4570
1117,AL,Shelby,,2016,4.3,103986,108670,4684
1117,AL,Shelby,,2017,3.3,108871,112591,3720
1117,AL,Shelby,,2018,2.8,112588,115854,3266
1117,AL,Shelby,,2019,2.3,115441,118169,2728
1117,AL,Shelby,,2020,4.2,112894,117880,4986
1117,AL,Shelby,,2021,2.1,115683,118212,2529
1119,AL,Sumter,,2007,6.7,4472,4791,319
1119,AL,Sumter,,2008,9.1,4300,4728,428
1119,AL,Sumter,,2009,13.7,4081,4730,649
1119,AL,Sumter,,2010,13.1,5018,5774,756
1119,AL,Sumter,,2011,13,4832,5555,723
1119,AL,Sumter,,2012,10.7,4842,5425,583
1119,AL,Sumter,,2013,9.2,4959,5459,500
1119,AL,Sumter,,2014,8.4,4927,5381,454
1119,AL,Sumter,,2015,8,4687,5096,409
1119,AL,Sumter,,2016,7.7,4678,5069,391
1119,AL,Sumter,,2017,6.7,4689,5026,337
1119,AL,Sumter,,2018,5.8,4591,4873,282
1119,AL,Sumter,,2019,4.8,4601,4832,231
1119,AL,Sumter,,2020,7.7,4410,4780,370
1119,AL,Sumter,,2021,4.5,4317,4520,203
1121,AL,Talladega,,2007,5.3,36949,39019,2070
1121,AL,Talladega,,2008,7.5,35452,38306,2854
1121,AL,Talladega,,2009,13.2,32583,37552,4969
1121,AL,Talladega,,2010,13.2,30455,35097,4642
1121,AL,Talladega,,2011,11.5,31207,35260,4053
1121,AL,Talladega,,2012,9.6,31693,35056,3363
1121,AL,Talladega,,2013,8.7,32632,35747,3115
1121,AL,Talladega,,2014,7.7,32710,35445,2735
1121,AL,Talladega,,2015,6.6,32736,35052,2316
1121,AL,Talladega,,2016,6.6,32244,34528,2284
1121,AL,Talladega,,2017,5.1,33254,35049,1795
1121,AL,Talladega,,2018,4.2,34201,35714,1513
1121,AL,Talladega,,2019,3.6,34912,36213,1301
1121,AL,Talladega,,2020,7.8,33605,36433,2828
1121,AL,Talladega,,2021,4.1,34215,35695,1480
1123,AL,Tallapoosa,,2007,5.4,17364,18357,993
1123,AL,Tallapoosa,,2008,7.4,16843,18192,1349
1123,AL,Tallapoosa,,2009,12.5,15801,18055,2254
1123,AL,Tallapoosa,,2010,12.9,16615,19075,2460
1123,AL,Tallapoosa,,2011,11.3,16274,18350,2076
1123,AL,Tallapoosa,,2012,8.8,16830,18461,1631
1123,AL,Tallapoosa,,2013,8.2,16874,18384,1510
1123,AL,Tallapoosa,,2014,7.5,17072,18448,1376
1123,AL,Tallapoosa,,2015,6.1,17550,18696,1146
1123,AL,Tallapoosa,,2016,5.6,17396,18426,1030
1123,AL,Tallapoosa,,2017,4.3,17618,18411,793
1123,AL,Tallapoosa,,2018,4.1,17406,18153,747
1123,AL,Tallapoosa,,2019,3.2,18145,18737,592
1123,AL,Tallapoosa,,2020,7.6,16822,18204,1382
1123,AL,Tallapoosa,,2021,4,17186,17910,724
1125,AL,Tuscaloosa,,2007,3.4,86200,89193,2993
1125,AL,Tuscaloosa,,2008,4.9,84817,89168,4351
1125,AL,Tuscaloosa,,2009,9.3,80625,88900,8275
1125,AL,Tuscaloosa,,2010,9.1,85458,94028,8570
1125,AL,Tuscaloosa,,2011,8.3,87574,95489,7915
1125,AL,Tuscaloosa,,2012,7.2,88575,95418,6843
1125,AL,Tuscaloosa,,2013,6.5,89414,95579,6165
1125,AL,Tuscaloosa,,2014,5.9,91523,97230,5707
1125,AL,Tuscaloosa,,2015,5.5,93229,98625,5396
1125,AL,Tuscaloosa,,2016,5.7,92864,98431,5567
1125,AL,Tuscaloosa,,2017,4.3,96711,101014,4303
1125,AL,Tuscaloosa,,2018,3.6,99857,103605,3748
1125,AL,Tuscaloosa,,2019,2.8,103529,106555,3026
1125,AL,Tuscaloosa,,2020,7.3,96225,103776,7551
1125,AL,Tuscaloosa,,2021,3.6,97442,101104,3662
1127,AL,Walker,,2007,4.4,27839,29122,1283
1127,AL,Walker,,2008,5.9,27062,28764,1702
1127,AL,Walker,,2009,10.7,25092,28095,3003
1127,AL,Walker,,2010,12.5,23867,27274,3407
1127,AL,Walker,,2011,11.2,24045,27076,3031
1127,AL,Walker,,2012,9.4,24107,26608,2501
1127,AL,Walker,,2013,8.6,24086,26347,2261
1127,AL,Walker,,2014,7.9,23766,25796,2030
1127,AL,Walker,,2015,7.3,23650,25503,1853
1127,AL,Walker,,2016,7.5,23465,25356,1891
1127,AL,Walker,,2017,5.2,23891,25189,1298
1127,AL,Walker,,2018,4.2,24330,25401,1071
1127,AL,Walker,,2019,3.5,24653,25542,889
1127,AL,Walker,,2020,6.5,23583,25210,1627
1127,AL,Walker,,2021,3.6,24174,25085,911
1129,AL,Washington,,2007,6.1,6595,7020,425
1129,AL,Washington,,2008,8.7,6290,6891,601
1129,AL,Washington,,2009,13.9,5933,6889,956
1129,AL,Washington,,2010,13.9,6348,7377,1029
1129,AL,Washington,,2011,14.4,6073,7097,1024
1129,AL,Washington,,2012,12.2,6046,6887,841
1129,AL,Washington,,2013,11,5972,6711,739
1129,AL,Washington,,2014,9.5,6028,6664,636
1129,AL,Washington,,2015,9,6086,6685,599
1129,AL,Washington,,2016,8.6,6109,6686,577
1129,AL,Washington,,2017,6.9,6304,6772,468
1129,AL,Washington,,2018,5.8,6392,6783,391
1129,AL,Washington,,2019,4.9,6474,6808,334
1129,AL,Washington,,2020,8.9,6219,6823,604
1129,AL,Washington,,2021,4.7,6233,6538,305
1131,AL,Wilcox,,2007,9.9,3110,3450,340
1131,AL,Wilcox,,2008,14.4,2990,3493,503
1131,AL,Wilcox,,2009,24.2,2717,3586,869
1131,AL,Wilcox,,2010,25.8,2266,3054,788
1131,AL,Wilcox,,2011,22.9,2290,2971,681
1131,AL,Wilcox,,2012,20.4,2305,2894,589
1131,AL,Wilcox,,2013,19.5,2239,2782,543
1131,AL,Wilcox,,2014,16.8,2385,2868,483
1131,AL,Wilcox,,2015,14.7,2404,2819,415
1131,AL,Wilcox,,2016,14.5,2391,2795,404
1131,AL,Wilcox,,2017,11.7,2507,2838,331
1131,AL,Wilcox,,2018,9.4,2524,2787,263
1131,AL,Wilcox,,2019,7.5,2547,2753,206
1131,AL,Wilcox,,2020,16.2,2449,2921,472
1131,AL,Wilcox,,2021,11,2353,2644,291
1133,AL,Winston,,2007,5.7,9725,10313,588
1133,AL,Winston,,2008,8.9,9103,9995,892
1133,AL,Winston,,2009,16.4,7890,9433,1543
1133,AL,Winston,,2010,15.7,8322,9868,1546
1133,AL,Winston,,2011,13.4,8496,9806,1310
1133,AL,Winston,,2012,10.2,8637,9621,984
1133,AL,Winston,,2013,9.5,8719,9638,919
1133,AL,Winston,,2014,8.6,8822,9647,825
1133,AL,Winston,,2015,7.6,8645,9354,709
1133,AL,Winston,,2016,7.1,8783,9455,672
1133,AL,Winston,,2017,5.1,9301,9806,505
1133,AL,Winston,,2018,4.2,9503,9916,413
1133,AL,Winston,,2019,3.5,9922,10280,358
1133,AL,Winston,,2020,5.2,9734,10271,537
1133,AL,Winston,,2021,2.8,9830,10110,280
2000,AK,Alaska,,2007,6.3,328309,350233,21924
2000,AK,Alaska,,2008,6.5,332364,355298,22934
2000,AK,Alaska,,2009,8,330718,359379,28661
2000,AK,Alaska,,2010,8.2,332185,361707,29522
2000,AK,Alaska,,2011,7.8,336312,364599,28287
2000,AK,Alaska,,2012,7.2,337834,364153,26319
2000,AK,Alaska,,2013,7,338104,363544,25440
2000,AK,Alaska,,2014,6.7,339704,364281,24577
2000,AK,Alaska,,2015,6.3,339604,362425,22821
2000,AK,Alaska,,2016,6.6,338193,362017,23824
2000,AK,Alaska,,2017,6.5,337108,360589,23481
2000,AK,Alaska,,2018,6,334241,355452,21211
2000,AK,Alaska,,2019,5.5,333541,352883,19342
2000,AK,Alaska,,2020,8.2,318279,346883,28604
2000,AK,Alaska,,2021,6.4,332266,354936,22670
2013,AK,Aleutians East,,2007,7.8,1006,1091,85
2013,AK,Aleutians East,,2008,8.4,1045,1141,96
2013,AK,Aleutians East,,2009,10.2,1018,1133,115
2013,AK,Aleutians East,,2010,5.8,1910,2028,118
2013,AK,Aleutians East,,2011,6.3,2036,2174,138
2013,AK,Aleutians East,,2012,6.9,1983,2130,147
2013,AK,Aleutians East,,2013,6.1,2073,2207,134
2013,AK,Aleutians East,,2014,4.4,2121,2219,98
2013,AK,Aleutians East,,2015,3.1,2395,2472,77
2013,AK,Aleutians East,,2016,2.5,2523,2589,66
2013,AK,Aleutians East,,2017,2.3,2485,2544,59
2013,AK,Aleutians East,,2018,2.8,2251,2316,65
2013,AK,Aleutians East,,2019,2.3,2493,2552,59
2013,AK,Aleutians East,,2020,4.1,2411,2515,104
2013,AK,Aleutians East,,2021,2.3,2499,2558,59
2016,AK,Aleutians West,,2007,5.4,2915,3081,166
2016,AK,Aleutians West,,2008,5.6,2883,3055,172
2016,AK,Aleutians West,,2009,7.2,2785,3002,217
2016,AK,Aleutians West,,2010,5.2,3742,3949,207
2016,AK,Aleutians West,,2011,6,3985,4238,253
2016,AK,Aleutians West,,2012,7,3953,4252,299
2016,AK,Aleutians West,,2013,6.9,3957,4252,295
2016,AK,Aleutians West,,2014,4.7,4253,4464,211
2016,AK,Aleutians West,,2015,3.7,3908,4060,152
2016,AK,Aleutians West,,2016,3.2,3856,3982,126
2016,AK,Aleutians West,,2017,3.4,3616,3745,129
2016,AK,Aleutians West,,2018,3.2,3523,3639,116
2016,AK,Aleutians West,,2019,3.1,3531,3645,114
2016,AK,Aleutians West,,2020,4.7,3655,3835,180
2016,AK,Aleutians West,,2021,3.6,3494,3625,131
2020,AK,Anchorage,,2007,5,143224,150839,7615
2020,AK,Anchorage,,2008,5.2,143873,151840,7967
2020,AK,Anchorage,,2009,6.7,143338,153655,10317
2020,AK,Anchorage,,2010,6.8,146993,157743,10750
2020,AK,Anchorage,,2011,6.1,148731,158382,9651
2020,AK,Anchorage,,2012,5.4,149177,157748,8571
2020,AK,Anchorage,,2013,5.2,149423,157637,8214
2020,AK,Anchorage,,2014,5.1,149591,157650,8059
2020,AK,Anchorage,,2015,4.9,148856,156476,7620
2020,AK,Anchorage,,2016,5.3,147254,155471,8217
2020,AK,Anchorage,,2017,5.4,145406,153774,8368
2020,AK,Anchorage,,2018,5,143226,150745,7519
2020,AK,Anchorage,,2019,4.5,141968,148655,6687
2020,AK,Anchorage,,2020,7.8,135682,147223,11541
2020,AK,Anchorage,,2021,5.8,141539,150276,8737
2050,AK,Bethel,,2007,12.7,6057,6935,878
2050,AK,Bethel,,2008,13.4,5973,6900,927
2050,AK,Bethel,,2009,14.5,6019,7039,1020
2050,AK,Bethel,,2010,15.1,6091,7174,1083
2050,AK,Bethel,,2011,15.3,6104,7208,1104
2050,AK,Bethel,,2012,15.6,6074,7193,1119
2050,AK,Bethel,,2013,16.2,6193,7390,1197
2050,AK,Bethel,,2014,15.8,6120,7270,1150
2050,AK,Bethel,,2015,13.9,6304,7325,1021
2050,AK,Bethel,,2016,13.7,6230,7219,989
2050,AK,Bethel,,2017,12.7,6393,7323,930
2050,AK,Bethel,,2018,11.8,6290,7131,841
2050,AK,Bethel,,2019,11.7,6260,7086,826
2050,AK,Bethel,,2020,12.2,6136,6987,851
2050,AK,Bethel,,2021,13.1,6046,6956,910
2060,AK,Bristol Bay,,2007,4.7,1012,1062,50
2060,AK,Bristol Bay,,2008,4.7,959,1006,47
2060,AK,Bristol Bay,,2009,4.9,992,1043,51
2060,AK,Bristol Bay,,2010,10.1,454,505,51
2060,AK,Bristol Bay,,2011,9.1,469,516,47
2060,AK,Bristol Bay,,2012,10,431,479,48
2060,AK,Bristol Bay,,2013,9,445,489,44
2060,AK,Bristol Bay,,2014,7.9,456,495,39
2060,AK,Bristol Bay,,2015,8.9,346,380,34
2060,AK,Bristol Bay,,2016,6.8,385,413,28
2060,AK,Bristol Bay,,2017,5.9,396,421,25
2060,AK,Bristol Bay,,2018,5.6,423,448,25
2060,AK,Bristol Bay,,2019,5.3,425,449,24
2060,AK,Bristol Bay,,2020,7.9,362,393,31
2060,AK,Bristol Bay,,2021,5.6,424,449,25
2063,AK,Chugach,,2020,8.6,2972,3251,279
2063,AK,Chugach,,2021,6.7,3182,3412,230
2066,AK,Copper River,,2020,10.6,1153,1290,137
2066,AK,Copper River,,2021,8.9,1235,1356,121
2068,AK,Denali,,2007,6.1,1499,1597,98
2068,AK,Denali,,2008,5.9,1507,1601,94
2068,AK,Denali,,2009,8.5,1291,1411,120
2068,AK,Denali,,2010,12.3,888,1013,125
2068,AK,Denali,,2011,14,874,1016,142
2068,AK,Denali,,2012,13.9,898,1043,145
2068,AK,Denali,,2013,12.6,937,1072,135
2068,AK,Denali,,2014,10.2,959,1068,109
2068,AK,Denali,,2015,8.4,976,1066,90
2068,AK,Denali,,2016,8.7,996,1091,95
2068,AK,Denali,,2017,8.5,1049,1146,97
2068,AK,Denali,,2018,7.2,987,1064,77
2068,AK,Denali,,2019,7.5,1017,1099,82
2068,AK,Denali,,2020,17.2,534,645,111
2068,AK,Denali,,2021,10.1,769,855,86
2070,AK,Dillingham,,2007,9,1856,2040,184
2070,AK,Dillingham,,2008,9,1875,2061,186
2070,AK,Dillingham,,2009,10.5,1927,2152,225
2070,AK,Dillingham,,2010,10.5,1871,2090,219
2070,AK,Dillingham,,2011,10.8,1873,2100,227
2070,AK,Dillingham,,2012,10,1911,2124,213
2070,AK,Dillingham,,2013,10.2,1906,2123,217
2070,AK,Dillingham,,2014,9.9,1902,2111,209
2070,AK,Dillingham,,2015,9.3,1843,2033,190
2070,AK,Dillingham,,2016,9.3,1881,2073,192
2070,AK,Dillingham,,2017,8.4,1877,2049,172
2070,AK,Dillingham,,2018,7.4,1868,2017,149
2070,AK,Dillingham,,2019,7.2,1840,1982,142
2070,AK,Dillingham,,2020,8.8,1570,1721,151
2070,AK,Dillingham,,2021,8.2,1569,1709,140
2090,AK,Fairbanks North Star,,2007,5.5,42824,45319,2495
2090,AK,Fairbanks North Star,,2008,5.9,43209,45900,2691
2090,AK,Fairbanks North Star,,2009,7.3,42618,45971,3353
2090,AK,Fairbanks North Star,,2010,6.9,44917,48234,3317
2090,AK,Fairbanks North Star,,2011,6.6,44992,48167,3175
2090,AK,Fairbanks North Star,,2012,6.2,45047,48009,2962
2090,AK,Fairbanks North Star,,2013,5.9,44292,47057,2765
2090,AK,Fairbanks North Star,,2014,5.7,44016,46662,2646
2090,AK,Fairbanks North Star,,2015,5.3,43862,46308,2446
2090,AK,Fairbanks North Star,,2016,5.6,43824,46443,2619
2090,AK,Fairbanks North Star,,2017,5.7,43775,46422,2647
2090,AK,Fairbanks North Star,,2018,5.2,43466,45865,2399
2090,AK,Fairbanks North Star,,2019,4.8,43216,45374,2158
2090,AK,Fairbanks North Star,,2020,6.7,41628,44597,2969
2090,AK,Fairbanks North Star,,2021,5,43099,45375,2276
2100,AK,Haines,,2007,7.3,1337,1443,106
2100,AK,Haines,,2008,8.6,1238,1354,116
2100,AK,Haines,,2009,9.3,1284,1416,132
2100,AK,Haines,,2010,11,1024,1151,127
2100,AK,Haines,,2011,10.2,1044,1163,119
2100,AK,Haines,,2012,10.1,992,1104,112
2100,AK,Haines,,2013,10.1,1021,1136,115
2100,AK,Haines,,2014,10.6,991,1108,117
2100,AK,Haines,,2015,9.5,980,1083,103
2100,AK,Haines,,2016,9.8,966,1071,105
2100,AK,Haines,,2017,8.3,990,1080,90
2100,AK,Haines,,2018,8.8,1005,1102,97
2100,AK,Haines,,2019,8.1,1039,1131,92
2100,AK,Haines,,2020,16.4,854,1021,167
2100,AK,Haines,,2021,11.3,908,1024,116
2105,AK,Hoonah-Angoon,,2010,14.5,912,1067,155
2105,AK,Hoonah-Angoon,,2011,15.4,928,1097,169
2105,AK,Hoonah-Angoon,,2012,14.6,945,1106,161
2105,AK,Hoonah-Angoon,,2013,14.7,954,1119,165
2105,AK,Hoonah-Angoon,,2014,14.9,965,1134,169
2105,AK,Hoonah-Angoon,,2015,14.7,962,1128,166
2105,AK,Hoonah-Angoon,,2016,11.3,1064,1200,136
2105,AK,Hoonah-Angoon,,2017,11.5,1006,1137,131
2105,AK,Hoonah-Angoon,,2018,11.5,1017,1149,132
2105,AK,Hoonah-Angoon,,2019,10.2,1070,1191,121
2105,AK,Hoonah-Angoon,,2020,13.9,908,1055,147
2105,AK,Hoonah-Angoon,,2021,9.3,1049,1156,107
2110,AK,Juneau ,,2007,4.5,17611,18433,822
2110,AK,Juneau ,,2008,4.6,17886,18755,869
2110,AK,Juneau ,,2009,6.1,17253,18369,1116
2110,AK,Juneau ,,2010,6.1,16787,17880,1093
2110,AK,Juneau ,,2011,5.7,16821,17833,1012
2110,AK,Juneau ,,2012,5.2,16909,17831,922
2110,AK,Juneau ,,2013,5.1,16619,17504,885
2110,AK,Juneau ,,2014,5,16548,17412,864
2110,AK,Juneau ,,2015,4.6,16283,17060,777
2110,AK,Juneau ,,2016,4.3,16599,17343,744
2110,AK,Juneau ,,2017,4.3,16547,17292,745
2110,AK,Juneau ,,2018,4,16520,17208,688
2110,AK,Juneau ,,2019,4,16565,17249,684
2110,AK,Juneau ,,2020,7,15168,16306,1138
2110,AK,Juneau ,,2021,4.7,15940,16734,794
2122,AK,Kenai Peninsula,,2007,7.8,23653,25654,2001
2122,AK,Kenai Peninsula,,2008,7.9,24180,26253,2073
2122,AK,Kenai Peninsula,,2009,10.1,24189,26907,2718
2122,AK,Kenai Peninsula,,2010,10.3,24220,27009,2789
2122,AK,Kenai Peninsula,,2011,9.7,24538,27184,2646
2122,AK,Kenai Peninsula,,2012,8.8,24881,27270,2389
2122,AK,Kenai Peninsula,,2013,8.1,25463,27699,2236
2122,AK,Kenai Peninsula,,2014,7.7,25712,27867,2155
2122,AK,Kenai Peninsula,,2015,7.6,25470,27557,2087
2122,AK,Kenai Peninsula,,2016,8.2,24906,27123,2217
2122,AK,Kenai Peninsula,,2017,7.7,24745,26823,2078
2122,AK,Kenai Peninsula,,2018,7,24703,26557,1854
2122,AK,Kenai Peninsula,,2019,6.1,24857,26483,1626
2122,AK,Kenai Peninsula,,2020,9.5,24098,26625,2527
2122,AK,Kenai Peninsula,,2021,7.3,25911,27945,2034
2130,AK,Ketchikan Gateway,,2007,5.6,7749,8208,459
2130,AK,Ketchikan Gateway,,2008,5.7,7807,8281,474
2130,AK,Ketchikan Gateway,,2009,7.3,7713,8324,611
2130,AK,Ketchikan Gateway,,2010,9.1,6477,7122,645
2130,AK,Ketchikan Gateway,,2011,8.8,6523,7155,632
2130,AK,Ketchikan Gateway,,2012,8.3,6561,7151,590
2130,AK,Ketchikan Gateway,,2013,7.9,6572,7132,560
2130,AK,Ketchikan Gateway,,2014,7.7,6535,7083,548
2130,AK,Ketchikan Gateway,,2015,6.7,6482,6944,462
2130,AK,Ketchikan Gateway,,2016,6.2,6581,7019,438
2130,AK,Ketchikan Gateway,,2017,5.8,6686,7094,408
2130,AK,Ketchikan Gateway,,2018,5.5,6641,7027,386
2130,AK,Ketchikan Gateway,,2019,5.6,6614,7004,390
2130,AK,Ketchikan Gateway,,2020,10.2,5823,6481,658
2130,AK,Ketchikan Gateway,,2021,7.4,6118,6604,486
2150,AK,Kodiak Island,,2007,6.2,5751,6132,381
2150,AK,Kodiak Island,,2008,6.6,5963,6386,423
2150,AK,Kodiak Island,,2009,7.4,6112,6598,486
2150,AK,Kodiak Island,,2010,7.6,5971,6465,494
2150,AK,Kodiak Island,,2011,7.6,6246,6757,511
2150,AK,Kodiak Island,,2012,6.8,6237,6691,454
2150,AK,Kodiak Island,,2013,6.2,6153,6563,410
2150,AK,Kodiak Island,,2014,5.6,6197,6563,366
2150,AK,Kodiak Island,,2015,4.7,6300,6608,308
2150,AK,Kodiak Island,,2016,4.9,6101,6418,317
2150,AK,Kodiak Island,,2017,4.7,6025,6320,295
2150,AK,Kodiak Island,,2018,5.4,5820,6150,330
2150,AK,Kodiak Island,,2019,5,5674,5971,297
2150,AK,Kodiak Island,,2020,6.6,5666,6068,402
2150,AK,Kodiak Island,,2021,6.4,5629,6015,386
2158,AK,Kusilvak,,2007,20.2,2056,2576,520
2158,AK,Kusilvak,,2008,19.9,2079,2597,518
2158,AK,Kusilvak,,2009,21.3,2128,2705,577
2158,AK,Kusilvak,,2010,21,2107,2668,561
2158,AK,Kusilvak,,2011,21.5,2165,2758,593
2158,AK,Kusilvak,,2012,22.4,2146,2764,618
2158,AK,Kusilvak,,2013,23.7,2114,2771,657
2158,AK,Kusilvak,,2014,23.5,2152,2812,660
2158,AK,Kusilvak,,2015,22.5,2160,2787,627
2158,AK,Kusilvak,,2016,20.8,2142,2706,564
2158,AK,Kusilvak,,2017,18.6,2227,2735,508
2158,AK,Kusilvak,,2018,18.3,2188,2678,490
2158,AK,Kusilvak,,2019,17.8,2178,2650,472
2158,AK,Kusilvak,,2020,20.6,1817,2288,471
2158,AK,Kusilvak,,2021,19.9,1880,2347,467
2164,AK,Lake and Peninsula,,2007,5.4,1101,1164,63
2164,AK,Lake and Peninsula,,2008,6.6,1059,1134,75
2164,AK,Lake and Peninsula,,2009,8.4,997,1088,91
2164,AK,Lake and Peninsula,,2010,14.9,515,605,90
2164,AK,Lake and Peninsula,,2011,15.4,539,637,98
2164,AK,Lake and Peninsula,,2012,15.4,537,635,98
2164,AK,Lake and Peninsula,,2013,15.6,536,635,99
2164,AK,Lake and Peninsula,,2014,16.1,538,641,103
2164,AK,Lake and Peninsula,,2015,12.1,565,643,78
2164,AK,Lake and Peninsula,,2016,11.9,575,653,78
2164,AK,Lake and Peninsula,,2017,11,637,716,79
2164,AK,Lake and Peninsula,,2018,10.2,668,744,76
2164,AK,Lake and Peninsula,,2019,9,645,709,64
2164,AK,Lake and Peninsula,,2020,11.4,543,613,70
2164,AK,Lake and Peninsula,,2021,8.9,591,649,58
2170,AK,Matanuska-Susitna,,2007,7.1,36906,39736,2830
2170,AK,Matanuska-Susitna,,2008,7.3,38382,41424,3042
2170,AK,Matanuska-Susitna,,2009,9.1,38588,42473,3885
2170,AK,Matanuska-Susitna,,2010,9.8,38178,42324,4146
2170,AK,Matanuska-Susitna,,2011,9.4,39177,43238,4061
2170,AK,Matanuska-Susitna,,2012,8.8,39776,43610,3834
2170,AK,Matanuska-Susitna,,2013,8.4,40053,43718,3665
2170,AK,Matanuska-Susitna,,2014,7.9,41199,44744,3545
2170,AK,Matanuska-Susitna,,2015,7.4,42633,46057,3424
2170,AK,Matanuska-Susitna,,2016,7.9,43613,47353,3740
2170,AK,Matanuska-Susitna,,2017,7.7,44526,48262,3736
2170,AK,Matanuska-Susitna,,2018,6.9,44766,48071,3305
2170,AK,Matanuska-Susitna,,2019,6.2,45267,48235,2968
2170,AK,Matanuska-Susitna,,2020,8.7,44183,48388,4205
2170,AK,Matanuska-Susitna,,2021,6.8,46130,49487,3357
2180,AK,Nome,,2007,11,3372,3788,416
2180,AK,Nome,,2008,10,3578,3976,398
2180,AK,Nome,,2009,12,3494,3970,476
2180,AK,Nome,,2010,13,3582,4115,533
2180,AK,Nome,,2011,12.6,3599,4117,518
2180,AK,Nome,,2012,11.8,3673,4166,493
2180,AK,Nome,,2013,12.4,3613,4123,510
2180,AK,Nome,,2014,12.1,3610,4107,497
2180,AK,Nome,,2015,11.5,3596,4065,469
2180,AK,Nome,,2016,12.2,3574,4072,498
2180,AK,Nome,,2017,11.4,3626,4091,465
2180,AK,Nome,,2018,10.5,3670,4099,429
2180,AK,Nome,,2019,9.9,3624,4024,400
2180,AK,Nome,,2020,10.9,3508,3939,431
2180,AK,Nome,,2021,9.7,3693,4088,395
2185,AK,North Slope,,2007,5.3,4417,4666,249
2185,AK,North Slope,,2008,4.1,4928,5138,210
2185,AK,North Slope,,2009,4.9,5037,5295,258
2185,AK,North Slope,,2010,8.3,3635,3965,330
2185,AK,North Slope,,2011,7.8,3670,3980,310
2185,AK,North Slope,,2012,7.9,3697,4012,315
2185,AK,North Slope,,2013,7.4,3753,4052,299
2185,AK,North Slope,,2014,5.9,4084,4338,254
2185,AK,North Slope,,2015,5.5,4059,4296,237
2185,AK,North Slope,,2016,6.5,3694,3951,257
2185,AK,North Slope,,2017,6.9,3348,3598,250
2185,AK,North Slope,,2018,6.3,3198,3413,215
2185,AK,North Slope,,2019,5.7,3348,3552,204
2185,AK,North Slope,,2020,6.1,2971,3164,193
2185,AK,North Slope,,2021,6.3,2733,2918,185
2188,AK,Northwest Arctic,,2007,10.7,2644,2962,318
2188,AK,Northwest Arctic,,2008,11.2,2637,2969,332
2188,AK,Northwest Arctic,,2009,12.2,2623,2989,366
2188,AK,Northwest Arctic,,2010,13.9,2551,2962,411
2188,AK,Northwest Arctic,,2011,15.8,2510,2980,470
2188,AK,Northwest Arctic,,2012,15.9,2542,3024,482
2188,AK,Northwest Arctic,,2013,16.5,2551,3054,503
2188,AK,Northwest Arctic,,2014,16.8,2490,2991,501
2188,AK,Northwest Arctic,,2015,15.5,2444,2893,449
2188,AK,Northwest Arctic,,2016,15.4,2496,2950,454
2188,AK,Northwest Arctic,,2017,15.2,2496,2945,449
2188,AK,Northwest Arctic,,2018,12.7,2552,2923,371
2188,AK,Northwest Arctic,,2019,12.8,2533,2904,371
2188,AK,Northwest Arctic,,2020,12.6,2570,2941,371
2188,AK,Northwest Arctic,,2021,11.5,2578,2914,336
2195,AK,Petersburg,,2010,8.2,1692,1844,152
2195,AK,Petersburg,,2011,8.5,1691,1849,158
2195,AK,Petersburg,,2012,8.2,1716,1870,154
2195,AK,Petersburg,,2013,8.7,1507,1650,143
2195,AK,Petersburg,,2014,9.3,1430,1577,147
2195,AK,Petersburg,,2015,8.7,1361,1490,129
2195,AK,Petersburg,,2016,8.6,1322,1447,125
2195,AK,Petersburg,,2017,8.6,1292,1414,122
2195,AK,Petersburg,,2018,7.9,1277,1387,110
2195,AK,Petersburg,,2019,7.9,1299,1410,111
2195,AK,Petersburg,,2020,9,1301,1430,129
2195,AK,Petersburg,,2021,7,1508,1621,113
2198,AK,Prince of Wales-Hyder,,2010,10.9,2267,2544,277
2198,AK,Prince of Wales-Hyder,,2011,12.6,2241,2565,324
2198,AK,Prince of Wales-Hyder,,2012,13.4,2236,2583,347
2198,AK,Prince of Wales-Hyder,,2013,12.3,2456,2799,343
2198,AK,Prince of Wales-Hyder,,2014,13.2,2453,2825,372
2198,AK,Prince of Wales-Hyder,,2015,12.2,2415,2750,335
2198,AK,Prince of Wales-Hyder,,2016,11.7,2437,2760,323
2198,AK,Prince of Wales-Hyder,,2017,10.4,2547,2843,296
2198,AK,Prince of Wales-Hyder,,2018,9.8,2601,2885,284
2198,AK,Prince of Wales-Hyder,,2019,9.1,2622,2884,262
2198,AK,Prince of Wales-Hyder,,2020,9.7,2558,2833,275
2198,AK,Prince of Wales-Hyder,,2021,8,2605,2832,227
2201,AK,Prince of Wales-Outer Ketchikan,,2007,13.4,1964,2269,305
2201,AK,Prince of Wales-Outer Ketchikan,,2008,13.4,2016,2327,311
2201,AK,Prince of Wales-Outer Ketchikan,,2009,15.7,2015,2389,374
2220,AK,Sitka ,,2007,5.1,4394,4628,234
2220,AK,Sitka ,,2008,5.6,4354,4612,258
2220,AK,Sitka ,,2009,6.4,4343,4641,298
2220,AK,Sitka ,,2010,6.5,4258,4556,298
2220,AK,Sitka ,,2011,6.2,4323,4611,288
2220,AK,Sitka ,,2012,5.7,4362,4627,265
2220,AK,Sitka ,,2013,5.5,4348,4601,253
2220,AK,Sitka ,,2014,5,4435,4669,234
2220,AK,Sitka ,,2015,4.4,4387,4591,204
2220,AK,Sitka ,,2016,4.4,4179,4373,194
2220,AK,Sitka ,,2017,4.2,4260,4448,188
2220,AK,Sitka ,,2018,3.8,4206,4370,164
2220,AK,Sitka ,,2019,3.7,4242,4404,162
2220,AK,Sitka ,,2020,7.3,3822,4121,299
2220,AK,Sitka ,,2021,4.5,4295,4496,201
2230,AK,Skagway,,2010,15,611,719,108
2230,AK,Skagway,,2011,16.5,596,714,118
2230,AK,Skagway,,2012,14.2,645,752,107
2230,AK,Skagway,,2013,12.4,692,790,98
2230,AK,Skagway,,2014,11.7,708,802,94
2230,AK,Skagway,,2015,11.1,718,808,90
2230,AK,Skagway,,2016,10.7,717,803,86
2230,AK,Skagway,,2017,9.7,747,827,80
2230,AK,Skagway,,2018,8.8,761,834,73
2230,AK,Skagway,,2019,9,712,782,70
2230,AK,Skagway,,2020,21.5,503,641,138
2230,AK,Skagway,,2021,14.2,533,621,88
2232,AK,Skagway-Hoonah-Angoon,,2007,12.3,1683,1920,237
2232,AK,Skagway-Hoonah-Angoon,,2008,12.5,1673,1912,239
2232,AK,Skagway-Hoonah-Angoon,,2009,15.1,1527,1798,271
2240,AK,Southeast Fairbanks,,2007,8.6,3243,3548,305
2240,AK,Southeast Fairbanks,,2008,8.5,3242,3544,302
2240,AK,Southeast Fairbanks,,2009,9.9,3254,3612,358
2240,AK,Southeast Fairbanks,,2010,12.3,2806,3200,394
2240,AK,Southeast Fairbanks,,2011,12.7,2789,3194,405
2240,AK,Southeast Fairbanks,,2012,13,2634,3029,395
2240,AK,Southeast Fairbanks,,2013,13.2,2604,2999,395
2240,AK,Southeast Fairbanks,,2014,13,2530,2908,378
2240,AK,Southeast Fairbanks,,2015,10.3,2688,2997,309
2240,AK,Southeast Fairbanks,,2016,10.3,2681,2990,309
2240,AK,Southeast Fairbanks,,2017,9.6,2650,2932,282
2240,AK,Southeast Fairbanks,,2018,8.8,2682,2942,260
2240,AK,Southeast Fairbanks,,2019,8,2642,2872,230
2240,AK,Southeast Fairbanks,,2020,7.7,2719,2945,226
2240,AK,Southeast Fairbanks,,2021,6.6,3007,3219,212
2261,AK,Valdez-Cordova,,2007,8.4,4773,5208,435
2261,AK,Valdez-Cordova,,2008,8.1,4816,5243,427
2261,AK,Valdez-Cordova,,2009,8.7,4872,5338,466
2261,AK,Valdez-Cordova,,2010,9.7,4403,4876,473
2261,AK,Valdez-Cordova,,2011,10.1,4423,4921,498
2261,AK,Valdez-Cordova,,2012,9.8,4397,4877,480
2261,AK,Valdez-Cordova,,2013,10,4421,4910,489
2261,AK,Valdez-Cordova,,2014,9.5,4404,4865,461
2261,AK,Valdez-Cordova,,2015,8.4,4456,4864,408
2261,AK,Valdez-Cordova,,2016,8.2,4406,4802,396
2261,AK,Valdez-Cordova,,2017,7.2,4518,4870,352
2261,AK,Valdez-Cordova,,2018,6.7,4536,4862,326
2261,AK,Valdez-Cordova,,2019,6.8,4535,4865,330
2275,AK,Wrangell ,,2010,8.4,942,1028,86
2275,AK,Wrangell ,,2011,7.7,967,1048,81
2275,AK,Wrangell ,,2012,8.3,937,1022,85
2275,AK,Wrangell ,,2013,8.1,969,1054,85
2275,AK,Wrangell ,,2014,8.2,970,1057,87
2275,AK,Wrangell ,,2015,7.6,950,1028,78
2275,AK,Wrangell ,,2016,7.2,977,1053,76
2275,AK,Wrangell ,,2017,7.2,973,1048,75
2275,AK,Wrangell ,,2018,6.3,975,1041,66
2275,AK,Wrangell ,,2019,6.8,961,1031,70
2275,AK,Wrangell ,,2020,9.2,867,955,88
2275,AK,Wrangell ,,2021,7.5,875,946,71
2280,AK,Wrangell-Petersburg,,2007,9.5,2595,2868,273
2280,AK,Wrangell-Petersburg,,2008,10.3,2513,2802,289
2280,AK,Wrangell-Petersburg,,2009,10.7,2563,2870,307
2282,AK,Yakutat ,,2007,6.8,286,307,21
2282,AK,Yakutat ,,2008,7.2,296,319,23
2282,AK,Yakutat ,,2009,11.8,277,314,37
2282,AK,Yakutat ,,2010,11.1,264,297,33
2282,AK,Yakutat ,,2011,11,267,300,33
2282,AK,Yakutat ,,2012,9.8,259,287,28
2282,AK,Yakutat ,,2013,9.5,257,284,27
2282,AK,Yakutat ,,2014,9.9,246,273,27
2282,AK,Yakutat ,,2015,8.5,237,259,22
2282,AK,Yakutat ,,2016,8.2,224,244,20
2282,AK,Yakutat ,,2017,8.6,213,233,20
2282,AK,Yakutat ,,2018,7.3,229,247,18
2282,AK,Yakutat ,,2019,6.8,234,251,17
2282,AK,Yakutat ,,2020,8.6,255,279,24
2282,AK,Yakutat ,,2021,7.1,286,308,22
2290,AK,Yukon-Koyukuk,,2007,13.6,2380,2756,376
2290,AK,Yukon-Koyukuk,,2008,13.6,2393,2771,378
2290,AK,Yukon-Koyukuk,,2009,14.4,2463,2879,416
2290,AK,Yukon-Koyukuk,,2010,17.8,2117,2575,458
2290,AK,Yukon-Koyukuk,,2011,18.8,2196,2703,507
2290,AK,Yukon-Koyukuk,,2012,17.6,2280,2766,486
2290,AK,Yukon-Koyukuk,,2013,18.4,2223,2723,500
2290,AK,Yukon-Koyukuk,,2014,18.7,2091,2571,480
2290,AK,Yukon-Koyukuk,,2015,17.8,1968,2395,427
2290,AK,Yukon-Koyukuk,,2016,17.2,1994,2408,414
2290,AK,Yukon-Koyukuk,,2017,16.6,2051,2459,408
2290,AK,Yukon-Koyukuk,,2018,13.6,2194,2539,345
2290,AK,Yukon-Koyukuk,,2019,12.8,2129,2441,312
2290,AK,Yukon-Koyukuk,,2020,12.6,2041,2334,293
2290,AK,Yukon-Koyukuk,,2021,12.4,2138,2441,303
4000,AZ,Arizona,,2007,3.8,2905144,3018805,113661
4000,AZ,Arizona,,2008,5.8,2916698,3095993,179295
4000,AZ,Arizona,,2009,9.7,2826426,3128891,302465
4000,AZ,Arizona,,2010,10.3,2777404,3096316,318912
4000,AZ,Arizona,,2011,9.4,2763761,3051937,288176
4000,AZ,Arizona,,2012,8.3,2799634,3054343,254709
4000,AZ,Arizona,,2013,7.8,2825341,3064554,239213
4000,AZ,Arizona,,2014,6.8,2906193,3118441,212248
4000,AZ,Arizona,,2015,6.1,2990545,3184445,193900
4000,AZ,Arizona,,2016,5.5,3075851,3253468,177617
4000,AZ,Arizona,,2017,5,3079700,3240111,160411
4000,AZ,Arizona,,2018,4.8,3168469,3328189,159720
4000,AZ,Arizona,,2019,4.9,3265925,3432476,166551
4000,AZ,Arizona,,2020,7.7,3191100,3456852,265752
4000,AZ,Arizona,,2021,4.9,3346319,3518425,172106
4001,AZ,Apache,,2007,8.6,18351,20077,1726
4001,AZ,Apache,,2008,11,18810,21131,2321
4001,AZ,Apache,,2009,15.4,19380,22905,3525
4001,AZ,Apache,,2010,16.3,19645,23475,3830
4001,AZ,Apache,,2011,18.3,18893,23137,4244
4001,AZ,Apache,,2012,19,18637,23001,4364
4001,AZ,Apache,,2013,18.5,18009,22104,4095
4001,AZ,Apache,,2014,15.7,17994,21345,3351
4001,AZ,Apache,,2015,13.3,17966,20730,2764
4001,AZ,Apache,,2016,11.6,18042,20418,2376
4001,AZ,Apache,,2017,10.4,17808,19884,2076
4001,AZ,Apache,,2018,9.9,17963,19935,1972
4001,AZ,Apache,,2019,10,17823,19813,1990
4001,AZ,Apache,,2020,12.5,17058,19502,2444
4001,AZ,Apache,,2021,9.1,16995,18700,1705
4003,AZ,Cochise,,2007,4,54709,56983,2274
4003,AZ,Cochise,,2008,5.5,56801,60117,3316
4003,AZ,Cochise,,2009,7.8,58204,63101,4897
4003,AZ,Cochise,,2010,9.3,51843,57146,5303
4003,AZ,Cochise,,2011,9.5,50870,56190,5320
4003,AZ,Cochise,,2012,9,49438,54343,4905
4003,AZ,Cochise,,2013,9.3,47097,51900,4803
4003,AZ,Cochise,,2014,8.4,46954,51273,4319
4003,AZ,Cochise,,2015,7.3,46891,50586,3695
4003,AZ,Cochise,,2016,6.3,46647,49799,3152
4003,AZ,Cochise,,2017,5.6,45406,48125,2719
4003,AZ,Cochise,,2018,5.6,45431,48115,2684
4003,AZ,Cochise,,2019,5.8,45963,48785,2822
4003,AZ,Cochise,,2020,6.8,46659,50090,3431
4003,AZ,Cochise,,2021,4.8,46667,49027,2360
4005,AZ,Coconino,,2007,3.7,67814,70388,2574
4005,AZ,Coconino,,2008,5.3,69176,73026,3850
4005,AZ,Coconino,,2009,8.3,68643,74852,6209
4005,AZ,Coconino,,2010,9.8,65838,72998,7160
4005,AZ,Coconino,,2011,9.5,65208,72036,6828
4005,AZ,Coconino,,2012,8.6,65467,71626,6159
4005,AZ,Coconino,,2013,8.2,65825,71698,5873
4005,AZ,Coconino,,2014,7.1,67508,72671,5163
4005,AZ,Coconino,,2015,6.5,68861,73669,4808
4005,AZ,Coconino,,2016,6.1,69930,74484,4554
4005,AZ,Coconino,,2017,5.6,69435,73563,4128
4005,AZ,Coconino,,2018,5.5,69968,74030,4062
4005,AZ,Coconino,,2019,5.7,70489,74782,4293
4005,AZ,Coconino,,2020,9.5,65193,72016,6823
4005,AZ,Coconino,,2021,6,67857,72223,4366
4007,AZ,Gila,,2007,4.2,20173,21059,886
4007,AZ,Gila,,2008,6.1,20902,22258,1356
4007,AZ,Gila,,2009,11.1,20694,23272,2578
4007,AZ,Gila,,2010,12.4,18969,21664,2695
4007,AZ,Gila,,2011,11.5,18830,21274,2444
4007,AZ,Gila,,2012,10.2,18943,21100,2157
4007,AZ,Gila,,2013,9.7,19098,21148,2050
4007,AZ,Gila,,2014,8.3,19750,21544,1794
4007,AZ,Gila,,2015,7.9,19633,21321,1688
4007,AZ,Gila,,2016,7.3,19536,21084,1548
4007,AZ,Gila,,2017,6.1,19515,20789,1274
4007,AZ,Gila,,2018,5.8,19565,20768,1203
4007,AZ,Gila,,2019,5.7,19586,20765,1179
4007,AZ,Gila,,2020,7.5,18830,20355,1525
4007,AZ,Gila,,2021,5,19377,20390,1013
4009,AZ,Graham,,2007,4.2,13624,14221,597
4009,AZ,Graham,,2008,6.7,15011,16083,1072
4009,AZ,Graham,,2009,14.7,12993,15229,2236
4009,AZ,Graham,,2010,12.8,12724,14598,1874
4009,AZ,Graham,,2011,9.9,12988,14415,1427
4009,AZ,Graham,,2012,8.5,13353,14594,1241
4009,AZ,Graham,,2013,7.8,13317,14441,1124
4009,AZ,Graham,,2014,7.4,13447,14529,1082
4009,AZ,Graham,,2015,7.4,13515,14590,1075
4009,AZ,Graham,,2016,6.8,13445,14433,988
4009,AZ,Graham,,2017,5.5,13235,14008,773
4009,AZ,Graham,,2018,5.1,13674,14404,730
4009,AZ,Graham,,2019,4.9,14226,14962,736
4009,AZ,Graham,,2020,6.2,14464,15412,948
4009,AZ,Graham,,2021,4.1,15047,15695,648
4011,AZ,Greenlee,,2007,3.2,3852,3979,127
4011,AZ,Greenlee,,2008,5,4178,4398,220
4011,AZ,Greenlee,,2009,18.5,3576,4387,811
4011,AZ,Greenlee,,2010,16.3,2883,3444,561
4011,AZ,Greenlee,,2011,11,2999,3369,370
4011,AZ,Greenlee,,2012,8.2,3289,3584,295
4011,AZ,Greenlee,,2013,5.9,4358,4632,274
4011,AZ,Greenlee,,2014,6.5,4439,4748,309
4011,AZ,Greenlee,,2015,7.9,3745,4068,323
4011,AZ,Greenlee,,2016,7.7,3615,3916,301
4011,AZ,Greenlee,,2017,5.1,3687,3885,198
4011,AZ,Greenlee,,2018,4.1,3973,4144,171
4011,AZ,Greenlee,,2019,4,4173,4346,173
4011,AZ,Greenlee,,2020,5.2,4082,4307,225
4011,AZ,Greenlee,,2021,4,4169,4343,174
4012,AZ,La Paz,,2007,5,7232,7614,382
4012,AZ,La Paz,,2008,7.3,6975,7523,548
4012,AZ,La Paz,,2009,9.6,6963,7705,742
4012,AZ,La Paz,,2010,10.2,7084,7885,801
4012,AZ,La Paz,,2011,9.8,7096,7864,768
4012,AZ,La Paz,,2012,8.6,7503,8205,702
4012,AZ,La Paz,,2013,8.2,7453,8121,668
4012,AZ,La Paz,,2014,7.6,7394,8002,608
4012,AZ,La Paz,,2015,7.5,7602,8217,615
4012,AZ,La Paz,,2016,6.1,7983,8506,523
4012,AZ,La Paz,,2017,5.5,8006,8469,463
4012,AZ,La Paz,,2018,6.2,8114,8651,537
4012,AZ,La Paz,,2019,6,8466,9004,538
4012,AZ,La Paz,,2020,7,8117,8726,609
4012,AZ,La Paz,,2021,5.1,8175,8616,441
4013,AZ,Maricopa,,2007,3.2,1874182,1935839,61657
4013,AZ,Maricopa,,2008,5.1,1866392,1966052,99660
4013,AZ,Maricopa,,2009,8.9,1792986,1967563,174577
4013,AZ,Maricopa,,2010,9.5,1741749,1923669,181920
4013,AZ,Maricopa,,2011,8.5,1742147,1904041,161894
4013,AZ,Maricopa,,2012,7.3,1772341,1911529,139188
4013,AZ,Maricopa,,2013,6.6,1801272,1929092,127820
4013,AZ,Maricopa,,2014,5.8,1858871,1973683,114812
4013,AZ,Maricopa,,2015,5.1,1928852,2033488,104636
4013,AZ,Maricopa,,2016,4.7,1991371,2088551,97180
4013,AZ,Maricopa,,2017,4.3,1999783,2088547,88764
4013,AZ,Maricopa,,2018,4.1,2066973,2155981,89008
4013,AZ,Maricopa,,2019,4.2,2136810,2229900,93090
4013,AZ,Maricopa,,2020,7.2,2094758,2256967,162209
4013,AZ,Maricopa,,2021,4.5,2208858,2311889,103031
4015,AZ,Mohave,,2007,4.6,86816,90964,4148
4015,AZ,Mohave,,2008,7.2,85565,92235,6670
4015,AZ,Mohave,,2009,11.1,81375,91543,10168
4015,AZ,Mohave,,2010,12.9,72206,82880,10674
4015,AZ,Mohave,,2011,12.2,70211,79969,9758
4015,AZ,Mohave,,2012,11,69600,78227,8627
4015,AZ,Mohave,,2013,10.4,69643,77748,8105
4015,AZ,Mohave,,2014,8.7,71947,78835,6888
4015,AZ,Mohave,,2015,8,73633,80004,6371
4015,AZ,Mohave,,2016,6.7,75410,80843,5433
4015,AZ,Mohave,,2017,6,75565,80346,4781
4015,AZ,Mohave,,2018,5.7,77910,82593,4683
4015,AZ,Mohave,,2019,5.8,79636,84582,4946
4015,AZ,Mohave,,2020,9.7,77556,85930,8374
4015,AZ,Mohave,,2021,5.5,82382,87215,4833
4017,AZ,Navajo,,2007,6.3,35636,38032,2396
4017,AZ,Navajo,,2008,9.5,35362,39094,3732
4017,AZ,Navajo,,2009,14.9,35002,41145,6143
4017,AZ,Navajo,,2010,14.6,37557,43978,6421
4017,AZ,Navajo,,2011,14.7,37120,43540,6420
4017,AZ,Navajo,,2012,14.1,37200,43323,6123
4017,AZ,Navajo,,2013,13.6,36681,42434,5753
4017,AZ,Navajo,,2014,11.1,37291,41943,4652
4017,AZ,Navajo,,2015,9.7,36963,40931,3968
4017,AZ,Navajo,,2016,8.4,38030,41511,3481
4017,AZ,Navajo,,2017,7.7,36633,39709,3076
4017,AZ,Navajo,,2018,7.7,36124,39123,2999
4017,AZ,Navajo,,2019,7.5,36514,39489,2975
4017,AZ,Navajo,,2020,9.9,35304,39186,3882
4017,AZ,Navajo,,2021,6.5,36704,39276,2572
4019,AZ,Pima,,2007,3.6,439740,456210,16470
4019,AZ,Pima,,2008,5.5,447233,473209,25976
4019,AZ,Pima,,2009,8.8,443226,486097,42871
4019,AZ,Pima,,2010,9.3,435352,479984,44632
4019,AZ,Pima,,2011,8.4,429711,469332,39621
4019,AZ,Pima,,2012,7.4,432392,466804,34412
4019,AZ,Pima,,2013,6.8,430789,462267,31478
4019,AZ,Pima,,2014,6,437713,465898,28185
4019,AZ,Pima,,2015,5.5,442099,467826,25727
4019,AZ,Pima,,2016,5,447695,471452,23757
4019,AZ,Pima,,2017,4.6,443046,464230,21184
4019,AZ,Pima,,2018,4.4,449984,470786,20802
4019,AZ,Pima,,2019,4.5,460572,482457,21885
4019,AZ,Pima,,2020,7.5,443416,479345,35929
4019,AZ,Pima,,2021,5,457095,480903,23808
4021,AZ,Pinal,,2007,4.5,106097,111050,4953
4021,AZ,Pinal,,2008,7,113386,121870,8484
4021,AZ,Pinal,,2009,12,111541,126725,15184
4021,AZ,Pinal,,2010,10.6,137636,154038,16402
4021,AZ,Pinal,,2011,9.7,135795,150364,14569
4021,AZ,Pinal,,2012,8.5,137136,149940,12804
4021,AZ,Pinal,,2013,8.1,137820,150007,12187
4021,AZ,Pinal,,2014,7,143829,154678,10849
4021,AZ,Pinal,,2015,6.3,148079,158049,9970
4021,AZ,Pinal,,2016,5.6,155330,164605,9275
4021,AZ,Pinal,,2017,5.1,158730,167281,8551
4021,AZ,Pinal,,2018,5,166124,174833,8709
4021,AZ,Pinal,,2019,5,174883,184133,9250
4021,AZ,Pinal,,2020,7.3,174319,187999,13680
4021,AZ,Pinal,,2021,4.7,183334,192406,9072
4023,AZ,Santa Cruz,,2007,7.2,15828,17058,1230
4023,AZ,Santa Cruz,,2008,10.4,15930,17783,1853
4023,AZ,Santa Cruz,,2009,15.4,15704,18564,2860
4023,AZ,Santa Cruz,,2010,15.2,17748,20917,3169
4023,AZ,Santa Cruz,,2011,15.4,17407,20567,3160
4023,AZ,Santa Cruz,,2012,15.5,17157,20293,3136
4023,AZ,Santa Cruz,,2013,15.5,17210,20355,3145
4023,AZ,Santa Cruz,,2014,13,17777,20422,2645
4023,AZ,Santa Cruz,,2015,11.5,17687,19986,2299
4023,AZ,Santa Cruz,,2016,10.2,17317,19282,1965
4023,AZ,Santa Cruz,,2017,9.6,16816,18601,1785
4023,AZ,Santa Cruz,,2018,9.2,17011,18728,1717
4023,AZ,Santa Cruz,,2019,8.7,17356,19009,1653
4023,AZ,Santa Cruz,,2020,11.2,16677,18775,2098
4023,AZ,Santa Cruz,,2021,8.7,17298,18942,1644
4025,AZ,Yavapai,,2007,3.6,93610,97122,3512
4025,AZ,Yavapai,,2008,5.8,92100,97796,5696
4025,AZ,Yavapai,,2009,10.2,88310,98321,10011
4025,AZ,Yavapai,,2010,10.6,86472,96734,10262
4025,AZ,Yavapai,,2011,9.8,84420,93580,9160
4025,AZ,Yavapai,,2012,8.6,85150,93162,8012
4025,AZ,Yavapai,,2013,7.8,85427,92659,7232
4025,AZ,Yavapai,,2014,6.4,88836,94877,6041
4025,AZ,Yavapai,,2015,5.6,91286,96735,5449
4025,AZ,Yavapai,,2016,5,94913,99916,5003
4025,AZ,Yavapai,,2017,4.6,94790,99348,4558
4025,AZ,Yavapai,,2018,4.4,97201,101700,4499
4025,AZ,Yavapai,,2019,4.6,98601,103311,4710
4025,AZ,Yavapai,,2020,7.3,95949,103471,7522
4025,AZ,Yavapai,,2021,4.1,100771,105108,4337
4027,AZ,Yuma,,2007,13.7,67478,78208,10730
4027,AZ,Yuma,,2008,17.4,68876,83416,14540
4027,AZ,Yuma,,2009,22.5,67830,87485,19655
4027,AZ,Yuma,,2010,25,69699,92909,23210
4027,AZ,Yuma,,2011,24.1,70065,92260,22195
4027,AZ,Yuma,,2012,23.9,72028,94613,22585
4027,AZ,Yuma,,2013,25.6,71342,95948,24606
4027,AZ,Yuma,,2014,22.9,72444,93996,21552
4027,AZ,Yuma,,2015,21.8,73736,94249,20513
4027,AZ,Yuma,,2016,19.1,76590,94671,18081
4027,AZ,Yuma,,2017,17.2,77245,93326,16081
4027,AZ,Yuma,,2018,16.9,78454,94398,15944
4027,AZ,Yuma,,2019,16.8,80826,97138,16312
4027,AZ,Yuma,,2020,16.9,78717,94768,16051
4027,AZ,Yuma,,2021,12.9,81591,93693,12102
5000,AR,Arkansas,,2007,5.4,1277902,1350811,72909
5000,AR,Arkansas,,2008,5.4,1284175,1357716,73541
5000,AR,Arkansas,,2009,7.7,1248691,1353340,104649
5000,AR,Arkansas,,2010,7.9,1247059,1353635,106576
5000,AR,Arkansas,,2011,7.9,1250431,1357819,107388
5000,AR,Arkansas,,2012,7.3,1251883,1349888,98005
5000,AR,Arkansas,,2013,7.1,1237609,1331609,94000
5000,AR,Arkansas,,2014,5.9,1249766,1327959,78193
5000,AR,Arkansas,,2015,5,1272785,1339301,66516
5000,AR,Arkansas,,2016,4,1290430,1343891,53461
5000,AR,Arkansas,,2017,3.7,1297854,1348088,50234
5000,AR,Arkansas,,2018,3.6,1302629,1351686,49057
5000,AR,Arkansas,,2019,3.5,1318465,1365790,47325
5000,AR,Arkansas,,2020,6.1,1274070,1356579,82509
5000,AR,Arkansas,,2021,4,1278984,1332620,53636
5001,AR,Arkansas,,2007,8.9,10784,11833,1049
5001,AR,Arkansas,,2008,9.7,10835,11999,1164
5001,AR,Arkansas,,2009,15.5,10347,12240,1893
5001,AR,Arkansas,,2010,17.9,9251,11273,2022
5001,AR,Arkansas,,2011,11.6,9286,10509,1223
5001,AR,Arkansas,,2012,8.4,9120,9958,838
5001,AR,Arkansas,,2013,7.1,8959,9647,688
5001,AR,Arkansas,,2014,5.2,9045,9545,500
5001,AR,Arkansas,,2015,4.1,9142,9534,392
5001,AR,Arkansas,,2016,3.4,8967,9284,317
5001,AR,Arkansas,,2017,3.3,8673,8967,294
5001,AR,Arkansas,,2018,3.3,8770,9069,299
5001,AR,Arkansas,,2019,2.9,9204,9481,277
5001,AR,Arkansas,,2020,4,9058,9436,378
5001,AR,Arkansas,,2021,3.4,9108,9424,316
5003,AR,Ashley,,2007,8.3,8586,9359,773
5003,AR,Ashley,,2008,7.5,8638,9342,704
5003,AR,Ashley,,2009,10.4,8334,9302,968
5003,AR,Ashley,,2010,9.6,8949,9896,947
5003,AR,Ashley,,2011,10.5,8953,10004,1051
5003,AR,Ashley,,2012,11.5,8394,9490,1096
5003,AR,Ashley,,2013,10.4,8204,9154,950
5003,AR,Ashley,,2014,8.9,7962,8736,774
5003,AR,Ashley,,2015,7.5,7771,8397,626
5003,AR,Ashley,,2016,6.1,7477,7966,489
5003,AR,Ashley,,2017,5.6,7424,7865,441
5003,AR,Ashley,,2018,5.2,7417,7826,409
5003,AR,Ashley,,2019,5.3,7300,7707,407
5003,AR,Ashley,,2020,9.4,6506,7178,672
5003,AR,Ashley,,2021,7.4,6301,6801,500
5005,AR,Baxter,,2007,5.5,16545,17509,964
5005,AR,Baxter,,2008,6,16433,17478,1045
5005,AR,Baxter,,2009,9.2,15669,17254,1585
5005,AR,Baxter,,2010,9.1,15088,16596,1508
5005,AR,Baxter,,2011,8.9,15057,16523,1466
5005,AR,Baxter,,2012,8.1,15116,16446,1330
5005,AR,Baxter,,2013,7.8,14890,16158,1268
5005,AR,Baxter,,2014,6.5,15052,16104,1052
5005,AR,Baxter,,2015,5.4,15407,16288,881
5005,AR,Baxter,,2016,4.3,15435,16130,695
5005,AR,Baxter,,2017,4.3,15663,16364,701
5005,AR,Baxter,,2018,4.1,15712,16378,666
5005,AR,Baxter,,2019,3.9,15690,16330,640
5005,AR,Baxter,,2020,6,15584,16576,992
5005,AR,Baxter,,2021,3.7,15681,16287,606
5007,AR,Benton,,2007,3.8,99669,103619,3950
5007,AR,Benton,,2008,4.1,101031,105357,4326
5007,AR,Benton,,2009,6.3,100476,107277,6801
5007,AR,Benton,,2010,6.4,100219,107052,6833
5007,AR,Benton,,2011,6.2,102361,109127,6766
5007,AR,Benton,,2012,5.8,104879,111298,6419
5007,AR,Benton,,2013,5.5,106367,112548,6181
5007,AR,Benton,,2014,4.5,111104,116340,5236
5007,AR,Benton,,2015,3.7,117802,122348,4546
5007,AR,Benton,,2016,2.9,124390,128130,3740
5007,AR,Benton,,2017,3,128502,132441,3939
5007,AR,Benton,,2018,2.9,130752,134603,3851
5007,AR,Benton,,2019,2.6,135616,139195,3579
5007,AR,Benton,,2020,4.5,135182,141515,6333
5007,AR,Benton,,2021,2.8,137993,141991,3998
5009,AR,Boone,,2007,5.1,15895,16758,863
5009,AR,Boone,,2008,5.4,15920,16832,912
5009,AR,Boone,,2009,7.4,15666,16919,1253
5009,AR,Boone,,2010,7.5,15259,16502,1243
5009,AR,Boone,,2011,7.6,15354,16613,1259
5009,AR,Boone,,2012,7.3,15376,16590,1214
5009,AR,Boone,,2013,6.8,15037,16140,1103
5009,AR,Boone,,2014,5.8,14858,15780,922
5009,AR,Boone,,2015,4.8,15145,15909,764
5009,AR,Boone,,2016,3.7,15370,15957,587
5009,AR,Boone,,2017,3.5,15249,15794,545
5009,AR,Boone,,2018,3.4,15345,15893,548
5009,AR,Boone,,2019,3.1,15570,16070,500
5009,AR,Boone,,2020,5.3,15019,15857,838
5009,AR,Boone,,2021,3,15313,15782,469
5011,AR,Bradley,,2007,6.2,5368,5722,354
5011,AR,Bradley,,2008,7.2,5152,5549,397
5011,AR,Bradley,,2009,9.6,4936,5461,525
5011,AR,Bradley,,2010,10.1,4637,5157,520
5011,AR,Bradley,,2011,11.5,4153,4695,542
5011,AR,Bradley,,2012,10.4,4062,4531,469
5011,AR,Bradley,,2013,9.3,3900,4298,398
5011,AR,Bradley,,2014,7.8,4008,4349,341
5011,AR,Bradley,,2015,5.7,4314,4575,261
5011,AR,Bradley,,2016,5,4265,4491,226
5011,AR,Bradley,,2017,4.6,4252,4456,204
5011,AR,Bradley,,2018,4.3,4289,4481,192
5011,AR,Bradley,,2019,4,4301,4482,181
5011,AR,Bradley,,2020,5.9,4110,4368,258
5011,AR,Bradley,,2021,4.7,3865,4056,191
5013,AR,Calhoun,,2007,6.8,2425,2603,178
5013,AR,Calhoun,,2008,6.1,2422,2580,158
5013,AR,Calhoun,,2009,8.3,2358,2572,214
5013,AR,Calhoun,,2010,8.4,2474,2701,227
5013,AR,Calhoun,,2011,9.1,2402,2642,240
5013,AR,Calhoun,,2012,8.6,2317,2536,219
5013,AR,Calhoun,,2013,7.9,2259,2453,194
5013,AR,Calhoun,,2014,6.4,2244,2397,153
5013,AR,Calhoun,,2015,5.3,2300,2429,129
5013,AR,Calhoun,,2016,4.6,2286,2396,110
5013,AR,Calhoun,,2017,3.9,2316,2410,94
5013,AR,Calhoun,,2018,3.8,2349,2441,92
5013,AR,Calhoun,,2019,4.3,2332,2437,105
5013,AR,Calhoun,,2020,5.3,2289,2416,127
5013,AR,Calhoun,,2021,3.3,2312,2392,80
5015,AR,Carroll,,2007,4.4,13223,13830,607
5015,AR,Carroll,,2008,4.5,13454,14082,628
5015,AR,Carroll,,2009,6,13122,13961,839
5015,AR,Carroll,,2010,7.1,11711,12601,890
5015,AR,Carroll,,2011,6.9,11968,12852,884
5015,AR,Carroll,,2012,6.1,11778,12539,761
5015,AR,Carroll,,2013,5.8,11637,12360,723
5015,AR,Carroll,,2014,5.1,12001,12641,640
5015,AR,Carroll,,2015,4.5,12138,12711,573
5015,AR,Carroll,,2016,3.6,12432,12891,459
5015,AR,Carroll,,2017,3.4,12554,12990,436
5015,AR,Carroll,,2018,3.2,12204,12604,400
5015,AR,Carroll,,2019,3,12439,12830,391
5015,AR,Carroll,,2020,5.7,12013,12735,722
5015,AR,Carroll,,2021,3.4,12279,12708,429
5017,AR,Chicot,,2007,8.4,4517,4931,414
5017,AR,Chicot,,2008,8.2,4500,4902,402
5017,AR,Chicot,,2009,11,4318,4851,533
5017,AR,Chicot,,2010,11.9,3763,4271,508
5017,AR,Chicot,,2011,12.6,3726,4261,535
5017,AR,Chicot,,2012,10.9,3628,4074,446
5017,AR,Chicot,,2013,11.3,3425,3863,438
5017,AR,Chicot,,2014,10.2,3480,3877,397
5017,AR,Chicot,,2015,9,3408,3743,335
5017,AR,Chicot,,2016,6.6,3353,3590,237
5017,AR,Chicot,,2017,6.6,3238,3465,227
5017,AR,Chicot,,2018,6.7,3130,3355,225
5017,AR,Chicot,,2019,6.8,3034,3254,220
5017,AR,Chicot,,2020,10.5,2876,3213,337
5017,AR,Chicot,,2021,8.6,2820,3084,264
5019,AR,Clark,,2007,5.7,10301,10921,620
5019,AR,Clark,,2008,5.9,10271,10913,642
5019,AR,Clark,,2009,8,9880,10737,857
5019,AR,Clark,,2010,8.1,9526,10366,840
5019,AR,Clark,,2011,9.8,9392,10411,1019
5019,AR,Clark,,2012,9.5,9355,10341,986
5019,AR,Clark,,2013,8.6,9280,10155,875
5019,AR,Clark,,2014,6.7,9100,9749,649
5019,AR,Clark,,2015,5.4,9144,9663,519
5019,AR,Clark,,2016,4.3,9173,9589,416
5019,AR,Clark,,2017,3.9,9199,9574,375
5019,AR,Clark,,2018,3.6,9337,9689,352
5019,AR,Clark,,2019,3.7,9341,9703,362
5019,AR,Clark,,2020,6,8711,9263,552
5019,AR,Clark,,2021,4.7,8390,8805,415
5021,AR,Clay,,2007,9.4,6037,6664,627
5021,AR,Clay,,2008,8,6071,6598,527
5021,AR,Clay,,2009,11.2,5897,6640,743
5021,AR,Clay,,2010,10.6,6673,7464,791
5021,AR,Clay,,2011,11.6,6420,7263,843
5021,AR,Clay,,2012,10.6,6156,6884,728
5021,AR,Clay,,2013,9.5,5938,6562,624
5021,AR,Clay,,2014,7.7,5964,6459,495
5021,AR,Clay,,2015,6.5,5911,6323,412
5021,AR,Clay,,2016,5.7,5706,6048,342
5021,AR,Clay,,2017,4.6,5614,5883,269
5021,AR,Clay,,2018,4.3,5551,5801,250
5021,AR,Clay,,2019,4.8,5403,5674,271
5021,AR,Clay,,2020,6.1,5209,5546,337
5021,AR,Clay,,2021,4,5178,5391,213
5023,AR,Cleburne,,2007,6.2,10819,11531,712
5023,AR,Cleburne,,2008,5.6,11288,11957,669
5023,AR,Cleburne,,2009,7.4,10879,11747,868
5023,AR,Cleburne,,2010,8.3,9491,10348,857
5023,AR,Cleburne,,2011,8.8,9609,10531,922
5023,AR,Cleburne,,2012,8.2,9603,10456,853
5023,AR,Cleburne,,2013,8.3,9253,10093,840
5023,AR,Cleburne,,2014,8.1,9028,9821,793
5023,AR,Cleburne,,2015,6.8,8996,9655,659
5023,AR,Cleburne,,2016,5.9,8935,9500,565
5023,AR,Cleburne,,2017,5,8826,9286,460
5023,AR,Cleburne,,2018,4.5,8712,9118,406
5023,AR,Cleburne,,2019,4.4,8823,9230,407
5023,AR,Cleburne,,2020,7.6,8489,9190,701
5023,AR,Cleburne,,2021,4.6,8559,8970,411
5025,AR,Cleveland,,2007,5.8,3885,4124,239
5025,AR,Cleveland,,2008,5.8,3845,4083,238
5025,AR,Cleveland,,2009,8,3703,4025,322
5025,AR,Cleveland,,2010,8.1,3570,3884,314
5025,AR,Cleveland,,2011,8.2,3551,3867,316
5025,AR,Cleveland,,2012,7.1,3500,3767,267
5025,AR,Cleveland,,2013,7.4,3353,3620,267
5025,AR,Cleveland,,2014,6.7,3249,3481,232
5025,AR,Cleveland,,2015,5.5,3184,3371,187
5025,AR,Cleveland,,2016,4.5,3198,3349,151
5025,AR,Cleveland,,2017,4.4,3182,3327,145
5025,AR,Cleveland,,2018,3.8,3141,3264,123
5025,AR,Cleveland,,2019,3.8,3121,3245,124
5025,AR,Cleveland,,2020,6.1,3055,3252,197
5025,AR,Cleveland,,2021,4,2985,3108,123
5027,AR,Columbia,,2007,6.6,10171,10893,722
5027,AR,Columbia,,2008,6.9,10042,10787,745
5027,AR,Columbia,,2009,9.6,9555,10571,1016
5027,AR,Columbia,,2010,9.6,9504,10516,1012
5027,AR,Columbia,,2011,9.6,9390,10386,996
5027,AR,Columbia,,2012,8.7,9282,10162,880
5027,AR,Columbia,,2013,8.6,8920,9755,835
5027,AR,Columbia,,2014,7,8957,9630,673
5027,AR,Columbia,,2015,6.4,8982,9599,617
5027,AR,Columbia,,2016,5.7,8781,9313,532
5027,AR,Columbia,,2017,5.1,8616,9077,461
5027,AR,Columbia,,2018,4.7,8594,9014,420
5027,AR,Columbia,,2019,4.3,8806,9206,400
5027,AR,Columbia,,2020,6.9,8437,9058,621
5027,AR,Columbia,,2021,5.3,8345,8814,469
5029,AR,Conway,,2007,4.9,9445,9936,491
5029,AR,Conway,,2008,5.5,9553,10107,554
5029,AR,Conway,,2009,7.4,9463,10223,760
5029,AR,Conway,,2010,9.3,8183,9023,840
5029,AR,Conway,,2011,9.4,8146,8995,849
5029,AR,Conway,,2012,8.8,7968,8739,771
5029,AR,Conway,,2013,9,7917,8698,781
5029,AR,Conway,,2014,7,8061,8667,606
5029,AR,Conway,,2015,6,8161,8682,521
5029,AR,Conway,,2016,5.7,7983,8468,485
5029,AR,Conway,,2017,4.8,7834,8229,395
5029,AR,Conway,,2018,4.3,7812,8163,351
5029,AR,Conway,,2019,4.2,7950,8300,350
5029,AR,Conway,,2020,6.1,7903,8413,510
5029,AR,Conway,,2021,4.2,7889,8231,342
5031,AR,Craighead,,2007,5.1,43058,45366,2308
5031,AR,Craighead,,2008,4.8,43767,45985,2218
5031,AR,Craighead,,2009,6.9,43354,46584,3230
5031,AR,Craighead,,2010,7.1,44346,47751,3405
5031,AR,Craighead,,2011,7,45520,48963,3443
5031,AR,Craighead,,2012,6.6,46024,49275,3251
5031,AR,Craighead,,2013,6.4,46453,49628,3175
5031,AR,Craighead,,2014,5.3,47210,49862,2652
5031,AR,Craighead,,2015,4.4,48977,51214,2237
5031,AR,Craighead,,2016,3.3,50613,52315,1702
5031,AR,Craighead,,2017,3,51961,53579,1618
5031,AR,Craighead,,2018,3,52863,54497,1634
5031,AR,Craighead,,2019,2.7,54685,56221,1536
5031,AR,Craighead,,2020,5.3,53304,56309,3005
5031,AR,Craighead,,2021,3.3,53861,55682,1821
5033,AR,Crawford,,2007,5,26783,28182,1399
5033,AR,Crawford,,2008,4.8,26993,28355,1362
5033,AR,Crawford,,2009,7.7,25681,27829,2148
5033,AR,Crawford,,2010,7.9,26053,28286,2233
5033,AR,Crawford,,2011,8.4,25519,27874,2355
5033,AR,Crawford,,2012,7.7,25599,27720,2121
5033,AR,Crawford,,2013,7.5,25179,27208,2029
5033,AR,Crawford,,2014,5.9,25426,27006,1580
5033,AR,Crawford,,2015,5.1,25582,26962,1380
5033,AR,Crawford,,2016,3.9,25941,26995,1054
5033,AR,Crawford,,2017,3.5,25971,26925,954
5033,AR,Crawford,,2018,3.5,26027,26972,945
5033,AR,Crawford,,2019,3.2,26036,26910,874
5033,AR,Crawford,,2020,5.5,25062,26510,1448
5033,AR,Crawford,,2021,3.6,24851,25772,921
5035,AR,Crittenden,,2007,6.6,20653,22118,1465
5035,AR,Crittenden,,2008,7.9,20554,22307,1753
5035,AR,Crittenden,,2009,10.7,19594,21954,2360
5035,AR,Crittenden,,2010,10.1,20478,22778,2300
5035,AR,Crittenden,,2011,10.4,20277,22636,2359
5035,AR,Crittenden,,2012,9.2,20135,22176,2041
5035,AR,Crittenden,,2013,8.2,19886,21653,1767
5035,AR,Crittenden,,2014,7.2,20031,21584,1553
5035,AR,Crittenden,,2015,6.1,20198,21503,1305
5035,AR,Crittenden,,2016,4.5,20664,21642,978
5035,AR,Crittenden,,2017,4.4,20437,21378,941
5035,AR,Crittenden,,2018,4.3,20272,21178,906
5035,AR,Crittenden,,2019,4.2,20362,21249,887
5035,AR,Crittenden,,2020,8.4,19339,21102,1763
5035,AR,Crittenden,,2021,5.4,19394,20502,1108
5037,AR,Cross,,2007,7.5,7720,8346,626
5037,AR,Cross,,2008,6.8,7877,8449,572
5037,AR,Cross,,2009,8.2,7801,8502,701
5037,AR,Cross,,2010,8,7921,8608,687
5037,AR,Cross,,2011,8,8084,8785,701
5037,AR,Cross,,2012,7.6,7913,8566,653
5037,AR,Cross,,2013,7.4,7645,8254,609
5037,AR,Cross,,2014,6.2,7646,8153,507
5037,AR,Cross,,2015,5.3,7701,8135,434
5037,AR,Cross,,2016,4.4,7547,7897,350
5037,AR,Cross,,2017,4,7346,7654,308
5037,AR,Cross,,2018,4.1,7143,7445,302
5037,AR,Cross,,2019,4.1,7102,7407,305
5037,AR,Cross,,2020,6.1,6820,7264,444
5037,AR,Cross,,2021,4.4,6681,6987,306
5039,AR,Dallas,,2007,7.2,3556,3830,274
5039,AR,Dallas,,2008,7.2,3581,3857,276
5039,AR,Dallas,,2009,10,3528,3921,393
5039,AR,Dallas,,2010,11.5,3187,3602,415
5039,AR,Dallas,,2011,11.5,3017,3409,392
5039,AR,Dallas,,2012,10.7,2951,3303,352
5039,AR,Dallas,,2013,10.2,2742,3054,312
5039,AR,Dallas,,2014,8.8,2737,3001,264
5039,AR,Dallas,,2015,6.9,2782,2987,205
5039,AR,Dallas,,2016,4.9,2842,2987,145
5039,AR,Dallas,,2017,4.4,2790,2919,129
5039,AR,Dallas,,2018,4.1,2727,2845,118
5039,AR,Dallas,,2019,4.5,2699,2827,128
5039,AR,Dallas,,2020,5.4,2669,2821,152
5039,AR,Dallas,,2021,4.1,2657,2770,113
5041,AR,Desha,,2007,10,5487,6099,612
5041,AR,Desha,,2008,8.7,5356,5865,509
5041,AR,Desha,,2009,11.2,4946,5568,622
5041,AR,Desha,,2010,10.7,5264,5895,631
5041,AR,Desha,,2011,10.6,5481,6132,651
5041,AR,Desha,,2012,9.5,5392,5958,566
5041,AR,Desha,,2013,9.4,5147,5682,535
5041,AR,Desha,,2014,7.9,5159,5600,441
5041,AR,Desha,,2015,7.2,5178,5579,401
5041,AR,Desha,,2016,5.5,5157,5455,298
5041,AR,Desha,,2017,4.8,5183,5446,263
5041,AR,Desha,,2018,4.4,5180,5420,240
5041,AR,Desha,,2019,4.3,5175,5410,235
5041,AR,Desha,,2020,7.1,4916,5289,373
5041,AR,Desha,,2021,5.9,4670,4963,293
5043,AR,Drew,,2007,7.5,7757,8390,633
5043,AR,Drew,,2008,7.8,7736,8393,657
5043,AR,Drew,,2009,10.9,7296,8186,890
5043,AR,Drew,,2010,10.4,7799,8702,903
5043,AR,Drew,,2011,10.9,7800,8754,954
5043,AR,Drew,,2012,10.1,7656,8517,861
5043,AR,Drew,,2013,9.4,7556,8340,784
5043,AR,Drew,,2014,8.1,7518,8180,662
5043,AR,Drew,,2015,6.7,7568,8115,547
5043,AR,Drew,,2016,5.7,7549,8002,453
5043,AR,Drew,,2017,5.1,7554,7961,407
5043,AR,Drew,,2018,4.8,7460,7838,378
5043,AR,Drew,,2019,5.1,7437,7834,397
5043,AR,Drew,,2020,6.9,7180,7716,536
5043,AR,Drew,,2021,5,7145,7522,377
5045,AR,Faulkner,,2007,4.5,52032,54457,2425
5045,AR,Faulkner,,2008,4.7,52914,55531,2617
5045,AR,Faulkner,,2009,6.9,52329,56178,3849
5045,AR,Faulkner,,2010,6.9,54585,58662,4077
5045,AR,Faulkner,,2011,6.8,55162,59201,4039
5045,AR,Faulkner,,2012,6.3,56177,59986,3809
5045,AR,Faulkner,,2013,6.3,55878,59652,3774
5045,AR,Faulkner,,2014,5.4,56270,59498,3228
5045,AR,Faulkner,,2015,4.6,57396,60161,2765
5045,AR,Faulkner,,2016,3.8,58345,60654,2309
5045,AR,Faulkner,,2017,3.4,59285,61341,2056
5045,AR,Faulkner,,2018,3.2,59995,61975,1980
5045,AR,Faulkner,,2019,2.9,61129,62970,1841
5045,AR,Faulkner,,2020,5.5,58616,62006,3390
5045,AR,Faulkner,,2021,3.5,58910,61033,2123
5047,AR,Franklin,,2007,4.6,8097,8483,386
5047,AR,Franklin,,2008,4.4,8085,8458,373
5047,AR,Franklin,,2009,7.2,7567,8151,584
5047,AR,Franklin,,2010,7.4,7216,7796,580
5047,AR,Franklin,,2011,7.3,7201,7769,568
5047,AR,Franklin,,2012,6.8,7178,7703,525
5047,AR,Franklin,,2013,6.7,6965,7466,501
5047,AR,Franklin,,2014,5.5,6936,7343,407
5047,AR,Franklin,,2015,4.9,7080,7442,362
5047,AR,Franklin,,2016,4.1,7079,7378,299
5047,AR,Franklin,,2017,3.5,7139,7401,262
5047,AR,Franklin,,2018,3.5,7118,7377,259
5047,AR,Franklin,,2019,3.3,7282,7528,246
5047,AR,Franklin,,2020,5.7,7058,7481,423
5047,AR,Franklin,,2021,3.7,6999,7267,268
5049,AR,Fulton,,2007,5.1,4841,5099,258
5049,AR,Fulton,,2008,5.2,4910,5178,268
5049,AR,Fulton,,2009,7.4,4847,5233,386
5049,AR,Fulton,,2010,7.5,4778,5167,389
5049,AR,Fulton,,2011,7.4,4727,5105,378
5049,AR,Fulton,,2012,6.9,4775,5130,355
5049,AR,Fulton,,2013,6.7,4613,4946,333
5049,AR,Fulton,,2014,5.7,4549,4823,274
5049,AR,Fulton,,2015,5.1,4534,4779,245
5049,AR,Fulton,,2016,4.3,4472,4675,203
5049,AR,Fulton,,2017,4.2,4518,4718,200
5049,AR,Fulton,,2018,3.9,4627,4817,190
5049,AR,Fulton,,2019,3.9,4788,4983,195
5049,AR,Fulton,,2020,5.2,4675,4929,254
5049,AR,Fulton,,2021,3.6,4711,4889,178
5051,AR,Garland,,2007,5.6,39798,42151,2353
5051,AR,Garland,,2008,5.6,39876,42236,2360
5051,AR,Garland,,2009,7.5,39205,42392,3187
5051,AR,Garland,,2010,8.1,38130,41504,3374
5051,AR,Garland,,2011,8.3,38097,41566,3469
5051,AR,Garland,,2012,7.6,38227,41366,3139
5051,AR,Garland,,2013,7.4,38029,41064,3035
5051,AR,Garland,,2014,6.2,38129,40645,2516
5051,AR,Garland,,2015,5.4,37950,40111,2161
5051,AR,Garland,,2016,4.3,38421,40152,1731
5051,AR,Garland,,2017,4.1,38691,40330,1639
5051,AR,Garland,,2018,4,39159,40777,1618
5051,AR,Garland,,2019,3.6,39983,41490,1507
5051,AR,Garland,,2020,8,38009,41320,3311
5051,AR,Garland,,2021,5,38500,40528,2028
5053,AR,Grant,,2007,5,8045,8471,426
5053,AR,Grant,,2008,5.2,8137,8581,444
5053,AR,Grant,,2009,7,7889,8485,596
5053,AR,Grant,,2010,6.8,7978,8561,583
5053,AR,Grant,,2011,7,7922,8522,600
5053,AR,Grant,,2012,6.5,7909,8462,553
5053,AR,Grant,,2013,6.4,7791,8322,531
5053,AR,Grant,,2014,5.3,7844,8287,443
5053,AR,Grant,,2015,4.5,7921,8293,372
5053,AR,Grant,,2016,3.6,7989,8288,299
5053,AR,Grant,,2017,3.2,8053,8323,270
5053,AR,Grant,,2018,3.1,8070,8324,254
5053,AR,Grant,,2019,3.1,8170,8432,262
5053,AR,Grant,,2020,5.2,7858,8289,431
5053,AR,Grant,,2021,3.2,7886,8146,260
5055,AR,Greene,,2007,6.6,17212,18430,1218
5055,AR,Greene,,2008,6.5,17653,18882,1229
5055,AR,Greene,,2009,9.9,16830,18683,1853
5055,AR,Greene,,2010,9.4,17804,19641,1837
5055,AR,Greene,,2011,9.3,18169,20021,1852
5055,AR,Greene,,2012,8.3,18413,20077,1664
5055,AR,Greene,,2013,7.7,18024,19525,1501
5055,AR,Greene,,2014,6.2,18553,19777,1224
5055,AR,Greene,,2015,5.1,19012,20036,1024
5055,AR,Greene,,2016,4.3,18987,19839,852
5055,AR,Greene,,2017,3.7,18987,19718,731
5055,AR,Greene,,2018,3.4,19145,19824,679
5055,AR,Greene,,2019,3.4,19385,20067,682
5055,AR,Greene,,2020,6,18430,19601,1171
5055,AR,Greene,,2021,3.4,18655,19318,663
5057,AR,Hempstead,,2007,6,10183,10831,648
5057,AR,Hempstead,,2008,5.7,9988,10597,609
5057,AR,Hempstead,,2009,8.1,9790,10658,868
5057,AR,Hempstead,,2010,8.9,9740,10693,953
5057,AR,Hempstead,,2011,8.4,10080,11003,923
5057,AR,Hempstead,,2012,7,10162,10925,763
5057,AR,Hempstead,,2013,7.1,9466,10184,718
5057,AR,Hempstead,,2014,5.8,9473,10056,583
5057,AR,Hempstead,,2015,4.8,9483,9965,482
5057,AR,Hempstead,,2016,3.8,9643,10019,376
5057,AR,Hempstead,,2017,3.5,9551,9893,342
5057,AR,Hempstead,,2018,3.4,9597,9939,342
5057,AR,Hempstead,,2019,3.7,9555,9925,370
5057,AR,Hempstead,,2020,5.2,9125,9628,503
5057,AR,Hempstead,,2021,3.5,8862,9182,320
5059,AR,Hot Spring,,2007,5.4,14443,15268,825
5059,AR,Hot Spring,,2008,6.5,14033,15014,981
5059,AR,Hot Spring,,2009,8.5,13976,15273,1297
5059,AR,Hot Spring,,2010,8.3,13051,14225,1174
5059,AR,Hot Spring,,2011,7.9,13434,14581,1147
5059,AR,Hot Spring,,2012,6.9,13592,14600,1008
5059,AR,Hot Spring,,2013,7.1,13228,14238,1010
5059,AR,Hot Spring,,2014,5.6,13327,14124,797
5059,AR,Hot Spring,,2015,5,13552,14260,708
5059,AR,Hot Spring,,2016,3.9,13582,14139,557
5059,AR,Hot Spring,,2017,3.7,13592,14117,525
5059,AR,Hot Spring,,2018,3.7,13433,13950,517
5059,AR,Hot Spring,,2019,3.5,13565,14063,498
5059,AR,Hot Spring,,2020,5.8,13256,14075,819
5059,AR,Hot Spring,,2021,3.9,13264,13797,533
5061,AR,Howard,,2007,5.5,6013,6365,352
5061,AR,Howard,,2008,5.5,5952,6298,346
5061,AR,Howard,,2009,7.9,5710,6201,491
5061,AR,Howard,,2010,7.4,6086,6575,489
5061,AR,Howard,,2011,7.1,6265,6746,481
5061,AR,Howard,,2012,6.4,6080,6496,416
5061,AR,Howard,,2013,6.2,5903,6295,392
5061,AR,Howard,,2014,5.7,5900,6254,354
5061,AR,Howard,,2015,4.2,5856,6110,254
5061,AR,Howard,,2016,3.3,5793,5989,196
5061,AR,Howard,,2017,3,5805,5987,182
5061,AR,Howard,,2018,3.4,5701,5901,200
5061,AR,Howard,,2019,3.2,5511,5691,180
5061,AR,Howard,,2020,5,5273,5553,280
5061,AR,Howard,,2021,3.2,5278,5455,177
5063,AR,Independence,,2007,6.3,16086,17161,1075
5063,AR,Independence,,2008,6.9,15728,16900,1172
5063,AR,Independence,,2009,8.7,15349,16805,1456
5063,AR,Independence,,2010,8.5,15596,17042,1446
5063,AR,Independence,,2011,8.9,15154,16639,1485
5063,AR,Independence,,2012,8.8,14708,16133,1425
5063,AR,Independence,,2013,8.8,14492,15889,1397
5063,AR,Independence,,2014,7.6,14403,15590,1187
5063,AR,Independence,,2015,6.4,14731,15733,1002
5063,AR,Independence,,2016,5,15243,16039,796
5063,AR,Independence,,2017,4.3,15451,16140,689
5063,AR,Independence,,2018,4,15632,16282,650
5063,AR,Independence,,2019,3.9,15940,16586,646
5063,AR,Independence,,2020,5.8,15770,16737,967
5063,AR,Independence,,2021,3.9,15734,16368,634
5065,AR,Izard,,2007,6,5051,5372,321
5065,AR,Izard,,2008,6.7,5045,5405,360
5065,AR,Izard,,2009,9,4844,5326,482
5065,AR,Izard,,2010,9.7,4634,5132,498
5065,AR,Izard,,2011,9.5,4710,5203,493
5065,AR,Izard,,2012,8.4,4748,5186,438
5065,AR,Izard,,2013,8.4,4606,5029,423
5065,AR,Izard,,2014,7.4,4587,4952,365
5065,AR,Izard,,2015,6.5,4673,4999,326
5065,AR,Izard,,2016,5.6,4696,4976,280
5065,AR,Izard,,2017,5.6,4609,4880,271
5065,AR,Izard,,2018,5.4,4605,4868,263
5065,AR,Izard,,2019,5.3,4645,4907,262
5065,AR,Izard,,2020,8.5,4261,4655,394
5065,AR,Izard,,2021,5.4,4146,4382,236
5067,AR,Jackson,,2007,7.6,7192,7787,595
5067,AR,Jackson,,2008,7.7,7224,7826,602
5067,AR,Jackson,,2009,10.8,6787,7609,822
5067,AR,Jackson,,2010,11.4,5950,6719,769
5067,AR,Jackson,,2011,11.1,5931,6674,743
5067,AR,Jackson,,2012,10.4,5819,6492,673
5067,AR,Jackson,,2013,10.6,5638,6309,671
5067,AR,Jackson,,2014,9,5669,6231,562
5067,AR,Jackson,,2015,7.4,5750,6212,462
5067,AR,Jackson,,2016,6.2,5689,6068,379
5067,AR,Jackson,,2017,5.9,5533,5880,347
5067,AR,Jackson,,2018,6,5431,5776,345
5067,AR,Jackson,,2019,6.4,5443,5814,371
5067,AR,Jackson,,2020,7.2,5428,5852,424
5067,AR,Jackson,,2021,5.2,5343,5637,294
5069,AR,Jefferson,,2007,7.6,32441,35111,2670
5069,AR,Jefferson,,2008,7.6,32236,34882,2646
5069,AR,Jefferson,,2009,9.7,32033,35472,3439
5069,AR,Jefferson,,2010,10.1,30505,33924,3419
5069,AR,Jefferson,,2011,10.7,29954,33538,3584
5069,AR,Jefferson,,2012,9.6,29435,32576,3141
5069,AR,Jefferson,,2013,10.1,28041,31183,3142
5069,AR,Jefferson,,2014,8.6,27170,29713,2543
5069,AR,Jefferson,,2015,7,26872,28882,2010
5069,AR,Jefferson,,2016,5.6,26779,28373,1594
5069,AR,Jefferson,,2017,5.2,26535,27995,1460
5069,AR,Jefferson,,2018,5.2,26567,28011,1444
5069,AR,Jefferson,,2019,5.3,26188,27665,1477
5069,AR,Jefferson,,2020,8.1,25079,27287,2208
5069,AR,Jefferson,,2021,6.6,24413,26128,1715
5071,AR,Johnson,,2007,4.9,10735,11287,552
5071,AR,Johnson,,2008,4.7,10945,11483,538
5071,AR,Johnson,,2009,7.1,10700,11517,817
5071,AR,Johnson,,2010,7.9,10103,10972,869
5071,AR,Johnson,,2011,7.5,10274,11107,833
5071,AR,Johnson,,2012,7.1,10111,10879,768
5071,AR,Johnson,,2013,7.4,9839,10631,792
5071,AR,Johnson,,2014,6.4,9716,10380,664
5071,AR,Johnson,,2015,5.7,9854,10446,592
5071,AR,Johnson,,2016,4.8,10049,10551,502
5071,AR,Johnson,,2017,4.3,10120,10575,455
5071,AR,Johnson,,2018,4.5,9922,10389,467
5071,AR,Johnson,,2019,4.5,9820,10279,459
5071,AR,Johnson,,2020,6.3,9498,10140,642
5071,AR,Johnson,,2021,4.7,9373,9835,462
5073,AR,Lafayette,,2007,7.6,2866,3101,235
5073,AR,Lafayette,,2008,7,2818,3030,212
5073,AR,Lafayette,,2009,9.4,2698,2978,280
5073,AR,Lafayette,,2010,9.4,2785,3073,288
5073,AR,Lafayette,,2011,9.1,2742,3017,275
5073,AR,Lafayette,,2012,9,2662,2925,263
5073,AR,Lafayette,,2013,9.3,2531,2790,259
5073,AR,Lafayette,,2014,7.5,2507,2711,204
5073,AR,Lafayette,,2015,7.4,2461,2658,197
5073,AR,Lafayette,,2016,5.8,2435,2586,151
5073,AR,Lafayette,,2017,5,2410,2538,128
5073,AR,Lafayette,,2018,5.1,2362,2489,127
5073,AR,Lafayette,,2019,4.5,2347,2458,111
5073,AR,Lafayette,,2020,7.7,2233,2419,186
5073,AR,Lafayette,,2021,5.8,2192,2327,135
5075,AR,Lawrence,,2007,7,6795,7303,508
5075,AR,Lawrence,,2008,7.1,6704,7213,509
5075,AR,Lawrence,,2009,9.1,6628,7289,661
5075,AR,Lawrence,,2010,9.2,6752,7433,681
5075,AR,Lawrence,,2011,9.4,6772,7474,702
5075,AR,Lawrence,,2012,8.7,6664,7300,636
5075,AR,Lawrence,,2013,8.6,6567,7188,621
5075,AR,Lawrence,,2014,7.1,6625,7129,504
5075,AR,Lawrence,,2015,5.9,6655,7075,420
5075,AR,Lawrence,,2016,4.3,6628,6929,301
5075,AR,Lawrence,,2017,3.8,6596,6856,260
5075,AR,Lawrence,,2018,3.9,6556,6820,264
5075,AR,Lawrence,,2019,4,6566,6842,276
5075,AR,Lawrence,,2020,6.2,6377,6797,420
5075,AR,Lawrence,,2021,4.3,6414,6700,286
5077,AR,Lee,,2007,9.5,3247,3588,341
5077,AR,Lee,,2008,8.5,3269,3571,302
5077,AR,Lee,,2009,9.1,3200,3520,320
5077,AR,Lee,,2010,8.2,3395,3699,304
5077,AR,Lee,,2011,9.1,3342,3675,333
5077,AR,Lee,,2012,9.1,3212,3532,320
5077,AR,Lee,,2013,9.1,3028,3330,302
5077,AR,Lee,,2014,7.4,3033,3274,241
5077,AR,Lee,,2015,6.6,2984,3194,210
5077,AR,Lee,,2016,4.7,2951,3098,147
5077,AR,Lee,,2017,4.9,2825,2969,144
5077,AR,Lee,,2018,4.7,2762,2899,137
5077,AR,Lee,,2019,4.4,2700,2824,124
5077,AR,Lee,,2020,7.7,2536,2747,211
5077,AR,Lee,,2021,5.6,2411,2554,143
5079,AR,Lincoln,,2007,8,4582,4978,396
5079,AR,Lincoln,,2008,8,4548,4944,396
5079,AR,Lincoln,,2009,9.8,4481,4966,485
5079,AR,Lincoln,,2010,9.1,4268,4693,425
5079,AR,Lincoln,,2011,8.9,4331,4756,425
5079,AR,Lincoln,,2012,8.4,4215,4602,387
5079,AR,Lincoln,,2013,8.1,4023,4378,355
5079,AR,Lincoln,,2014,6.9,3952,4246,294
5079,AR,Lincoln,,2015,6.1,3892,4143,251
5079,AR,Lincoln,,2016,4.8,3904,4102,198
5079,AR,Lincoln,,2017,4.2,3882,4052,170
5079,AR,Lincoln,,2018,4.2,3839,4008,169
5079,AR,Lincoln,,2019,4.2,3738,3903,165
5079,AR,Lincoln,,2020,6,3637,3868,231
5079,AR,Lincoln,,2021,4.6,3558,3729,171
5081,AR,Little River,,2007,4.2,6176,6449,273
5081,AR,Little River,,2008,3.9,6403,6662,259
5081,AR,Little River,,2009,5.9,6347,6748,401
5081,AR,Little River,,2010,7.5,5750,6213,463
5081,AR,Little River,,2011,7.5,5658,6114,456
5081,AR,Little River,,2012,7,5584,6005,421
5081,AR,Little River,,2013,7.4,5315,5741,426
5081,AR,Little River,,2014,6.4,5228,5587,359
5081,AR,Little River,,2015,5.4,5315,5617,302
5081,AR,Little River,,2016,4.7,5339,5602,263
5081,AR,Little River,,2017,4.9,5230,5498,268
5081,AR,Little River,,2018,5.2,5177,5460,283
5081,AR,Little River,,2019,4.2,5297,5529,232
5081,AR,Little River,,2020,6.5,5003,5353,350
5081,AR,Little River,,2021,4.5,5015,5250,235
5083,AR,Logan,,2007,5.1,9904,10432,528
5083,AR,Logan,,2008,6.5,9633,10300,667
5083,AR,Logan,,2009,9.1,9158,10076,918
5083,AR,Logan,,2010,8.2,8988,9795,807
5083,AR,Logan,,2011,8.4,8809,9616,807
5083,AR,Logan,,2012,7.7,8922,9664,742
5083,AR,Logan,,2013,7.6,8593,9298,705
5083,AR,Logan,,2014,5.8,8616,9150,534
5083,AR,Logan,,2015,5.7,8682,9204,522
5083,AR,Logan,,2016,4.6,8724,9145,421
5083,AR,Logan,,2017,3.9,8553,8897,344
5083,AR,Logan,,2018,4,8389,8734,345
5083,AR,Logan,,2019,4.2,8168,8530,362
5083,AR,Logan,,2020,6.7,8085,8664,579
5083,AR,Logan,,2021,4.2,8033,8383,350
5085,AR,Lonoke,,2007,4.4,29891,31278,1387
5085,AR,Lonoke,,2008,4.4,30625,32049,1424
5085,AR,Lonoke,,2009,6.2,30230,32219,1989
5085,AR,Lonoke,,2010,6.5,31105,33265,2160
5085,AR,Lonoke,,2011,6.6,31099,33304,2205
5085,AR,Lonoke,,2012,6.1,31210,33234,2024
5085,AR,Lonoke,,2013,5.9,31033,32996,1963
5085,AR,Lonoke,,2014,5,31356,33001,1645
5085,AR,Lonoke,,2015,4.1,31769,33138,1369
5085,AR,Lonoke,,2016,3.3,32327,33442,1115
5085,AR,Lonoke,,2017,3.3,32727,33840,1113
5085,AR,Lonoke,,2018,3.1,33096,34165,1069
5085,AR,Lonoke,,2019,3.2,33199,34281,1082
5085,AR,Lonoke,,2020,5.6,31886,33761,1875
5085,AR,Lonoke,,2021,3.3,32034,33141,1107
5087,AR,Madison,,2007,4.1,7357,7675,318
5087,AR,Madison,,2008,4.4,7327,7661,334
5087,AR,Madison,,2009,6.7,6876,7367,491
5087,AR,Madison,,2010,6.8,6771,7265,494
5087,AR,Madison,,2011,6.4,6748,7213,465
5087,AR,Madison,,2012,5.6,6611,7005,394
5087,AR,Madison,,2013,5.7,6510,6900,390
5087,AR,Madison,,2014,4.7,6691,7023,332
5087,AR,Madison,,2015,3.8,6843,7113,270
5087,AR,Madison,,2016,3.2,7063,7297,234
5087,AR,Madison,,2017,2.9,7157,7369,212
5087,AR,Madison,,2018,2.9,7133,7343,210
5087,AR,Madison,,2019,2.5,7225,7411,186
5087,AR,Madison,,2020,4,7001,7292,291
5087,AR,Madison,,2021,3.1,7142,7373,231
5089,AR,Marion,,2007,5.5,6575,6957,382
5089,AR,Marion,,2008,6.2,6446,6873,427
5089,AR,Marion,,2009,11.7,5900,6679,779
5089,AR,Marion,,2010,9.8,6051,6706,655
5089,AR,Marion,,2011,9,6118,6721,603
5089,AR,Marion,,2012,7.9,6109,6633,524
5089,AR,Marion,,2013,7.5,6059,6549,490
5089,AR,Marion,,2014,6.1,6178,6582,404
5089,AR,Marion,,2015,5.1,6217,6552,335
5089,AR,Marion,,2016,4,6271,6532,261
5089,AR,Marion,,2017,4,6221,6478,257
5089,AR,Marion,,2018,4.1,6225,6489,264
5089,AR,Marion,,2019,3.9,6407,6668,261
5089,AR,Marion,,2020,6.5,5860,6265,405
5089,AR,Marion,,2021,4.3,5829,6089,260
5091,AR,Miller,,2007,4.5,18638,19523,885
5091,AR,Miller,,2008,4,19187,19988,801
5091,AR,Miller,,2009,5.6,18769,19876,1107
5091,AR,Miller,,2010,5.6,19406,20554,1148
5091,AR,Miller,,2011,6.1,19468,20723,1255
5091,AR,Miller,,2012,5.7,19195,20358,1163
5091,AR,Miller,,2013,6.3,18441,19673,1232
5091,AR,Miller,,2014,5.7,18411,19522,1111
5091,AR,Miller,,2015,4.9,19007,19993,986
5091,AR,Miller,,2016,4.2,19067,19904,837
5091,AR,Miller,,2017,4.4,18894,19758,864
5091,AR,Miller,,2018,4.8,18583,19511,928
5091,AR,Miller,,2019,4,18959,19751,792
5091,AR,Miller,,2020,6.9,18003,19343,1340
5091,AR,Miller,,2021,4.8,18074,18987,913
5093,AR,Mississippi,,2007,7.4,19755,21330,1575
5093,AR,Mississippi,,2008,7.6,20119,21776,1657
5093,AR,Mississippi,,2009,13.8,18477,21428,2951
5093,AR,Mississippi,,2010,11.9,17940,20369,2429
5093,AR,Mississippi,,2011,11.5,18453,20852,2399
5093,AR,Mississippi,,2012,10.5,18179,20319,2140
5093,AR,Mississippi,,2013,11.1,16978,19088,2110
5093,AR,Mississippi,,2014,9,17473,19205,1732
5093,AR,Mississippi,,2015,8.9,16774,18412,1638
5093,AR,Mississippi,,2016,6.8,16869,18099,1230
5093,AR,Mississippi,,2017,6,16718,17782,1064
5093,AR,Mississippi,,2018,5.6,16369,17336,967
5093,AR,Mississippi,,2019,5,16518,17384,866
5093,AR,Mississippi,,2020,9.1,15704,17269,1565
5093,AR,Mississippi,,2021,7.2,15141,16310,1169
5095,AR,Monroe,,2007,6.8,3584,3846,262
5095,AR,Monroe,,2008,6.4,3568,3810,242
5095,AR,Monroe,,2009,8,3405,3702,297
5095,AR,Monroe,,2010,8.9,3107,3410,303
5095,AR,Monroe,,2011,9.1,3075,3381,306
5095,AR,Monroe,,2012,8.6,3000,3284,284
5095,AR,Monroe,,2013,8.5,2873,3141,268
5095,AR,Monroe,,2014,6.6,2911,3116,205
5095,AR,Monroe,,2015,6,2808,2986,178
5095,AR,Monroe,,2016,4.8,2747,2886,139
5095,AR,Monroe,,2017,4.3,2678,2798,120
5095,AR,Monroe,,2018,4.2,2626,2741,115
5095,AR,Monroe,,2019,4.2,2640,2755,115
5095,AR,Monroe,,2020,6.6,2541,2722,181
5095,AR,Monroe,,2021,5.3,2482,2621,139
5097,AR,Montgomery,,2007,5.4,3980,4205,225
5097,AR,Montgomery,,2008,5.6,3917,4150,233
5097,AR,Montgomery,,2009,7,3863,4152,289
5097,AR,Montgomery,,2010,8.4,3602,3931,329
5097,AR,Montgomery,,2011,8.8,3493,3832,339
5097,AR,Montgomery,,2012,8.1,3326,3620,294
5097,AR,Montgomery,,2013,8.2,3177,3459,282
5097,AR,Montgomery,,2014,7.7,3137,3400,263
5097,AR,Montgomery,,2015,6.6,3054,3271,217
5097,AR,Montgomery,,2016,5.1,2972,3133,161
5097,AR,Montgomery,,2017,4.8,2943,3092,149
5097,AR,Montgomery,,2018,4.7,2908,3051,143
5097,AR,Montgomery,,2019,4.5,2845,2980,135
5097,AR,Montgomery,,2020,7,2752,2958,206
5097,AR,Montgomery,,2021,4.8,2737,2876,139
5099,AR,Nevada,,2007,5.8,4056,4304,248
5099,AR,Nevada,,2008,6.7,3940,4225,285
5099,AR,Nevada,,2009,9.2,3844,4232,388
5099,AR,Nevada,,2010,9.6,3635,4021,386
5099,AR,Nevada,,2011,9,3796,4172,376
5099,AR,Nevada,,2012,7.4,3847,4156,309
5099,AR,Nevada,,2013,7.5,3526,3812,286
5099,AR,Nevada,,2014,5.9,3513,3732,219
5099,AR,Nevada,,2015,4.9,3495,3675,180
5099,AR,Nevada,,2016,3.7,3515,3650,135
5099,AR,Nevada,,2017,3.6,3475,3603,128
5099,AR,Nevada,,2018,3.4,3521,3646,125
5099,AR,Nevada,,2019,3.9,3514,3655,141
5099,AR,Nevada,,2020,5.9,3336,3545,209
5099,AR,Nevada,,2021,4,3237,3373,136
5101,AR,Newton,,2007,5.2,3294,3473,179
5101,AR,Newton,,2008,5.6,3263,3458,195
5101,AR,Newton,,2009,7.9,3175,3446,271
5101,AR,Newton,,2010,6.7,3536,3788,252
5101,AR,Newton,,2011,7.1,3515,3785,270
5101,AR,Newton,,2012,7.1,3387,3644,257
5101,AR,Newton,,2013,6.8,3274,3511,237
5101,AR,Newton,,2014,5.7,3195,3388,193
5101,AR,Newton,,2015,4.8,3246,3409,163
5101,AR,Newton,,2016,3.9,3284,3417,133
5101,AR,Newton,,2017,3.6,3201,3322,121
5101,AR,Newton,,2018,3.3,3191,3301,110
5101,AR,Newton,,2019,3.4,3209,3323,114
5101,AR,Newton,,2020,5.1,3023,3186,163
5101,AR,Newton,,2021,3,3085,3182,97
5103,AR,Ouachita,,2007,7.4,11017,11895,878
5103,AR,Ouachita,,2008,6.3,11076,11826,750
5103,AR,Ouachita,,2009,7.9,11129,12086,957
5103,AR,Ouachita,,2010,9.1,10346,11386,1040
5103,AR,Ouachita,,2011,10,9982,11090,1108
5103,AR,Ouachita,,2012,10,9550,10614,1064
5103,AR,Ouachita,,2013,9.4,9406,10380,974
5103,AR,Ouachita,,2014,7.7,9304,10085,781
5103,AR,Ouachita,,2015,6.2,9357,9977,620
5103,AR,Ouachita,,2016,5,9399,9897,498
5103,AR,Ouachita,,2017,4.6,9275,9722,447
5103,AR,Ouachita,,2018,4.5,9313,9756,443
5103,AR,Ouachita,,2019,5,9351,9846,495
5103,AR,Ouachita,,2020,6.1,9243,9840,597
5103,AR,Ouachita,,2021,3.9,9340,9716,376
5105,AR,Perry,,2007,4.9,4535,4770,235
5105,AR,Perry,,2008,5.6,4495,4760,265
5105,AR,Perry,,2009,7.8,4340,4705,365
5105,AR,Perry,,2010,8.6,4163,4554,391
5105,AR,Perry,,2011,8.9,4095,4495,400
5105,AR,Perry,,2012,8.7,4044,4429,385
5105,AR,Perry,,2013,9.1,3986,4385,399
5105,AR,Perry,,2014,7.5,3940,4261,321
5105,AR,Perry,,2015,6,3963,4218,255
5105,AR,Perry,,2016,4.8,3974,4174,200
5105,AR,Perry,,2017,4.2,4068,4246,178
5105,AR,Perry,,2018,4.1,4071,4245,174
5105,AR,Perry,,2019,4,4141,4313,172
5105,AR,Perry,,2020,5.6,3899,4132,233
5105,AR,Perry,,2021,4.1,3924,4092,168
5107,AR,Phillips,,2007,7.4,8282,8941,659
5107,AR,Phillips,,2008,7.1,8295,8930,635
5107,AR,Phillips,,2009,9.4,7977,8803,826
5107,AR,Phillips,,2010,10.2,7699,8572,873
5107,AR,Phillips,,2011,11.6,7415,8391,976
5107,AR,Phillips,,2012,11.1,7100,7990,890
5107,AR,Phillips,,2013,11.1,6785,7633,848
5107,AR,Phillips,,2014,9.4,6593,7277,684
5107,AR,Phillips,,2015,7.5,6498,7023,525
5107,AR,Phillips,,2016,5.9,6274,6668,394
5107,AR,Phillips,,2017,5.8,6151,6532,381
5107,AR,Phillips,,2018,6,6178,6572,394
5107,AR,Phillips,,2019,5.8,5992,6361,369
5107,AR,Phillips,,2020,9.2,5723,6303,580
5107,AR,Phillips,,2021,7.7,5412,5865,453
5109,AR,Pike,,2007,5.7,4873,5170,297
5109,AR,Pike,,2008,6,4753,5056,303
5109,AR,Pike,,2009,7.6,4650,5030,380
5109,AR,Pike,,2010,8.7,4475,4900,425
5109,AR,Pike,,2011,9.4,4248,4691,443
5109,AR,Pike,,2012,8.6,4052,4433,381
5109,AR,Pike,,2013,8.5,3898,4260,362
5109,AR,Pike,,2014,7.1,3970,4273,303
5109,AR,Pike,,2015,5.8,3987,4231,244
5109,AR,Pike,,2016,4.3,4048,4228,180
5109,AR,Pike,,2017,4,4120,4293,173
5109,AR,Pike,,2018,4,4124,4297,173
5109,AR,Pike,,2019,3.7,4089,4248,159
5109,AR,Pike,,2020,5.9,4016,4270,254
5109,AR,Pike,,2021,4.4,3999,4183,184
5111,AR,Poinsett,,2007,7.4,9986,10779,793
5111,AR,Poinsett,,2008,6.4,9979,10657,678
5111,AR,Poinsett,,2009,8.8,9579,10498,919
5111,AR,Poinsett,,2010,9,9758,10722,964
5111,AR,Poinsett,,2011,9.1,9775,10755,980
5111,AR,Poinsett,,2012,8.3,9556,10423,867
5111,AR,Poinsett,,2013,8.2,9360,10198,838
5111,AR,Poinsett,,2014,6.8,9489,10177,688
5111,AR,Poinsett,,2015,5.5,9548,10105,557
5111,AR,Poinsett,,2016,4.3,9675,10108,433
5111,AR,Poinsett,,2017,4.2,9826,10255,429
5111,AR,Poinsett,,2018,3.8,9746,10130,384
5111,AR,Poinsett,,2019,3.4,9698,10037,339
5111,AR,Poinsett,,2020,5.6,9206,9753,547
5111,AR,Poinsett,,2021,3.9,9299,9676,377
5113,AR,Polk,,2007,5,8345,8783,438
5113,AR,Polk,,2008,5.1,8356,8806,450
5113,AR,Polk,,2009,7.5,8101,8762,661
5113,AR,Polk,,2010,7.2,8367,9012,645
5113,AR,Polk,,2011,7.6,8246,8929,683
5113,AR,Polk,,2012,7.1,8148,8772,624
5113,AR,Polk,,2013,7,7950,8545,595
5113,AR,Polk,,2014,6.1,8024,8546,522
5113,AR,Polk,,2015,5.7,7887,8362,475
5113,AR,Polk,,2016,4.9,7794,8194,400
5113,AR,Polk,,2017,4.5,7665,8027,362
5113,AR,Polk,,2018,4.1,7737,8064,327
5113,AR,Polk,,2019,4.1,7748,8079,331
5113,AR,Polk,,2020,6.7,7468,8005,537
5113,AR,Polk,,2021,4.4,7428,7771,343
5115,AR,Pope,,2007,4.8,28420,29863,1443
5115,AR,Pope,,2008,4.9,28654,30116,1462
5115,AR,Pope,,2009,7.4,27263,29455,2192
5115,AR,Pope,,2010,7.5,27834,30095,2261
5115,AR,Pope,,2011,7.4,28246,30519,2273
5115,AR,Pope,,2012,7,28091,30198,2107
5115,AR,Pope,,2013,7.1,27768,29901,2133
5115,AR,Pope,,2014,6.1,28094,29921,1827
5115,AR,Pope,,2015,5.2,28333,29886,1553
5115,AR,Pope,,2016,4.6,27981,29332,1351
5115,AR,Pope,,2017,4.5,27789,29089,1300
5115,AR,Pope,,2018,4.4,27710,28978,1268
5115,AR,Pope,,2019,4.2,27848,29068,1220
5115,AR,Pope,,2020,5.9,26218,27870,1652
5115,AR,Pope,,2021,4,26186,27266,1080
5117,AR,Prairie,,2007,5.8,4121,4376,255
5117,AR,Prairie,,2008,5.6,4123,4369,246
5117,AR,Prairie,,2009,7.8,3944,4276,332
5117,AR,Prairie,,2010,8.9,3613,3964,351
5117,AR,Prairie,,2011,8.3,3591,3916,325
5117,AR,Prairie,,2012,7.3,3563,3842,279
5117,AR,Prairie,,2013,6.9,3564,3827,263
5117,AR,Prairie,,2014,5.6,3624,3841,217
5117,AR,Prairie,,2015,4.6,3571,3744,173
5117,AR,Prairie,,2016,3.8,3516,3656,140
5117,AR,Prairie,,2017,4.1,3544,3696,152
5117,AR,Prairie,,2018,3.8,3420,3555,135
5117,AR,Prairie,,2019,4.2,3459,3611,152
5117,AR,Prairie,,2020,5.4,3417,3611,194
5117,AR,Prairie,,2021,3.7,3397,3527,130
5119,AR,Pulaski,,2007,4.8,179494,188562,9068
5119,AR,Pulaski,,2008,4.7,180574,189490,8916
5119,AR,Pulaski,,2009,6.6,176754,189196,12442
5119,AR,Pulaski,,2010,7,175899,189160,13261
5119,AR,Pulaski,,2011,7.1,175745,189186,13441
5119,AR,Pulaski,,2012,6.6,176846,189310,12464
5119,AR,Pulaski,,2013,6.4,175881,187838,11957
5119,AR,Pulaski,,2014,5.4,175968,185985,10017
5119,AR,Pulaski,,2015,4.5,178413,186837,8424
5119,AR,Pulaski,,2016,3.6,180752,187419,6667
5119,AR,Pulaski,,2017,3.4,181973,188436,6463
5119,AR,Pulaski,,2018,3.4,181973,188411,6438
5119,AR,Pulaski,,2019,3.3,183378,189699,6321
5119,AR,Pulaski,,2020,7.4,174991,189050,14059
5119,AR,Pulaski,,2021,4.9,175806,184896,9090
5121,AR,Randolph,,2007,9.4,6856,7568,712
5121,AR,Randolph,,2008,8.1,6889,7497,608
5121,AR,Randolph,,2009,9.1,6935,7631,696
5121,AR,Randolph,,2010,9.9,6530,7246,716
5121,AR,Randolph,,2011,10.8,6376,7146,770
5121,AR,Randolph,,2012,10.4,6175,6891,716
5121,AR,Randolph,,2013,9.3,6103,6727,624
5121,AR,Randolph,,2014,7.7,6084,6592,508
5121,AR,Randolph,,2015,7,5772,6209,437
5121,AR,Randolph,,2016,4.6,6232,6534,302
5121,AR,Randolph,,2017,4.2,6632,6922,290
5121,AR,Randolph,,2018,3.9,6879,7161,282
5121,AR,Randolph,,2019,3.8,7036,7313,277
5121,AR,Randolph,,2020,5.9,7006,7449,443
5121,AR,Randolph,,2021,3.9,7025,7313,288
5123,AR,St. Francis,,2007,9.8,9409,10427,1018
5123,AR,St. Francis,,2008,9.3,9335,10292,957
5123,AR,St. Francis,,2009,10.3,9281,10343,1062
5123,AR,St. Francis,,2010,10.3,8806,9815,1009
5123,AR,St. Francis,,2011,10.6,8747,9789,1042
5123,AR,St. Francis,,2012,10.4,8536,9527,991
5123,AR,St. Francis,,2013,10.2,8284,9220,936
5123,AR,St. Francis,,2014,8.5,8274,9044,770
5123,AR,St. Francis,,2015,7.1,8351,8992,641
5123,AR,St. Francis,,2016,5.2,8394,8855,461
5123,AR,St. Francis,,2017,5.1,7937,8360,423
5123,AR,St. Francis,,2018,5,7868,8284,416
5123,AR,St. Francis,,2019,5,7781,8193,412
5123,AR,St. Francis,,2020,7.9,7388,8022,634
5123,AR,St. Francis,,2021,6.2,7201,7675,474
5125,AR,Saline,,2007,4.2,46342,48397,2055
5125,AR,Saline,,2008,4.4,47224,49402,2178
5125,AR,Saline,,2009,6.5,46183,49398,3215
5125,AR,Saline,,2010,6.4,49934,53348,3414
5125,AR,Saline,,2011,6.3,50565,53987,3422
5125,AR,Saline,,2012,5.9,51443,54644,3201
5125,AR,Saline,,2013,5.6,52011,55120,3109
5125,AR,Saline,,2014,4.7,52439,55039,2600
5125,AR,Saline,,2015,4,53970,56229,2259
5125,AR,Saline,,2016,3.1,55170,56952,1782
5125,AR,Saline,,2017,3,55729,57474,1745
5125,AR,Saline,,2018,3,56890,58664,1774
5125,AR,Saline,,2019,2.7,57919,59554,1635
5125,AR,Saline,,2020,5.1,55813,58783,2970
5125,AR,Saline,,2021,3.1,56082,57900,1818
5127,AR,Scott,,2007,4.7,4588,4813,225
5127,AR,Scott,,2008,4.7,4599,4827,228
5127,AR,Scott,,2009,6.7,4564,4894,330
5127,AR,Scott,,2010,6.8,4434,4756,322
5127,AR,Scott,,2011,6.7,4529,4855,326
5127,AR,Scott,,2012,6.4,4409,4710,301
5127,AR,Scott,,2013,6.1,4373,4656,283
5127,AR,Scott,,2014,4.9,4388,4614,226
5127,AR,Scott,,2015,4.7,4333,4546,213
5127,AR,Scott,,2016,3.7,4305,4469,164
5127,AR,Scott,,2017,3.5,4279,4433,154
5127,AR,Scott,,2018,3.6,4231,4388,157
5127,AR,Scott,,2019,3.3,4188,4331,143
5127,AR,Scott,,2020,4.5,4150,4345,195
5127,AR,Scott,,2021,3.3,4076,4216,140
5129,AR,Searcy,,2007,5,3401,3579,178
5129,AR,Searcy,,2008,5.3,3399,3591,192
5129,AR,Searcy,,2009,7.6,3285,3555,270
5129,AR,Searcy,,2010,8.9,3088,3388,300
5129,AR,Searcy,,2011,8.7,3028,3318,290
5129,AR,Searcy,,2012,7.9,2977,3232,255
5129,AR,Searcy,,2013,7.8,2899,3143,244
5129,AR,Searcy,,2014,6.2,2829,3016,187
5129,AR,Searcy,,2015,5.6,2870,3039,169
5129,AR,Searcy,,2016,4.6,2857,2994,137
5129,AR,Searcy,,2017,4.7,2798,2935,137
5129,AR,Searcy,,2018,4.3,2799,2924,125
5129,AR,Searcy,,2019,4.4,2779,2908,129
5129,AR,Searcy,,2020,6.5,2692,2878,186
5129,AR,Searcy,,2021,4.2,2796,2920,124
5131,AR,Sebastian,,2007,5.2,58352,61570,3218
5131,AR,Sebastian,,2008,4.9,58413,61428,3015
5131,AR,Sebastian,,2009,7.5,55783,60333,4550
5131,AR,Sebastian,,2010,7.7,54881,59472,4591
5131,AR,Sebastian,,2011,8.3,54399,59300,4901
5131,AR,Sebastian,,2012,7.5,54791,59261,4470
5131,AR,Sebastian,,2013,7.3,54232,58482,4250
5131,AR,Sebastian,,2014,5.5,54425,57622,3197
5131,AR,Sebastian,,2015,4.7,55224,57971,2747
5131,AR,Sebastian,,2016,3.7,55543,57697,2154
5131,AR,Sebastian,,2017,3.6,55131,57208,2077
5131,AR,Sebastian,,2018,3.5,54795,56790,1995
5131,AR,Sebastian,,2019,3.2,55011,56835,1824
5131,AR,Sebastian,,2020,6,52716,56085,3369
5131,AR,Sebastian,,2021,3.7,52275,54294,2019
5133,AR,Sevier,,2007,4.2,7372,7694,322
5133,AR,Sevier,,2008,4,7240,7543,303
5133,AR,Sevier,,2009,5.8,7105,7541,436
5133,AR,Sevier,,2010,6.7,6613,7089,476
5133,AR,Sevier,,2011,8.7,5842,6402,560
5133,AR,Sevier,,2012,8.3,5706,6224,518
5133,AR,Sevier,,2013,8.1,5533,6018,485
5133,AR,Sevier,,2014,6.8,5491,5889,398
5133,AR,Sevier,,2015,6,5348,5688,340
5133,AR,Sevier,,2016,4.9,5427,5704,277
5133,AR,Sevier,,2017,4.6,5407,5665,258
5133,AR,Sevier,,2018,4.5,5341,5594,253
5133,AR,Sevier,,2019,4.7,5267,5526,259
5133,AR,Sevier,,2020,5.9,5218,5543,325
5133,AR,Sevier,,2021,4.4,5132,5368,236
5135,AR,Sharp,,2007,6.8,5929,6364,435
5135,AR,Sharp,,2008,7.5,5770,6237,467
5135,AR,Sharp,,2009,9.1,5656,6221,565
5135,AR,Sharp,,2010,9.5,5706,6302,596
5135,AR,Sharp,,2011,10.3,5617,6259,642
5135,AR,Sharp,,2012,9.8,5529,6127,598
5135,AR,Sharp,,2013,9.5,5475,6050,575
5135,AR,Sharp,,2014,8.3,5510,6006,496
5135,AR,Sharp,,2015,6.8,5618,6028,410
5135,AR,Sharp,,2016,5.5,5731,6062,331
5135,AR,Sharp,,2017,5,5660,5961,301
5135,AR,Sharp,,2018,4.7,5508,5781,273
5135,AR,Sharp,,2019,4.8,5483,5762,279
5135,AR,Sharp,,2020,7.2,5306,5717,411
5135,AR,Sharp,,2021,4.9,5353,5630,277
5137,AR,Stone,,2007,5.8,4466,4740,274
5137,AR,Stone,,2008,6.5,4378,4683,305
5137,AR,Stone,,2009,8.7,4179,4578,399
5137,AR,Stone,,2010,7.3,5115,5517,402
5137,AR,Stone,,2011,8.5,4916,5372,456
5137,AR,Stone,,2012,7.9,4670,5071,401
5137,AR,Stone,,2013,8.2,4430,4826,396
5137,AR,Stone,,2014,7.5,4382,4735,353
5137,AR,Stone,,2015,6.2,4432,4723,291
5137,AR,Stone,,2016,5.1,4504,4748,244
5137,AR,Stone,,2017,4.8,4562,4792,230
5137,AR,Stone,,2018,4.4,4574,4787,213
5137,AR,Stone,,2019,4.6,4519,4738,219
5137,AR,Stone,,2020,7.1,4295,4624,329
5137,AR,Stone,,2021,5,4303,4531,228
5139,AR,Union,,2007,7,17869,19204,1335
5139,AR,Union,,2008,6.3,17845,19046,1201
5139,AR,Union,,2009,10.2,17141,19089,1948
5139,AR,Union,,2010,11,15321,17213,1892
5139,AR,Union,,2011,10.1,15234,16952,1718
5139,AR,Union,,2012,8.9,15383,16879,1496
5139,AR,Union,,2013,8.4,15338,16740,1402
5139,AR,Union,,2014,7.2,15545,16754,1209
5139,AR,Union,,2015,6,15973,16999,1026
5139,AR,Union,,2016,5.5,15504,16401,897
5139,AR,Union,,2017,5.3,15239,16093,854
5139,AR,Union,,2018,5.4,15097,15963,866
5139,AR,Union,,2019,5.1,14989,15796,807
5139,AR,Union,,2020,8.4,14310,15615,1305
5139,AR,Union,,2021,6.1,14114,15025,911
5141,AR,Van Buren,,2007,6,6545,6964,419
5141,AR,Van Buren,,2008,6.6,6533,6991,458
5141,AR,Van Buren,,2009,10.3,6275,6997,722
5141,AR,Van Buren,,2010,10.8,5768,6469,701
5141,AR,Van Buren,,2011,10.6,6021,6735,714
5141,AR,Van Buren,,2012,9.8,5980,6629,649
5141,AR,Van Buren,,2013,9.5,5910,6530,620
5141,AR,Van Buren,,2014,7.9,5988,6503,515
5141,AR,Van Buren,,2015,6.6,6026,6453,427
5141,AR,Van Buren,,2016,6.9,5692,6113,421
5141,AR,Van Buren,,2017,5.5,5708,6040,332
5141,AR,Van Buren,,2018,5.2,5577,5883,306
5141,AR,Van Buren,,2019,4.9,5500,5781,281
5141,AR,Van Buren,,2020,7.2,5354,5767,413
5141,AR,Van Buren,,2021,4.9,5521,5803,282
5143,AR,Washington,,2007,3.9,99365,103418,4053
5143,AR,Washington,,2008,4.2,98272,102564,4292
5143,AR,Washington,,2009,6.2,92956,99100,6144
5143,AR,Washington,,2010,6.3,96374,102805,6431
5143,AR,Washington,,2011,6,98139,104405,6266
5143,AR,Washington,,2012,5.4,100201,105913,5712
5143,AR,Washington,,2013,5.2,101904,107521,5617
5143,AR,Washington,,2014,4.3,106301,111044,4743
5143,AR,Washington,,2015,3.5,111702,115733,4031
5143,AR,Washington,,2016,2.8,115300,118574,3274
5143,AR,Washington,,2017,2.6,117523,120668,3145
5143,AR,Washington,,2018,2.6,119317,122484,3167
5143,AR,Washington,,2019,2.4,121989,125000,3011
5143,AR,Washington,,2020,4.7,119532,125379,5847
5143,AR,Washington,,2021,2.9,122052,125728,3676
5145,AR,White,,2007,6.7,29556,31667,2111
5145,AR,White,,2008,5.9,30920,32864,1944
5145,AR,White,,2009,8.1,31176,33917,2741
5145,AR,White,,2010,7.9,33516,36409,2893
5145,AR,White,,2011,8.3,33620,36645,3025
5145,AR,White,,2012,7.5,33682,36432,2750
5145,AR,White,,2013,7.6,32619,35304,2685
5145,AR,White,,2014,6.9,32332,34720,2388
5145,AR,White,,2015,6.1,32557,34681,2124
5145,AR,White,,2016,5.2,32318,34092,1774
5145,AR,White,,2017,4.6,32090,33628,1538
5145,AR,White,,2018,4.3,32156,33604,1448
5145,AR,White,,2019,4.4,32452,33937,1485
5145,AR,White,,2020,6.3,31880,34020,2140
5145,AR,White,,2021,4,32361,33712,1351
5147,AR,Woodruff,,2007,8.8,3185,3494,309
5147,AR,Woodruff,,2008,7.9,3198,3474,276
5147,AR,Woodruff,,2009,10.9,2988,3353,365
5147,AR,Woodruff,,2010,10,3258,3621,363
5147,AR,Woodruff,,2011,10.5,3170,3540,370
5147,AR,Woodruff,,2012,9.8,3061,3393,332
5147,AR,Woodruff,,2013,9.3,2953,3254,301
5147,AR,Woodruff,,2014,7.4,2952,3189,237
5147,AR,Woodruff,,2015,6.3,2851,3043,192
5147,AR,Woodruff,,2016,5.5,2811,2974,163
5147,AR,Woodruff,,2017,4.9,2783,2925,142
5147,AR,Woodruff,,2018,4.6,2670,2800,130
5147,AR,Woodruff,,2019,5.1,2628,2770,142
5147,AR,Woodruff,,2020,5.8,2661,2826,165
5147,AR,Woodruff,,2021,5,2651,2790,139
5149,AR,Yell,,2007,4.4,10043,10500,457
5149,AR,Yell,,2008,4.5,10045,10517,472
5149,AR,Yell,,2009,8.1,9740,10599,859
5149,AR,Yell,,2010,7.8,8967,9722,755
5149,AR,Yell,,2011,7.1,8921,9604,683
5149,AR,Yell,,2012,6.4,8725,9326,601
5149,AR,Yell,,2013,6.4,8559,9142,583
5149,AR,Yell,,2014,5.5,8627,9128,501
5149,AR,Yell,,2015,5,8551,9001,450
5149,AR,Yell,,2016,4.5,8311,8700,389
5149,AR,Yell,,2017,4.1,8211,8558,347
5149,AR,Yell,,2018,4.1,8134,8484,350
5149,AR,Yell,,2019,3.9,8063,8391,328
5149,AR,Yell,,2020,5.1,7526,7933,407
5149,AR,Yell,,2021,4,7520,7831,311
6000,CA,California,,2007,5.3,16955400,17910726,955326
6000,CA,California,,2008,7.3,16856082,18179907,1323825
6000,CA,California,,2009,11.5,16193122,18305953,2112831
6000,CA,California,,2010,12.5,16078454,18370536,2292082
6000,CA,California,,2011,11.9,16220602,18406756,2186154
6000,CA,California,,2012,10.5,16541039,18484881,1943842
6000,CA,California,,2013,9,16887864,18565408,1677544
6000,CA,California,,2014,7.6,17264518,18676692,1412174
6000,CA,California,,2015,6.3,17647409,18824141,1176732
6000,CA,California,,2016,5.5,17965407,19012017,1046610
6000,CA,California,,2017,4.8,18258064,19185366,927302
6000,CA,California,,2018,4.3,18468143,19289507,821364
6000,CA,California,,2019,4.1,18612607,19409413,796806
6000,CA,California,,2020,10.2,16996666,18931116,1934450
6000,CA,California,,2021,7.3,17541944,18923194,1381250
6001,CA,Alameda,,2007,4.7,711529,746245,34716
6001,CA,Alameda,,2008,6.2,709639,756795,47156
6001,CA,Alameda,,2009,10.7,682769,764554,81785
6001,CA,Alameda,,2010,11.2,695343,782680,87337
6001,CA,Alameda,,2011,10.3,704596,785124,80528
6001,CA,Alameda,,2012,8.8,726131,796456,70325
6001,CA,Alameda,,2013,7.3,741222,799847,58625
6001,CA,Alameda,,2014,5.9,758819,806326,47507
6001,CA,Alameda,,2015,4.8,779897,819008,39111
6001,CA,Alameda,,2016,4.3,796037,831827,35790
6001,CA,Alameda,,2017,3.7,807100,838175,31075
6001,CA,Alameda,,2018,3.1,815554,841435,25881
6001,CA,Alameda,,2019,3,817355,842645,25290
6001,CA,Alameda,,2020,9,743193,816829,73636
6001,CA,Alameda,,2021,6.1,760859,809964,49105
6003,CA,Alpine,,2007,7.9,455,494,39
6003,CA,Alpine,,2008,10.5,417,466,49
6003,CA,Alpine,,2009,14.7,383,449,66
6003,CA,Alpine,,2010,13.1,471,542,71
6003,CA,Alpine,,2011,12.9,515,591,76
6003,CA,Alpine,,2012,11.2,482,543,61
6003,CA,Alpine,,2013,9.8,472,523,51
6003,CA,Alpine,,2014,8.3,467,509,42
6003,CA,Alpine,,2015,7.5,508,549,41
6003,CA,Alpine,,2016,6.5,518,554,36
6003,CA,Alpine,,2017,6.2,514,548,34
6003,CA,Alpine,,2018,4.6,522,547,25
6003,CA,Alpine,,2019,5.2,514,542,28
6003,CA,Alpine,,2020,11.7,453,513,60
6003,CA,Alpine,,2021,8.1,477,519,42
6005,CA,Amador,,2007,5.7,16707,17725,1018
6005,CA,Amador,,2008,7.7,16433,17806,1373
6005,CA,Amador,,2009,11.9,15779,17912,2133
6005,CA,Amador,,2010,14.4,13291,15523,2232
6005,CA,Amador,,2011,13.8,12988,15075,2087
6005,CA,Amador,,2012,12.5,12822,14646,1824
6005,CA,Amador,,2013,10.4,12897,14400,1503
6005,CA,Amador,,2014,8.4,13118,14321,1203
6005,CA,Amador,,2015,6.6,13366,14317,951
6005,CA,Amador,,2016,6,13658,14525,867
6005,CA,Amador,,2017,5,13958,14694,736
6005,CA,Amador,,2018,4.1,14066,14672,606
6005,CA,Amador,,2019,3.9,14243,14828,585
6005,CA,Amador,,2020,9.5,13084,14451,1367
6005,CA,Amador,,2021,7,13345,14342,997
6007,CA,Butte,,2007,6.6,94674,101348,6674
6007,CA,Butte,,2008,8.5,94144,102869,8725
6007,CA,Butte,,2009,12.8,90989,104335,13346
6007,CA,Butte,,2010,14.2,88098,102713,14615
6007,CA,Butte,,2011,13.9,86549,100530,13981
6007,CA,Butte,,2012,12.3,88363,100812,12449
6007,CA,Butte,,2013,10.4,90829,101408,10579
6007,CA,Butte,,2014,8.7,92215,101057,8842
6007,CA,Butte,,2015,7.2,93766,101066,7300
6007,CA,Butte,,2016,6.6,94909,101648,6739
6007,CA,Butte,,2017,5.8,96056,101998,5942
6007,CA,Butte,,2018,5.1,96624,101810,5186
6007,CA,Butte,,2019,5.2,93025,98096,5071
6007,CA,Butte,,2020,9.4,84291,93080,8789
6007,CA,Butte,,2021,6.9,85720,92031,6311
6009,CA,Calaveras,,2007,6.4,19431,20749,1318
6009,CA,Calaveras,,2008,8.7,18836,20632,1796
6009,CA,Calaveras,,2009,14.2,17561,20456,2895
6009,CA,Calaveras,,2010,14.8,17931,21045,3114
6009,CA,Calaveras,,2011,14.3,17699,20645,2946
6009,CA,Calaveras,,2012,12.6,17634,20166,2532
6009,CA,Calaveras,,2013,10.1,18157,20187,2030
6009,CA,Calaveras,,2014,8.1,18569,20205,1636
6009,CA,Calaveras,,2015,6.4,19231,20549,1318
6009,CA,Calaveras,,2016,5.7,19615,20798,1183
6009,CA,Calaveras,,2017,4.8,20014,21016,1002
6009,CA,Calaveras,,2018,4.1,20303,21163,860
6009,CA,Calaveras,,2019,3.9,20522,21349,827
6009,CA,Calaveras,,2020,7.9,19637,21315,1678
6009,CA,Calaveras,,2021,5.7,20177,21402,1225
6011,CA,Colusa,,2007,11.6,9033,10223,1190
6011,CA,Colusa,,2008,13.9,9045,10501,1456
6011,CA,Colusa,,2009,18.3,9490,11610,2120
6011,CA,Colusa,,2010,21.3,9095,11560,2465
6011,CA,Colusa,,2011,21.6,8924,11380,2456
6011,CA,Colusa,,2012,21,8900,11270,2370
6011,CA,Colusa,,2013,19.1,9113,11268,2155
6011,CA,Colusa,,2014,17.6,9131,11078,1947
6011,CA,Colusa,,2015,15.5,9342,11051,1709
6011,CA,Colusa,,2016,15.6,9205,10908,1703
6011,CA,Colusa,,2017,14.3,9267,10816,1549
6011,CA,Colusa,,2018,13.3,9409,10851,1442
6011,CA,Colusa,,2019,13,9566,10993,1427
6011,CA,Colusa,,2020,16.5,8853,10607,1754
6011,CA,Colusa,,2021,12.5,9398,10740,1342
6013,CA,Contra Costa,,2007,4.6,491176,515040,23864
6013,CA,Contra Costa,,2008,6.2,491295,523981,32686
6013,CA,Contra Costa,,2009,10.4,472520,527243,54723
6013,CA,Contra Costa,,2010,11.2,466727,525745,59018
6013,CA,Contra Costa,,2011,10.5,473141,528506,55365
6013,CA,Contra Costa,,2012,9.1,485934,534520,48586
6013,CA,Contra Costa,,2013,7.6,495293,536032,40739
6013,CA,Contra Costa,,2014,6.2,504821,538458,33637
6013,CA,Contra Costa,,2015,5.1,517048,544617,27569
6013,CA,Contra Costa,,2016,4.5,528401,553221,24820
6013,CA,Contra Costa,,2017,3.9,536304,557869,21565
6013,CA,Contra Costa,,2018,3.2,542110,560233,18123
6013,CA,Contra Costa,,2019,3.1,543096,560709,17613
6013,CA,Contra Costa,,2020,9.1,495891,545458,49567
6013,CA,Contra Costa,,2021,6.4,507874,542352,34478
6015,CA,Del Norte,,2007,7.4,10219,11041,822
6015,CA,Del Norte,,2008,8.8,10362,11368,1006
6015,CA,Del Norte,,2009,12.3,10302,11744,1442
6015,CA,Del Norte,,2010,13.5,9465,10944,1479
6015,CA,Del Norte,,2011,13.5,9409,10882,1473
6015,CA,Del Norte,,2012,13.7,9040,10481,1441
6015,CA,Del Norte,,2013,12,9064,10298,1234
6015,CA,Del Norte,,2014,10.2,8905,9915,1010
6015,CA,Del Norte,,2015,8.6,9009,9856,847
6015,CA,Del Norte,,2016,7.5,9019,9755,736
6015,CA,Del Norte,,2017,6.5,9068,9696,628
6015,CA,Del Norte,,2018,5.8,9152,9712,560
6015,CA,Del Norte,,2019,5.9,9070,9635,565
6015,CA,Del Norte,,2020,9.7,8497,9414,917
6015,CA,Del Norte,,2021,7.6,8606,9314,708
6017,CA,El Dorado,,2007,5.1,85874,90504,4630
6017,CA,El Dorado,,2008,7,84284,90644,6360
6017,CA,El Dorado,,2009,11.3,81706,92136,10430
6017,CA,El Dorado,,2010,12.5,79799,91205,11406
6017,CA,El Dorado,,2011,11.9,78876,89550,10674
6017,CA,El Dorado,,2012,10.4,79638,88866,9228
6017,CA,El Dorado,,2013,8.6,80677,88281,7604
6017,CA,El Dorado,,2014,7.1,81532,87730,6198
6017,CA,El Dorado,,2015,5.7,82840,87892,5052
6017,CA,El Dorado,,2016,5.2,84248,88824,4576
6017,CA,El Dorado,,2017,4.4,85766,89712,3946
6017,CA,El Dorado,,2018,3.7,87691,91021,3330
6017,CA,El Dorado,,2019,3.6,88993,92296,3303
6017,CA,El Dorado,,2020,8.5,82984,90730,7746
6017,CA,El Dorado,,2021,5.7,85910,91142,5232
6019,CA,Fresno,,2007,8.5,383536,418979,35443
6019,CA,Fresno,,2008,10.6,384431,429911,45480
6019,CA,Fresno,,2009,15.3,370280,437028,66748
6019,CA,Fresno,,2010,17.1,365290,440562,75272
6019,CA,Fresno,,2011,16.8,368767,443250,74483
6019,CA,Fresno,,2012,15.4,371963,439492,67529
6019,CA,Fresno,,2013,13.4,378042,436620,58578
6019,CA,Fresno,,2014,11.7,386366,437617,51251
6019,CA,Fresno,,2015,10.3,395174,440308,45134
6019,CA,Fresno,,2016,9.5,402364,444737,42373
6019,CA,Fresno,,2017,8.6,406265,444452,38187
6019,CA,Fresno,,2018,7.6,412260,446228,33968
6019,CA,Fresno,,2019,7.4,418064,451289,33225
6019,CA,Fresno,,2020,11.7,392711,444993,52282
6019,CA,Fresno,,2021,9.2,402642,443383,40741
6021,CA,Glenn,,2007,8.7,10942,11986,1044
6021,CA,Glenn,,2008,10.5,10908,12189,1281
6021,CA,Glenn,,2009,14.7,10799,12662,1863
6021,CA,Glenn,,2010,15.8,11151,13242,2091
6021,CA,Glenn,,2011,15.8,11080,13157,2077
6021,CA,Glenn,,2012,14.4,11237,13129,1892
6021,CA,Glenn,,2013,12.2,11364,12950,1586
6021,CA,Glenn,,2014,10.8,11405,12783,1378
6021,CA,Glenn,,2015,8.8,11827,12964,1137
6021,CA,Glenn,,2016,8.4,11867,12949,1082
6021,CA,Glenn,,2017,7.5,11840,12803,963
6021,CA,Glenn,,2018,6.6,11923,12768,845
6021,CA,Glenn,,2019,6.2,12196,13006,810
6021,CA,Glenn,,2020,9.1,11581,12737,1156
6021,CA,Glenn,,2021,6.9,11740,12616,876
6023,CA,Humboldt,,2007,5.9,55883,59356,3473
6023,CA,Humboldt,,2008,7.3,55597,59983,4386
6023,CA,Humboldt,,2009,11.1,54327,61139,6812
6023,CA,Humboldt,,2010,10.8,58933,66064,7131
6023,CA,Humboldt,,2011,10.7,57998,64954,6956
6023,CA,Humboldt,,2012,9.7,57888,64128,6240
6023,CA,Humboldt,,2013,8.2,57671,62830,5159
6023,CA,Humboldt,,2014,6.7,58036,62235,4199
6023,CA,Humboldt,,2015,5.6,58782,62290,3508
6023,CA,Humboldt,,2016,4.9,59338,62424,3086
6023,CA,Humboldt,,2017,4.2,59842,62486,2644
6023,CA,Humboldt,,2018,3.6,60251,62530,2279
6023,CA,Humboldt,,2019,3.7,59932,62214,2282
6023,CA,Humboldt,,2020,8.6,54515,59653,5138
6023,CA,Humboldt,,2021,6.2,55053,58714,3661
6025,CA,Imperial,,2007,17.9,54157,65955,11798
6025,CA,Imperial,,2008,22.6,56114,72509,16395
6025,CA,Imperial,,2009,28.3,54882,76558,21676
6025,CA,Imperial,,2010,29.4,55836,79098,23262
6025,CA,Imperial,,2011,29.3,56301,79611,23310
6025,CA,Imperial,,2012,27.7,57355,79347,21992
6025,CA,Imperial,,2013,25.3,58391,78165,19774
6025,CA,Imperial,,2014,24.3,59281,78264,18983
6025,CA,Imperial,,2015,24.6,57864,76750,18886
6025,CA,Imperial,,2016,24.2,56998,75186,18188
6025,CA,Imperial,,2017,19.7,57886,72049,14163
6025,CA,Imperial,,2018,18.9,57736,71163,13427
6025,CA,Imperial,,2019,20.9,58358,73755,15397
6025,CA,Imperial,,2020,22.8,55218,71528,16310
6025,CA,Imperial,,2021,17.3,57094,69075,11981
6027,CA,Inyo,,2007,4.9,8463,8897,434
6027,CA,Inyo,,2008,6.6,8489,9092,603
6027,CA,Inyo,,2009,9.3,8546,9427,881
6027,CA,Inyo,,2010,10,8783,9755,972
6027,CA,Inyo,,2011,9.9,8707,9663,956
6027,CA,Inyo,,2012,9.2,8656,9536,880
6027,CA,Inyo,,2013,7.9,8613,9356,743
6027,CA,Inyo,,2014,6.9,8558,9192,634
6027,CA,Inyo,,2015,5.8,8552,9081,529
6027,CA,Inyo,,2016,5.3,8390,8860,470
6027,CA,Inyo,,2017,4.4,8226,8604,378
6027,CA,Inyo,,2018,3.9,8361,8704,343
6027,CA,Inyo,,2019,3.6,8452,8767,315
6027,CA,Inyo,,2020,8,7637,8305,668
6027,CA,Inyo,,2021,5.9,7745,8229,484
6029,CA,Kern,,2007,8.1,317580,345537,27957
6029,CA,Kern,,2008,9.9,323905,359331,35426
6029,CA,Kern,,2009,14.6,311671,365111,53440
6029,CA,Kern,,2010,16,312566,372229,59663
6029,CA,Kern,,2011,15.1,324431,382013,57582
6029,CA,Kern,,2012,13.4,338995,391269,52274
6029,CA,Kern,,2013,11.9,345564,392205,46641
6029,CA,Kern,,2014,10.5,350628,391896,41268
6029,CA,Kern,,2015,10.3,350050,390138,40088
6029,CA,Kern,,2016,10.4,347692,388109,40417
6029,CA,Kern,,2017,9.3,348493,384073,35580
6029,CA,Kern,,2018,8.1,354428,385789,31361
6029,CA,Kern,,2019,7.9,358105,388816,30711
6029,CA,Kern,,2020,12.9,335929,385860,49931
6029,CA,Kern,,2021,10,345432,383987,38555
6031,CA,Kings,,2007,8.6,52455,57381,4926
6031,CA,Kings,,2008,10.6,52527,58767,6240
6031,CA,Kings,,2009,14.8,51870,60891,9021
6031,CA,Kings,,2010,16.5,49730,59562,9832
6031,CA,Kings,,2011,16.2,49523,59082,9559
6031,CA,Kings,,2012,15.1,49849,58733,8884
6031,CA,Kings,,2013,13.6,50148,58029,7881
6031,CA,Kings,,2014,12.1,50447,57361,6914
6031,CA,Kings,,2015,10.6,51628,57729,6101
6031,CA,Kings,,2016,10,51446,57161,5715
6031,CA,Kings,,2017,9,52133,57265,5132
6031,CA,Kings,,2018,7.9,52949,57502,4553
6031,CA,Kings,,2019,8,53281,57923,4642
6031,CA,Kings,,2020,12,50118,56921,6803
6031,CA,Kings,,2021,9.6,50544,55930,5386
6033,CA,Lake,,2007,8.4,22053,24065,2012
6033,CA,Lake,,2008,10.7,21916,24540,2624
6033,CA,Lake,,2009,15.6,21563,25551,3988
6033,CA,Lake,,2010,15.5,25279,29899,4620
6033,CA,Lake,,2011,14.8,25210,29582,4372
6033,CA,Lake,,2012,13,25635,29460,3825
6033,CA,Lake,,2013,11,25944,29163,3219
6033,CA,Lake,,2014,9,26585,29230,2645
6033,CA,Lake,,2015,7.6,26790,29006,2216
6033,CA,Lake,,2016,6.7,27108,29067,1959
6033,CA,Lake,,2017,5.8,27598,29302,1704
6033,CA,Lake,,2018,5.3,27523,29070,1547
6033,CA,Lake,,2019,5.2,27555,29056,1501
6033,CA,Lake,,2020,9.8,25614,28411,2797
6033,CA,Lake,,2021,7.6,26211,28371,2160
6035,CA,Lassen,,2007,8.1,11445,12449,1004
6035,CA,Lassen,,2008,9.6,11595,12826,1231
6035,CA,Lassen,,2009,12.8,11892,13642,1750
6035,CA,Lassen,,2010,14.4,10374,12117,1743
6035,CA,Lassen,,2011,13.8,10150,11771,1621
6035,CA,Lassen,,2012,12.7,10002,11451,1449
6035,CA,Lassen,,2013,10.7,9791,10968,1177
6035,CA,Lassen,,2014,9.2,9803,10798,995
6035,CA,Lassen,,2015,7.3,9978,10760,782
6035,CA,Lassen,,2016,7,9642,10363,721
6035,CA,Lassen,,2017,5.5,9469,10025,556
6035,CA,Lassen,,2018,4.9,9376,9854,478
6035,CA,Lassen,,2019,4.7,9275,9732,457
6035,CA,Lassen,,2020,7.4,8694,9393,699
6035,CA,Lassen,,2021,5.9,8615,9159,544
6037,CA,Los Angeles,,2007,5.1,4614575,4864654,250079
6037,CA,Los Angeles,,2008,7.5,4553013,4923903,370890
6037,CA,Los Angeles,,2009,11.7,4357147,4936966,579819
6037,CA,Los Angeles,,2010,12.6,4318722,4940672,621950
6037,CA,Los Angeles,,2011,12.2,4337370,4941667,604297
6037,CA,Los Angeles,,2012,11,4365690,4904883,539193
6037,CA,Los Angeles,,2013,9.8,4471400,4955806,484406
6037,CA,Los Angeles,,2014,8.2,4572171,4982412,410241
6037,CA,Los Angeles,,2015,6.7,4641054,4973756,332702
6037,CA,Los Angeles,,2016,5.3,4751209,5018920,267711
6037,CA,Los Angeles,,2017,4.8,4864120,5109810,245690
6037,CA,Los Angeles,,2018,4.6,4885329,5121279,235950
6037,CA,Los Angeles,,2019,4.4,4926056,5153091,227035
6037,CA,Los Angeles,,2020,12.3,4355926,4968912,612986
6037,CA,Los Angeles,,2021,8.9,4548852,4994057,445205
6039,CA,Madera,,2007,7.4,58735,63434,4699
6039,CA,Madera,,2008,9.5,58879,65054,6175
6039,CA,Madera,,2009,13.9,57591,66889,9298
6039,CA,Madera,,2010,17,51236,61743,10507
6039,CA,Madera,,2011,16.4,51786,61974,10188
6039,CA,Madera,,2012,14.7,53282,62446,9164
6039,CA,Madera,,2013,12.7,54168,62073,7905
6039,CA,Madera,,2014,11.3,54720,61712,6992
6039,CA,Madera,,2015,10.6,53480,59807,6327
6039,CA,Madera,,2016,9.3,55393,61051,5658
6039,CA,Madera,,2017,8.2,55932,60909,4977
6039,CA,Madera,,2018,7.1,56882,61261,4379
6039,CA,Madera,,2019,7,57848,62204,4356
6039,CA,Madera,,2020,11.2,54920,61852,6932
6039,CA,Madera,,2021,8.8,56468,61944,5476
6041,CA,Marin,,2007,3.6,127331,132106,4775
6041,CA,Marin,,2008,4.7,126011,132263,6252
6041,CA,Marin,,2009,7.8,122046,132442,10396
6041,CA,Marin,,2010,8.1,122259,132971,10712
6041,CA,Marin,,2011,7.4,124309,134245,9936
6041,CA,Marin,,2012,6.4,127796,136522,8726
6041,CA,Marin,,2013,5.2,130592,137807,7215
6041,CA,Marin,,2014,4.3,132477,138458,5981
6041,CA,Marin,,2015,3.6,133718,138677,4959
6041,CA,Marin,,2016,3.3,135040,139632,4592
6041,CA,Marin,,2017,2.9,135584,139632,4048
6041,CA,Marin,,2018,2.5,136256,139681,3425
6041,CA,Marin,,2019,2.4,135543,138811,3268
6041,CA,Marin,,2020,6.9,121476,130414,8938
6041,CA,Marin,,2021,4.5,123172,128920,5748
6043,CA,Mariposa,,2007,6,8532,9072,540
6043,CA,Mariposa,,2008,7.6,8577,9278,701
6043,CA,Mariposa,,2009,10.7,8431,9442,1011
6043,CA,Mariposa,,2010,13.3,7563,8720,1157
6043,CA,Mariposa,,2011,13.4,7490,8649,1159
6043,CA,Mariposa,,2012,12.4,7323,8361,1038
6043,CA,Mariposa,,2013,10.6,7328,8201,873
6043,CA,Mariposa,,2014,8.9,7359,8077,718
6043,CA,Mariposa,,2015,7.2,7436,8011,575
6043,CA,Mariposa,,2016,6.9,7048,7568,520
6043,CA,Mariposa,,2017,5.9,7203,7653,450
6043,CA,Mariposa,,2018,5.4,7239,7651,412
6043,CA,Mariposa,,2019,4.6,7281,7635,354
6043,CA,Mariposa,,2020,11.2,6385,7191,806
6043,CA,Mariposa,,2021,8,6456,7014,558
6045,CA,Mendocino,,2007,5.4,40823,43171,2348
6045,CA,Mendocino,,2008,6.9,40242,43233,2991
6045,CA,Mendocino,,2009,10.5,38951,43508,4557
6045,CA,Mendocino,,2010,11.9,36679,41614,4935
6045,CA,Mendocino,,2011,11.6,36141,40874,4733
6045,CA,Mendocino,,2012,10.2,36693,40860,4167
6045,CA,Mendocino,,2013,8.5,37246,40690,3444
6045,CA,Mendocino,,2014,7.1,37446,40301,2855
6045,CA,Mendocino,,2015,5.9,37500,39831,2331
6045,CA,Mendocino,,2016,5.3,37521,39617,2096
6045,CA,Mendocino,,2017,4.6,37735,39534,1799
6045,CA,Mendocino,,2018,4,37864,39453,1589
6045,CA,Mendocino,,2019,4,37159,38725,1566
6045,CA,Mendocino,,2020,9.2,33698,37099,3401
6045,CA,Mendocino,,2021,6.2,34622,36920,2298
6047,CA,Merced,,2007,10,89973,99923,9950
6047,CA,Merced,,2008,12.7,89272,102211,12939
6047,CA,Merced,,2009,17.3,87855,106193,18338
6047,CA,Merced,,2010,18.4,92954,113874,20920
6047,CA,Merced,,2011,17.9,94128,114693,20565
6047,CA,Merced,,2012,16.6,95852,114901,19049
6047,CA,Merced,,2013,14.7,97543,114311,16768
6047,CA,Merced,,2014,13,99355,114169,14814
6047,CA,Merced,,2015,11.4,101031,114061,13030
6047,CA,Merced,,2016,10.6,102211,114339,12128
6047,CA,Merced,,2017,9.4,104330,115210,10880
6047,CA,Merced,,2018,8.5,105501,115251,9750
6047,CA,Merced,,2019,8.2,106423,115964,9541
6047,CA,Merced,,2020,12.6,100761,115332,14571
6047,CA,Merced,,2021,10.4,103223,115158,11935
6049,CA,Modoc,,2007,8,3589,3900,311
6049,CA,Modoc,,2008,9.7,3556,3939,383
6049,CA,Modoc,,2009,12.6,3555,4067,512
6049,CA,Modoc,,2010,15.5,3228,3821,593
6049,CA,Modoc,,2011,16.2,3030,3617,587
6049,CA,Modoc,,2012,14.6,3080,3607,527
6049,CA,Modoc,,2013,12.4,3058,3492,434
6049,CA,Modoc,,2014,10.4,3012,3361,349
6049,CA,Modoc,,2015,8.6,3019,3303,284
6049,CA,Modoc,,2016,7.8,3034,3292,258
6049,CA,Modoc,,2017,8.2,2932,3193,261
6049,CA,Modoc,,2018,7.6,2915,3156,241
6049,CA,Modoc,,2019,7.2,2950,3179,229
6049,CA,Modoc,,2020,8.9,2893,3174,281
6049,CA,Modoc,,2021,7.1,2962,3187,225
6051,CA,Mono,,2007,4.8,7756,8143,387
6051,CA,Mono,,2008,5.9,8098,8609,511
6051,CA,Mono,,2009,9.2,7968,8771,803
6051,CA,Mono,,2010,10.4,7963,8890,927
6051,CA,Mono,,2011,10.2,7913,8814,901
6051,CA,Mono,,2012,10.5,7502,8383,881
6051,CA,Mono,,2013,8.6,7619,8338,719
6051,CA,Mono,,2014,7.1,7637,8224,587
6051,CA,Mono,,2015,6.2,7731,8239,508
6051,CA,Mono,,2016,5.4,7915,8365,450
6051,CA,Mono,,2017,4.5,8106,8485,379
6051,CA,Mono,,2018,4.1,8081,8424,343
6051,CA,Mono,,2019,3.8,8198,8519,321
6051,CA,Mono,,2020,12.2,6917,7875,958
6051,CA,Mono,,2021,6.8,7771,8340,569
6053,CA,Monterey,,2007,7.1,191156,205698,14542
6053,CA,Monterey,,2008,8.5,194178,212165,17987
6053,CA,Monterey,,2009,12,190569,216502,25933
6053,CA,Monterey,,2010,13,187860,216038,28178
6053,CA,Monterey,,2011,12.9,188401,216257,27856
6053,CA,Monterey,,2012,11.8,191832,217399,25567
6053,CA,Monterey,,2013,10.4,193153,215676,22523
6053,CA,Monterey,,2014,9.2,197439,217354,19915
6053,CA,Monterey,,2015,8.2,200452,218274,17822
6053,CA,Monterey,,2016,7.7,201971,218802,16831
6053,CA,Monterey,,2017,7.2,203630,219487,15857
6053,CA,Monterey,,2018,6.4,207648,221914,14266
6053,CA,Monterey,,2019,6.4,207458,221536,14078
6053,CA,Monterey,,2020,11.2,189830,213837,24007
6053,CA,Monterey,,2021,8.3,194310,211858,17548
6055,CA,Napa,,2007,4,70424,73342,2918
6055,CA,Napa,,2008,5.1,71699,75582,3883
6055,CA,Napa,,2009,8.7,69233,75854,6621
6055,CA,Napa,,2010,10.6,62830,70244,7414
6055,CA,Napa,,2011,10,63595,70628,7033
6055,CA,Napa,,2012,8.6,65492,71645,6153
6055,CA,Napa,,2013,7,67444,72539,5095
6055,CA,Napa,,2014,5.7,69047,73259,4212
6055,CA,Napa,,2015,4.6,70290,73717,3427
6055,CA,Napa,,2016,4.3,69799,72941,3142
6055,CA,Napa,,2017,3.7,70549,73237,2688
6055,CA,Napa,,2018,3,71572,73770,2198
6055,CA,Napa,,2019,2.9,71210,73342,2132
6055,CA,Napa,,2020,9,62575,68777,6202
6055,CA,Napa,,2021,6,64305,68437,4132
6057,CA,Nevada,,2007,4.7,47812,50195,2383
6057,CA,Nevada,,2008,6.6,47047,50377,3330
6057,CA,Nevada,,2009,10.7,45199,50620,5421
6057,CA,Nevada,,2010,12,43068,48939,5871
6057,CA,Nevada,,2011,11.3,43418,48941,5523
6057,CA,Nevada,,2012,9.9,43474,48257,4783
6057,CA,Nevada,,2013,8.2,44056,47994,3938
6057,CA,Nevada,,2014,6.6,44581,47746,3165
6057,CA,Nevada,,2015,5.5,45388,48006,2618
6057,CA,Nevada,,2016,4.8,45838,48147,2309
6057,CA,Nevada,,2017,4.1,46289,48288,1999
6057,CA,Nevada,,2018,3.5,46844,48561,1717
6057,CA,Nevada,,2019,3.4,46830,48477,1647
6057,CA,Nevada,,2020,8.2,42871,46697,3826
6057,CA,Nevada,,2021,5.6,44459,47089,2630
6059,CA,Orange,,2007,3.8,1546709,1608580,61871
6059,CA,Orange,,2008,5.3,1530120,1616256,86136
6059,CA,Orange,,2009,9,1451508,1595687,144179
6059,CA,Orange,,2010,10,1383916,1537701,153785
6059,CA,Orange,,2011,9.3,1400874,1543784,142910
6059,CA,Orange,,2012,8,1433508,1558477,124969
6059,CA,Orange,,2013,6.7,1455311,1559480,104169
6059,CA,Orange,,2014,5.6,1478476,1565446,86970
6059,CA,Orange,,2015,4.5,1513060,1584296,71236
6059,CA,Orange,,2016,4.1,1532725,1597447,64722
6059,CA,Orange,,2017,3.5,1549003,1605787,56784
6059,CA,Orange,,2018,3,1567723,1615863,48140
6059,CA,Orange,,2019,2.8,1570049,1615978,45929
6059,CA,Orange,,2020,9,1420678,1561462,140784
6059,CA,Orange,,2021,6,1461154,1553897,92743
6061,CA,Placer,,2007,4.7,164566,172718,8152
6061,CA,Placer,,2008,6.5,165535,177065,11530
6061,CA,Placer,,2009,10.6,161396,180575,19179
6061,CA,Placer,,2010,11.9,152847,173433,20586
6061,CA,Placer,,2011,11,154313,173470,19157
6061,CA,Placer,,2012,9.5,157910,174534,16624
6061,CA,Placer,,2013,7.8,161492,175189,13697
6061,CA,Placer,,2014,6.3,163994,175097,11103
6061,CA,Placer,,2015,5.1,167367,176339,8972
6061,CA,Placer,,2016,4.5,171550,179634,8084
6061,CA,Placer,,2017,3.9,174177,181231,7054
6061,CA,Placer,,2018,3.2,179626,185605,5979
6061,CA,Placer,,2019,3.2,182933,188900,5967
6061,CA,Placer,,2020,7.5,172621,186664,14043
6061,CA,Placer,,2021,5,178657,188045,9388
6063,CA,Plumas,,2007,8.4,9117,9958,841
6063,CA,Plumas,,2008,10.6,8777,9817,1040
6063,CA,Plumas,,2009,16,8474,10087,1613
6063,CA,Plumas,,2010,18.7,7460,9172,1712
6063,CA,Plumas,,2011,17.9,7297,8886,1589
6063,CA,Plumas,,2012,16.4,7087,8477,1390
6063,CA,Plumas,,2013,14,7080,8232,1152
6063,CA,Plumas,,2014,11.7,7144,8088,944
6063,CA,Plumas,,2015,10.3,7076,7891,815
6063,CA,Plumas,,2016,9.8,7085,7851,766
6063,CA,Plumas,,2017,8.9,7070,7764,694
6063,CA,Plumas,,2018,7.6,7219,7815,596
6063,CA,Plumas,,2019,7.8,7275,7891,616
6063,CA,Plumas,,2020,11.1,6768,7615,847
6063,CA,Plumas,,2021,9.5,6682,7382,700
6065,CA,Riverside,,2007,6,849266,903169,53903
6065,CA,Riverside,,2008,8.6,833559,912039,78480
6065,CA,Riverside,,2009,13.6,795712,921434,125722
6065,CA,Riverside,,2010,14.2,839147,977784,138637
6065,CA,Riverside,,2011,13.4,846288,977288,131000
6065,CA,Riverside,,2012,11.8,868757,985244,116487
6065,CA,Riverside,,2013,10,893454,993023,99569
6065,CA,Riverside,,2014,8.3,925465,1009162,83697
6065,CA,Riverside,,2015,6.7,963825,1033458,69633
6065,CA,Riverside,,2016,6.1,987187,1051610,64423
6065,CA,Riverside,,2017,5.3,1014232,1070876,56644
6065,CA,Riverside,,2018,4.5,1041323,1090038,48715
6065,CA,Riverside,,2019,4.3,1060633,1107716,47083
6065,CA,Riverside,,2020,10.2,1003553,1117258,113705
6065,CA,Riverside,,2021,7.3,1046723,1129562,82839
6067,CA,Sacramento,,2007,5.4,640320,676692,36372
6067,CA,Sacramento,,2008,7.2,630472,679749,49277
6067,CA,Sacramento,,2009,11.5,605996,684611,78615
6067,CA,Sacramento,,2010,12.9,595476,683829,88353
6067,CA,Sacramento,,2011,12.3,595329,678994,83665
6067,CA,Sacramento,,2012,10.7,607250,679873,72623
6067,CA,Sacramento,,2013,9,616885,677831,60946
6067,CA,Sacramento,,2014,7.4,627615,677696,50081
6067,CA,Sacramento,,2015,6,643295,684577,41282
6067,CA,Sacramento,,2016,5.4,656360,693979,37619
6067,CA,Sacramento,,2017,4.7,663727,696466,32739
6067,CA,Sacramento,,2018,3.9,676667,704161,27494
6067,CA,Sacramento,,2019,3.8,684781,711464,26683
6067,CA,Sacramento,,2020,9.5,641956,709713,67757
6067,CA,Sacramento,,2021,7,664353,714032,49679
6069,CA,San Benito,,2007,7.2,22312,24032,1720
6069,CA,San Benito,,2008,9.7,22442,24852,2410
6069,CA,San Benito,,2009,14.5,21390,25026,3636
6069,CA,San Benito,,2010,15.5,23632,27957,4325
6069,CA,San Benito,,2011,14.8,24084,28253,4169
6069,CA,San Benito,,2012,13.3,24837,28632,3795
6069,CA,San Benito,,2013,11.2,25574,28811,3237
6069,CA,San Benito,,2014,9.4,26372,29121,2749
6069,CA,San Benito,,2015,7.6,27495,29759,2264
6069,CA,San Benito,,2016,6.7,28398,30434,2036
6069,CA,San Benito,,2017,5.8,28811,30588,1777
6069,CA,San Benito,,2018,5.1,29606,31199,1593
6069,CA,San Benito,,2019,5,30688,32316,1628
6069,CA,San Benito,,2020,10,29251,32493,3242
6069,CA,San Benito,,2021,7.2,29658,31976,2318
6071,CA,San Bernardino,,2007,5.5,815449,863306,47857
6071,CA,San Bernardino,,2008,8.1,793074,862596,69522
6071,CA,San Bernardino,,2009,13.2,749047,862804,113757
6071,CA,San Bernardino,,2010,13.9,767935,891422,123487
6071,CA,San Bernardino,,2011,13.1,771117,887345,116228
6071,CA,San Bernardino,,2012,11.6,787254,890518,103264
6071,CA,San Bernardino,,2013,9.9,805211,893610,88399
6071,CA,San Bernardino,,2014,8.1,830461,903649,73188
6071,CA,San Bernardino,,2015,6.5,859733,919308,59575
6071,CA,San Bernardino,,2016,5.8,876387,930242,53855
6071,CA,San Bernardino,,2017,5,895265,942048,46783
6071,CA,San Bernardino,,2018,4.1,915519,954989,39470
6071,CA,San Bernardino,,2019,3.9,929049,966763,37714
6071,CA,San Bernardino,,2020,9.7,876969,971384,94415
6071,CA,San Bernardino,,2021,7.4,915089,988604,73515
6073,CA,San Diego,,2007,4.5,1449165,1517503,68338
6073,CA,San Diego,,2008,6.1,1453044,1546617,93573
6073,CA,San Diego,,2009,9.8,1408178,1561162,152984
6073,CA,San Diego,,2010,11,1348833,1515862,167029
6073,CA,San Diego,,2011,10.5,1361865,1521745,159880
6073,CA,San Diego,,2012,9.3,1394274,1536925,142651
6073,CA,San Diego,,2013,7.9,1415625,1537644,122019
6073,CA,San Diego,,2014,6.5,1437398,1537512,100114
6073,CA,San Diego,,2015,5.2,1467686,1548794,81108
6073,CA,San Diego,,2016,4.7,1489143,1563246,74103
6073,CA,San Diego,,2017,4,1507180,1570791,63611
6073,CA,San Diego,,2018,3.4,1526087,1579550,53463
6073,CA,San Diego,,2019,3.3,1531029,1582874,51845
6073,CA,San Diego,,2020,9.5,1395730,1541979,146249
6073,CA,San Diego,,2021,6.5,1443815,1543678,99863
6075,CA,San Francisco,,2007,4.2,415008,433197,18189
6075,CA,San Francisco,,2008,5.3,433111,457204,24093
6075,CA,San Francisco,,2009,9.1,419496,461298,41802
6075,CA,San Francisco,,2010,9.1,441571,485779,44208
6075,CA,San Francisco,,2011,8.2,453071,493437,40366
6075,CA,San Francisco,,2012,6.9,473033,508011,34978
6075,CA,San Francisco,,2013,5.5,485801,514231,28430
6075,CA,San Francisco,,2014,4.4,503984,527320,23336
6075,CA,San Francisco,,2015,3.7,521569,541414,19845
6075,CA,San Francisco,,2016,3.3,536972,555316,18344
6075,CA,San Francisco,,2017,2.9,546440,563046,16606
6075,CA,San Francisco,,2018,2.4,554889,568605,13716
6075,CA,San Francisco,,2019,2.2,567612,580597,12985
6075,CA,San Francisco,,2020,8,513363,558105,44742
6075,CA,San Francisco,,2021,5,518434,545953,27519
6077,CA,San Joaquin,,2007,8,265796,288930,23134
6077,CA,San Joaquin,,2008,10.5,262350,293019,30669
6077,CA,San Joaquin,,2009,15.5,253280,299895,46615
6077,CA,San Joaquin,,2010,16.9,259334,312104,52770
6077,CA,San Joaquin,,2011,16.5,259969,311159,51190
6077,CA,San Joaquin,,2012,14.6,265990,311393,45403
6077,CA,San Joaquin,,2013,12.5,273256,312140,38884
6077,CA,San Joaquin,,2014,10.7,278342,311543,33201
6077,CA,San Joaquin,,2015,8.9,286281,314401,28120
6077,CA,San Joaquin,,2016,8.2,292367,318316,25949
6077,CA,San Joaquin,,2017,7,300205,322951,22746
6077,CA,San Joaquin,,2018,6.1,304226,324146,19920
6077,CA,San Joaquin,,2019,6,307458,327089,19631
6077,CA,San Joaquin,,2020,11.6,295559,334292,38733
6077,CA,San Joaquin,,2021,8.7,305278,334250,28972
6079,CA,San Luis Obispo,,2007,4.2,128525,134219,5694
6079,CA,San Luis Obispo,,2008,5.8,128561,136469,7908
6079,CA,San Luis Obispo,,2009,9.2,124356,136937,12581
6079,CA,San Luis Obispo,,2010,10.2,119904,133590,13686
6079,CA,San Luis Obispo,,2011,9.7,121031,134066,13035
6079,CA,San Luis Obispo,,2012,8.4,125533,137013,11480
6079,CA,San Luis Obispo,,2013,6.9,128206,137727,9521
6079,CA,San Luis Obispo,,2014,5.6,132020,139919,7899
6079,CA,San Luis Obispo,,2015,4.8,132302,138913,6611
6079,CA,San Luis Obispo,,2016,4.3,133438,139484,6046
6079,CA,San Luis Obispo,,2017,3.6,135171,140250,5079
6079,CA,San Luis Obispo,,2018,3,135845,140085,4240
6079,CA,San Luis Obispo,,2019,2.9,135750,139838,4088
6079,CA,San Luis Obispo,,2020,7.9,123379,133921,10542
6079,CA,San Luis Obispo,,2021,5.2,128186,135268,7082
6081,CA,San Mateo,,2007,3.8,356109,370061,13952
6081,CA,San Mateo,,2008,4.9,354267,372532,18265
6081,CA,San Mateo,,2009,8.6,343453,375635,32182
6081,CA,San Mateo,,2010,8.6,359249,392869,33620
6081,CA,San Mateo,,2011,7.7,368371,398892,30521
6081,CA,San Mateo,,2012,6.5,384118,410898,26780
6081,CA,San Mateo,,2013,5.3,394209,416399,22190
6081,CA,San Mateo,,2014,4.3,407692,425863,18171
6081,CA,San Mateo,,2015,3.4,419310,434234,14924
6081,CA,San Mateo,,2016,3.1,428282,441792,13510
6081,CA,San Mateo,,2017,2.7,432729,444909,12180
6081,CA,San Mateo,,2018,2.3,438753,448911,10158
6081,CA,San Mateo,,2019,2.1,447577,457133,9556
6081,CA,San Mateo,,2020,7,407241,437835,30594
6081,CA,San Mateo,,2021,4.6,411484,431205,19721
6083,CA,Santa Barbara,,2007,4.3,204561,213781,9220
6083,CA,Santa Barbara,,2008,5.5,206192,218183,11991
6083,CA,Santa Barbara,,2009,8.6,201849,220831,18982
6083,CA,Santa Barbara,,2010,9.9,191192,212274,21082
6083,CA,Santa Barbara,,2011,9.5,192261,212557,20296
6083,CA,Santa Barbara,,2012,8.5,197127,215485,18358
6083,CA,Santa Barbara,,2013,7.3,200720,216531,15811
6083,CA,Santa Barbara,,2014,6.2,203882,217331,13449
6083,CA,Santa Barbara,,2015,5.3,205591,217158,11567
6083,CA,Santa Barbara,,2016,5.1,204329,215256,10927
6083,CA,Santa Barbara,,2017,4.6,205145,214948,9803
6083,CA,Santa Barbara,,2018,4,206642,215220,8578
6083,CA,Santa Barbara,,2019,3.7,214501,222675,8174
6083,CA,Santa Barbara,,2020,8.2,200213,218122,17909
6083,CA,Santa Barbara,,2021,5.8,205423,217988,12565
6085,CA,Santa Clara,,2007,4.6,805447,844626,39179
6085,CA,Santa Clara,,2008,6,816863,869347,52484
6085,CA,Santa Clara,,2009,11,782289,879339,97050
6085,CA,Santa Clara,,2010,10.7,828008,926868,98860
6085,CA,Santa Clara,,2011,9.5,849070,937871,88801
6085,CA,Santa Clara,,2012,8,879447,955979,76532
6085,CA,Santa Clara,,2013,6.6,904718,968154,63436
6085,CA,Santa Clara,,2014,5.2,936090,987613,51523
6085,CA,Santa Clara,,2015,4.2,969950,1012215,42265
6085,CA,Santa Clara,,2016,3.8,989048,1027918,38870
6085,CA,Santa Clara,,2017,3.2,1003683,1037356,33673
6085,CA,Santa Clara,,2018,2.7,1014614,1042337,27723
6085,CA,Santa Clara,,2019,2.5,1023426,1050090,26664
6085,CA,Santa Clara,,2020,7.2,948273,1021799,73526
6085,CA,Santa Clara,,2021,4.7,966009,1013614,47605
6087,CA,Santa Cruz,,2007,5.8,136424,144897,8473
6087,CA,Santa Cruz,,2008,7.4,135383,146188,10805
6087,CA,Santa Cruz,,2009,11.5,131288,148422,17134
6087,CA,Santa Cruz,,2010,13.6,122559,141873,19314
6087,CA,Santa Cruz,,2011,13.3,122382,141147,18765
6087,CA,Santa Cruz,,2012,12,124756,141801,17045
6087,CA,Santa Cruz,,2013,10.4,126860,141591,14731
6087,CA,Santa Cruz,,2014,8.9,129469,142048,12579
6087,CA,Santa Cruz,,2015,7.5,132434,143227,10793
6087,CA,Santa Cruz,,2016,7,133730,143764,10034
6087,CA,Santa Cruz,,2017,5.7,134423,142601,8178
6087,CA,Santa Cruz,,2018,5,134175,141270,7095
6087,CA,Santa Cruz,,2019,5,134342,141352,7010
6087,CA,Santa Cruz,,2020,9.8,121436,134611,13175
6087,CA,Santa Cruz,,2021,6.9,124166,133351,9185
6089,CA,Shasta,,2007,7.4,76499,82629,6130
6089,CA,Shasta,,2008,10.1,74279,82622,8343
6089,CA,Shasta,,2009,14.9,71911,84524,12613
6089,CA,Shasta,,2010,17.2,65168,78680,13512
6089,CA,Shasta,,2011,16.2,64507,76990,12483
6089,CA,Shasta,,2012,14.4,64968,75904,10936
6089,CA,Shasta,,2013,12,66069,75049,8980
6089,CA,Shasta,,2014,9.7,67469,74741,7272
6089,CA,Shasta,,2015,7.8,68325,74122,5797
6089,CA,Shasta,,2016,7,69019,74207,5188
6089,CA,Shasta,,2017,5.8,69594,73912,4318
6089,CA,Shasta,,2018,5,70163,73888,3725
6089,CA,Shasta,,2019,4.8,69421,72954,3533
6089,CA,Shasta,,2020,9,66563,73129,6566
6089,CA,Shasta,,2021,6.8,67834,72809,4975
6091,CA,Sierra,,2007,7.8,1485,1611,126
6091,CA,Sierra,,2008,10.6,1421,1590,169
6091,CA,Sierra,,2009,15.5,1357,1606,249
6091,CA,Sierra,,2010,15.7,1361,1614,253
6091,CA,Sierra,,2011,15.1,1357,1599,242
6091,CA,Sierra,,2012,14.6,1253,1467,214
6091,CA,Sierra,,2013,12.9,1261,1448,187
6091,CA,Sierra,,2014,10.2,1266,1410,144
6091,CA,Sierra,,2015,8.8,1242,1362,120
6091,CA,Sierra,,2016,7.6,1232,1334,102
6091,CA,Sierra,,2017,6.6,1204,1289,85
6091,CA,Sierra,,2018,6.1,1199,1277,78
6091,CA,Sierra,,2019,5.4,1258,1330,72
6091,CA,Sierra,,2020,8.3,1176,1283,107
6091,CA,Sierra,,2021,6,1226,1304,78
6093,CA,Siskiyou,,2007,8.4,17226,18805,1579
6093,CA,Siskiyou,,2008,10.2,17247,19214,1967
6093,CA,Siskiyou,,2009,14.8,16833,19760,2927
6093,CA,Siskiyou,,2010,17.2,16283,19672,3389
6093,CA,Siskiyou,,2011,17.3,16070,19425,3355
6093,CA,Siskiyou,,2012,15.9,15865,18854,2989
6093,CA,Siskiyou,,2013,13.3,15812,18239,2427
6093,CA,Siskiyou,,2014,11.2,15961,17977,2016
6093,CA,Siskiyou,,2015,9.4,16199,17884,1685
6093,CA,Siskiyou,,2016,8.5,16370,17896,1526
6093,CA,Siskiyou,,2017,7.3,16484,17785,1301
6093,CA,Siskiyou,,2018,6.8,16184,17364,1180
6093,CA,Siskiyou,,2019,6.6,16056,17188,1132
6093,CA,Siskiyou,,2020,10.1,15228,16938,1710
6093,CA,Siskiyou,,2021,8.1,15222,16561,1339
6095,CA,Solano,,2007,5.2,197599,208475,10876
6095,CA,Solano,,2008,6.9,196562,211167,14605
6095,CA,Solano,,2009,10.8,192203,215564,23361
6095,CA,Solano,,2010,12.8,176520,202546,26026
6095,CA,Solano,,2011,12.4,176920,201909,24989
6095,CA,Solano,,2012,10.9,180260,202237,21977
6095,CA,Solano,,2013,9.2,183752,202338,18586
6095,CA,Solano,,2014,7.6,186972,202391,15419
6095,CA,Solano,,2015,6.2,192237,204869,12632
6095,CA,Solano,,2016,5.5,195835,207273,11438
6095,CA,Solano,,2017,4.8,197959,207947,9988
6095,CA,Solano,,2018,4,200737,209037,8300
6095,CA,Solano,,2019,3.8,200424,208423,7999
6095,CA,Solano,,2020,9.8,181675,201518,19843
6095,CA,Solano,,2021,7.5,184505,199365,14860
6097,CA,Sonoma,,2007,4.3,246623,257688,11065
6097,CA,Sonoma,,2008,5.8,244727,259757,15030
6097,CA,Sonoma,,2009,9.8,232371,257651,25280
6097,CA,Sonoma,,2010,11.1,217546,244609,27063
6097,CA,Sonoma,,2011,10.4,220088,245618,25530
6097,CA,Sonoma,,2012,9,223564,245671,22107
6097,CA,Sonoma,,2013,7.2,231095,249019,17924
6097,CA,Sonoma,,2014,5.7,241048,255563,14515
6097,CA,Sonoma,,2015,4.5,246028,257659,11631
6097,CA,Sonoma,,2016,4,248876,259214,10338
6097,CA,Sonoma,,2017,3.4,250932,259768,8836
6097,CA,Sonoma,,2018,2.8,253298,260587,7289
6097,CA,Sonoma,,2019,2.7,250486,257549,7063
6097,CA,Sonoma,,2020,8.1,225417,245312,19895
6097,CA,Sonoma,,2021,5.5,229439,242752,13313
6099,CA,Stanislaus,,2007,8.6,207607,227104,19497
6099,CA,Stanislaus,,2008,11.1,206074,231840,25766
6099,CA,Stanislaus,,2009,16.1,198080,236170,38090
6099,CA,Stanislaus,,2010,17.3,201670,243828,42158
6099,CA,Stanislaus,,2011,16.8,201564,242178,40614
6099,CA,Stanislaus,,2012,15.1,205116,241659,36543
6099,CA,Stanislaus,,2013,13.1,208783,240268,31485
6099,CA,Stanislaus,,2014,11.3,213079,240222,27143
6099,CA,Stanislaus,,2015,9.6,217971,240986,23015
6099,CA,Stanislaus,,2016,8.6,221769,242737,20968
6099,CA,Stanislaus,,2017,7.5,223735,241971,18236
6099,CA,Stanislaus,,2018,6.5,227230,243068,15838
6099,CA,Stanislaus,,2019,6.2,227939,242886,14947
6099,CA,Stanislaus,,2020,11.1,214903,241656,26753
6099,CA,Stanislaus,,2021,8.4,219496,239538,20042
6101,CA,Sutter,,2007,9.6,37094,41020,3926
6101,CA,Sutter,,2008,12.4,35991,41082,5091
6101,CA,Sutter,,2009,17.1,34987,42204,7217
6101,CA,Sutter,,2010,18.8,37433,46089,8656
6101,CA,Sutter,,2011,18.5,37447,45926,8479
6101,CA,Sutter,,2012,17.1,37750,45516,7766
6101,CA,Sutter,,2013,14.8,38061,44669,6608
6101,CA,Sutter,,2014,12.8,38574,44230,5656
6101,CA,Sutter,,2015,10.8,39925,44734,4809
6101,CA,Sutter,,2016,9.7,40612,44983,4371
6101,CA,Sutter,,2017,8.8,41028,44965,3937
6101,CA,Sutter,,2018,7.7,41395,44840,3445
6101,CA,Sutter,,2019,7.5,42143,45544,3401
6101,CA,Sutter,,2020,11.4,40238,45440,5202
6101,CA,Sutter,,2021,9,41145,45214,4069
6103,CA,Tehama,,2007,7.2,23106,24887,1781
6103,CA,Tehama,,2008,9.2,22839,25166,2327
6103,CA,Tehama,,2009,14.2,21884,25506,3622
6103,CA,Tehama,,2010,15.8,21699,25762,4063
6103,CA,Tehama,,2011,15.2,21659,25551,3892
6103,CA,Tehama,,2012,14,21693,25211,3518
6103,CA,Tehama,,2013,11.8,22065,25006,2941
6103,CA,Tehama,,2014,9.7,22605,25041,2436
6103,CA,Tehama,,2015,8,23029,25019,1990
6103,CA,Tehama,,2016,7.1,23280,25071,1791
6103,CA,Tehama,,2017,6.4,23875,25511,1636
6103,CA,Tehama,,2018,5.8,24014,25485,1471
6103,CA,Tehama,,2019,5.7,24137,25596,1459
6103,CA,Tehama,,2020,9.2,23282,25630,2348
6103,CA,Tehama,,2021,7.2,23617,25443,1826
6105,CA,Trinity,,2007,10.3,4508,5028,520
6105,CA,Trinity,,2008,12.8,4230,4853,623
6105,CA,Trinity,,2009,17.4,4148,5024,876
6105,CA,Trinity,,2010,17.4,4490,5436,946
6105,CA,Trinity,,2011,17,4469,5382,913
6105,CA,Trinity,,2012,14.9,4532,5323,791
6105,CA,Trinity,,2013,12.1,4550,5175,625
6105,CA,Trinity,,2014,9.6,4668,5161,493
6105,CA,Trinity,,2015,7.8,4739,5141,402
6105,CA,Trinity,,2016,7.1,4638,4993,355
6105,CA,Trinity,,2017,6.2,4504,4804,300
6105,CA,Trinity,,2018,5.8,4405,4675,270
6105,CA,Trinity,,2019,5.6,4393,4652,259
6105,CA,Trinity,,2020,8.3,4157,4532,375
6105,CA,Trinity,,2021,6.3,4193,4475,282
6107,CA,Tulare,,2007,9.1,174194,191736,17542
6107,CA,Tulare,,2008,10.9,177406,199013,21607
6107,CA,Tulare,,2009,15.4,172976,204579,31603
6107,CA,Tulare,,2010,17.6,167682,203498,35816
6107,CA,Tulare,,2011,17.4,168022,203378,35356
6107,CA,Tulare,,2012,16.4,168088,201078,32990
6107,CA,Tulare,,2013,14.5,171350,200490,29140
6107,CA,Tulare,,2014,13.3,171630,197913,26283
6107,CA,Tulare,,2015,11.7,178491,202126,23635
6107,CA,Tulare,,2016,11.2,180503,203292,22789
6107,CA,Tulare,,2017,10.5,182958,204457,21499
6107,CA,Tulare,,2018,9.8,183065,203039,19974
6107,CA,Tulare,,2019,9.8,182554,202496,19942
6107,CA,Tulare,,2020,13.6,174781,202207,27426
6107,CA,Tulare,,2021,10.7,179461,200896,21435
6109,CA,Tuolumne,,2007,6.1,24223,25806,1583
6109,CA,Tuolumne,,2008,8,23710,25779,2069
6109,CA,Tuolumne,,2009,12.7,22592,25871,3279
6109,CA,Tuolumne,,2010,15.6,19124,22657,3533
6109,CA,Tuolumne,,2011,14.7,19363,22701,3338
6109,CA,Tuolumne,,2012,13.2,19341,22278,2937
6109,CA,Tuolumne,,2013,10.9,19314,21678,2364
6109,CA,Tuolumne,,2014,8.8,19651,21536,1885
6109,CA,Tuolumne,,2015,7.1,20005,21532,1527
6109,CA,Tuolumne,,2016,6.2,20221,21567,1346
6109,CA,Tuolumne,,2017,5.4,20208,21368,1160
6109,CA,Tuolumne,,2018,4.7,20191,21187,996
6109,CA,Tuolumne,,2019,4.6,20003,20968,965
6109,CA,Tuolumne,,2020,10.7,17998,20153,2155
6109,CA,Tuolumne,,2021,7.3,18586,20042,1456
6111,CA,Ventura,,2007,4.8,403179,423646,20467
6111,CA,Ventura,,2008,6.3,401897,429007,27110
6111,CA,Ventura,,2009,10.1,388774,432230,43456
6111,CA,Ventura,,2010,11.1,382449,430235,47786
6111,CA,Ventura,,2011,10.4,385967,430917,44950
6111,CA,Ventura,,2012,9.2,393575,433668,40093
6111,CA,Ventura,,2013,8,397865,432345,34480
6111,CA,Ventura,,2014,6.7,400313,429179,28866
6111,CA,Ventura,,2015,5.7,402977,427235,24258
6111,CA,Ventura,,2016,5.2,403087,425346,22259
6111,CA,Ventura,,2017,4.5,404462,423676,19214
6111,CA,Ventura,,2018,3.9,406752,423044,16292
6111,CA,Ventura,,2019,3.7,406610,422110,15500
6111,CA,Ventura,,2020,8.8,373303,409408,36105
6111,CA,Ventura,,2021,6.2,379995,404923,24928
6113,CA,Yolo,,2007,5.7,92108,97644,5536
6113,CA,Yolo,,2008,7.4,91039,98348,7309
6113,CA,Yolo,,2009,11.5,87851,99246,11395
6113,CA,Yolo,,2010,12.4,89606,102253,12647
6113,CA,Yolo,,2011,12,89464,101633,12169
6113,CA,Yolo,,2012,10.8,91322,102397,11075
6113,CA,Yolo,,2013,9.1,92218,101475,9257
6113,CA,Yolo,,2014,7.6,94258,102028,7770
6113,CA,Yolo,,2015,6.5,97384,104154,6770
6113,CA,Yolo,,2016,5.9,99812,106078,6266
6113,CA,Yolo,,2017,5.1,101083,106564,5481
6113,CA,Yolo,,2018,4.3,102886,107537,4651
6113,CA,Yolo,,2019,4.2,103583,108121,4538
6113,CA,Yolo,,2020,7.8,96435,104638,8203
6113,CA,Yolo,,2021,5.8,99926,106122,6196
6115,CA,Yuba,,2007,9.2,24861,27369,2508
6115,CA,Yuba,,2008,12,24403,27716,3313
6115,CA,Yuba,,2009,17.5,23572,28573,5001
6115,CA,Yuba,,2010,18.2,23841,29137,5296
6115,CA,Yuba,,2011,17.3,23940,28933,4993
6115,CA,Yuba,,2012,15.6,24297,28798,4501
6115,CA,Yuba,,2013,13.3,24414,28166,3752
6115,CA,Yuba,,2014,11.3,24696,27853,3157
6115,CA,Yuba,,2015,9.3,25135,27726,2591
6115,CA,Yuba,,2016,8.6,25722,28153,2431
6115,CA,Yuba,,2017,7.5,26570,28718,2148
6115,CA,Yuba,,2018,6.5,27346,29241,1895
6115,CA,Yuba,,2019,6.2,27944,29793,1849
6115,CA,Yuba,,2020,10.7,27370,30665,3295
6115,CA,Yuba,,2021,8.5,28148,30752,2604
8000,CO,Colorado,,2007,3.7,2588340,2687742,99402
8000,CO,Colorado,,2008,4.9,2601712,2734398,132686
8000,CO,Colorado,,2009,7.9,2515483,2730604,215121
8000,CO,Colorado,,2010,9.2,2466996,2715723,248727
8000,CO,Colorado,,2011,8.7,2493472,2730262,236790
8000,CO,Colorado,,2012,8,2529785,2749192,219407
8000,CO,Colorado,,2013,6.7,2579568,2766140,186572
8000,CO,Colorado,,2014,5,2661070,2800666,139596
8000,CO,Colorado,,2015,3.7,2719997,2825761,105764
8000,CO,Colorado,,2016,3.1,2803504,2894157,90653
8000,CO,Colorado,,2017,2.6,2885980,2963790,77810
8000,CO,Colorado,,2018,3,2957690,3049640,91950
8000,CO,Colorado,,2019,2.6,3019934,3100598,80664
8000,CO,Colorado,,2020,6.9,2874857,3087271,212414
8000,CO,Colorado,,2021,5.4,2986711,3156110,169399
8001,CO,Adams,,2007,4.2,212201,221445,9244
8001,CO,Adams,,2008,5.4,215050,227365,12315
8001,CO,Adams,,2009,9.1,208259,229197,20938
8001,CO,Adams,,2010,10.5,209082,233563,24481
8001,CO,Adams,,2011,10.3,211759,236016,24257
8001,CO,Adams,,2012,9.5,216056,238797,22741
8001,CO,Adams,,2013,8,222280,241599,19319
8001,CO,Adams,,2014,5.7,230977,244942,13965
8001,CO,Adams,,2015,4.2,237372,247743,10371
8001,CO,Adams,,2016,3.4,244903,253599,8696
8001,CO,Adams,,2017,2.8,251187,258513,7326
8001,CO,Adams,,2018,3.2,257987,266494,8507
8001,CO,Adams,,2019,2.8,263585,271103,7518
8001,CO,Adams,,2020,7.6,249734,270349,20615
8001,CO,Adams,,2021,6.2,259081,276299,17218
8003,CO,Alamosa,,2007,3.9,8094,8424,330
8003,CO,Alamosa,,2008,5.2,7969,8410,441
8003,CO,Alamosa,,2009,6.8,8343,8954,611
8003,CO,Alamosa,,2010,9.5,6955,7681,726
8003,CO,Alamosa,,2011,10.1,6904,7676,772
8003,CO,Alamosa,,2012,10.6,6915,7737,822
8003,CO,Alamosa,,2013,9.6,6832,7555,723
8003,CO,Alamosa,,2014,7.2,6970,7509,539
8003,CO,Alamosa,,2015,5,7267,7648,381
8003,CO,Alamosa,,2016,3.9,7657,7964,307
8003,CO,Alamosa,,2017,3.2,7810,8067,257
8003,CO,Alamosa,,2018,3.7,8161,8477,316
8003,CO,Alamosa,,2019,3.3,8138,8418,280
8003,CO,Alamosa,,2020,6.1,7809,8312,503
8003,CO,Alamosa,,2021,5.5,8062,8533,471
8005,CO,Arapahoe,,2007,3.7,296142,307557,11415
8005,CO,Arapahoe,,2008,4.9,299269,314696,15427
8005,CO,Arapahoe,,2009,7.8,288803,313359,24556
8005,CO,Arapahoe,,2010,9,287454,315828,28374
8005,CO,Arapahoe,,2011,8.6,291255,318595,27340
8005,CO,Arapahoe,,2012,7.8,296756,321927,25171
8005,CO,Arapahoe,,2013,6.5,304991,326164,21173
8005,CO,Arapahoe,,2014,4.9,314951,331140,16189
8005,CO,Arapahoe,,2015,3.6,322380,334380,12000
8005,CO,Arapahoe,,2016,3,330532,340623,10091
8005,CO,Arapahoe,,2017,2.6,338561,347523,8962
8005,CO,Arapahoe,,2018,3,345984,356525,10541
8005,CO,Arapahoe,,2019,2.5,352585,361796,9211
8005,CO,Arapahoe,,2020,7.5,333136,359977,26841
8005,CO,Arapahoe,,2021,5.8,345949,367171,21222
8007,CO,Archuleta,,2007,3.8,6411,6661,250
8007,CO,Archuleta,,2008,5.1,6234,6567,333
8007,CO,Archuleta,,2009,8.1,5841,6353,512
8007,CO,Archuleta,,2010,11.1,5129,5771,642
8007,CO,Archuleta,,2011,10.4,5140,5739,599
8007,CO,Archuleta,,2012,10.2,5140,5722,582
8007,CO,Archuleta,,2013,8.6,5204,5696,492
8007,CO,Archuleta,,2014,6,5381,5722,341
8007,CO,Archuleta,,2015,3.9,5777,6011,234
8007,CO,Archuleta,,2016,3.1,6165,6365,200
8007,CO,Archuleta,,2017,2.8,6375,6560,185
8007,CO,Archuleta,,2018,3.2,6582,6798,216
8007,CO,Archuleta,,2019,3,6641,6845,204
8007,CO,Archuleta,,2020,7.2,6537,7042,505
8007,CO,Archuleta,,2021,4.9,6943,7300,357
8009,CO,Baca,,2007,2.5,2360,2420,60
8009,CO,Baca,,2008,3.4,2179,2256,77
8009,CO,Baca,,2009,3.9,2489,2591,102
8009,CO,Baca,,2010,5.2,1967,2074,107
8009,CO,Baca,,2011,5,1958,2061,103
8009,CO,Baca,,2012,4.6,1916,2008,92
8009,CO,Baca,,2013,4.1,1818,1895,77
8009,CO,Baca,,2014,2.8,1872,1925,53
8009,CO,Baca,,2015,2,1932,1971,39
8009,CO,Baca,,2016,1.6,2059,2093,34
8009,CO,Baca,,2017,1.5,2073,2105,32
8009,CO,Baca,,2018,1.7,2114,2150,36
8009,CO,Baca,,2019,1.6,2105,2139,34
8009,CO,Baca,,2020,2.3,2036,2083,47
8009,CO,Baca,,2021,2.1,2073,2118,45
8011,CO,Bent,,2007,4.8,2327,2444,117
8011,CO,Bent,,2008,6.2,2210,2357,147
8011,CO,Bent,,2009,7,2497,2686,189
8011,CO,Bent,,2010,8.6,1829,2000,171
8011,CO,Bent,,2011,8.6,1760,1925,165
8011,CO,Bent,,2012,8.5,1571,1717,146
8011,CO,Bent,,2013,7.6,1520,1645,125
8011,CO,Bent,,2014,5.3,1564,1651,87
8011,CO,Bent,,2015,3.8,1666,1732,66
8011,CO,Bent,,2016,2.9,1797,1851,54
8011,CO,Bent,,2017,2.6,1860,1909,49
8011,CO,Bent,,2018,3,1831,1888,57
8011,CO,Bent,,2019,2.6,1802,1851,49
8011,CO,Bent,,2020,4.1,1700,1773,73
8011,CO,Bent,,2021,6.1,1771,1886,115
8013,CO,Boulder,,2007,3.2,169467,175158,5691
8013,CO,Boulder,,2008,4.2,171193,178629,7436
8013,CO,Boulder,,2009,6.6,164180,175833,11653
8013,CO,Boulder,,2010,7.4,157072,169678,12606
8013,CO,Boulder,,2011,6.7,160020,171585,11565
8013,CO,Boulder,,2012,6.3,162818,173808,10990
8013,CO,Boulder,,2013,5.4,165314,174766,9452
8013,CO,Boulder,,2014,4.1,168947,176123,7176
8013,CO,Boulder,,2015,3.1,171415,176818,5403
8013,CO,Boulder,,2016,2.6,176286,180901,4615
8013,CO,Boulder,,2017,2.2,180914,185056,4142
8013,CO,Boulder,,2018,2.6,185906,190906,5000
8013,CO,Boulder,,2019,2.2,189610,193894,4284
8013,CO,Boulder,,2020,5.8,179615,190742,11127
8013,CO,Boulder,,2021,4.4,187094,195616,8522
8014,CO,Broomfield,,2007,3.5,29189,30245,1056
8014,CO,Broomfield,,2008,4.5,29639,31046,1407
8014,CO,Broomfield,,2009,7.4,28620,30919,2299
8014,CO,Broomfield,,2010,7.8,28970,31418,2448
8014,CO,Broomfield,,2011,7.3,29377,31684,2307
8014,CO,Broomfield,,2012,6.7,30009,32175,2166
8014,CO,Broomfield,,2013,5.7,30895,32769,1874
8014,CO,Broomfield,,2014,4.2,32727,34165,1438
8014,CO,Broomfield,,2015,3.2,34415,35546,1131
8014,CO,Broomfield,,2016,2.8,35767,36784,1017
8014,CO,Broomfield,,2017,2.4,37289,38214,925
8014,CO,Broomfield,,2018,2.7,38132,39188,1056
8014,CO,Broomfield,,2019,2.3,39216,40147,931
8014,CO,Broomfield,,2020,6.2,37908,40409,2501
8014,CO,Broomfield,,2021,4.5,39319,41167,1848
8015,CO,Chaffee,,2007,3.5,7989,8282,293
8015,CO,Chaffee,,2008,4.5,8037,8417,380
8015,CO,Chaffee,,2009,6.8,8009,8593,584
8015,CO,Chaffee,,2010,8.1,7575,8244,669
8015,CO,Chaffee,,2011,7.5,7659,8282,623
8015,CO,Chaffee,,2012,6.9,7765,8343,578
8015,CO,Chaffee,,2013,6,7796,8298,502
8015,CO,Chaffee,,2014,4.3,8017,8381,364
8015,CO,Chaffee,,2015,3.3,8215,8494,279
8015,CO,Chaffee,,2016,2.5,8619,8843,224
8015,CO,Chaffee,,2017,2.2,9026,9227,201
8015,CO,Chaffee,,2018,2.5,9288,9525,237
8015,CO,Chaffee,,2019,2.3,9477,9696,219
8015,CO,Chaffee,,2020,6,9062,9642,580
8015,CO,Chaffee,,2021,4,9835,10248,413
8017,CO,Cheyenne,,2007,2.5,1344,1378,34
8017,CO,Cheyenne,,2008,2.7,1230,1264,34
8017,CO,Cheyenne,,2009,2.8,1333,1371,38
8017,CO,Cheyenne,,2010,4.4,996,1042,46
8017,CO,Cheyenne,,2011,4.4,1001,1047,46
8017,CO,Cheyenne,,2012,4.6,960,1006,46
8017,CO,Cheyenne,,2013,4.1,929,969,40
8017,CO,Cheyenne,,2014,2.9,943,971,28
8017,CO,Cheyenne,,2015,2.6,985,1011,26
8017,CO,Cheyenne,,2016,2.1,1058,1081,23
8017,CO,Cheyenne,,2017,1.6,1106,1124,18
8017,CO,Cheyenne,,2018,1.7,1110,1129,19
8017,CO,Cheyenne,,2019,1.5,1112,1129,17
8017,CO,Cheyenne,,2020,2.3,1058,1083,25
8017,CO,Cheyenne,,2021,2.3,1080,1105,25
8019,CO,Clear Creek,,2007,3.6,5490,5696,206
8019,CO,Clear Creek,,2008,4.6,5427,5689,262
8019,CO,Clear Creek,,2009,7.8,5018,5441,423
8019,CO,Clear Creek,,2010,8.4,5126,5597,471
8019,CO,Clear Creek,,2011,7.6,5066,5485,419
8019,CO,Clear Creek,,2012,7.1,5080,5470,390
8019,CO,Clear Creek,,2013,6.2,5104,5440,336
8019,CO,Clear Creek,,2014,4.6,5260,5515,255
8019,CO,Clear Creek,,2015,3.5,5349,5545,196
8019,CO,Clear Creek,,2016,3,5513,5686,173
8019,CO,Clear Creek,,2017,2.4,5679,5819,140
8019,CO,Clear Creek,,2018,2.8,5752,5918,166
8019,CO,Clear Creek,,2019,2.3,5870,6009,139
8019,CO,Clear Creek,,2020,8.2,5475,5964,489
8019,CO,Clear Creek,,2021,5.5,5689,6023,334
8021,CO,Conejos,,2007,5.5,3469,3670,201
8021,CO,Conejos,,2008,7.3,3390,3658,268
8021,CO,Conejos,,2009,8,3449,3749,300
8021,CO,Conejos,,2010,10,3368,3744,376
8021,CO,Conejos,,2011,10.9,3319,3723,404
8021,CO,Conejos,,2012,10.8,3304,3703,399
8021,CO,Conejos,,2013,10.5,3228,3606,378
8021,CO,Conejos,,2014,7.8,3327,3607,280
8021,CO,Conejos,,2015,5.5,3398,3596,198
8021,CO,Conejos,,2016,4.6,3594,3769,175
8021,CO,Conejos,,2017,3.9,3737,3887,150
8021,CO,Conejos,,2018,3.9,3896,4055,159
8021,CO,Conejos,,2019,3.4,3985,4126,141
8021,CO,Conejos,,2020,5.4,3790,4006,216
8021,CO,Conejos,,2021,4.8,3906,4102,196
8023,CO,Costilla,,2007,7,1222,1314,92
8023,CO,Costilla,,2008,7.8,1188,1288,100
8023,CO,Costilla,,2009,9.8,1249,1384,135
8023,CO,Costilla,,2010,11.1,1378,1550,172
8023,CO,Costilla,,2011,12.1,1389,1580,191
8023,CO,Costilla,,2012,11.6,1414,1599,185
8023,CO,Costilla,,2013,11,1418,1594,176
8023,CO,Costilla,,2014,9,1463,1608,145
8023,CO,Costilla,,2015,6.2,1521,1621,100
8023,CO,Costilla,,2016,4.6,1648,1728,80
8023,CO,Costilla,,2017,3.3,1746,1805,59
8023,CO,Costilla,,2018,4.1,1747,1821,74
8023,CO,Costilla,,2019,3.7,1783,1852,69
8023,CO,Costilla,,2020,6.9,1687,1812,125
8023,CO,Costilla,,2021,6,1771,1885,114
8025,CO,Crowley,,2007,6.2,1818,1939,121
8025,CO,Crowley,,2008,7.4,1698,1833,135
8025,CO,Crowley,,2009,9.3,1810,1996,186
8025,CO,Crowley,,2010,9.7,1373,1520,147
8025,CO,Crowley,,2011,9.2,1349,1486,137
8025,CO,Crowley,,2012,8.2,1247,1358,111
8025,CO,Crowley,,2013,7,1228,1321,93
8025,CO,Crowley,,2014,5.9,1238,1315,77
8025,CO,Crowley,,2015,4.3,1295,1353,58
8025,CO,Crowley,,2016,3.4,1374,1422,48
8025,CO,Crowley,,2017,2.9,1415,1457,42
8025,CO,Crowley,,2018,4.1,1417,1477,60
8025,CO,Crowley,,2019,4,1479,1541,62
8025,CO,Crowley,,2020,5.3,1364,1440,76
8025,CO,Crowley,,2021,5.2,1389,1465,76
8027,CO,Custer,,2007,3.9,1932,2011,79
8027,CO,Custer,,2008,5.1,1826,1924,98
8027,CO,Custer,,2009,6.8,1905,2043,138
8027,CO,Custer,,2010,7,1925,2070,145
8027,CO,Custer,,2011,6.6,1879,2012,133
8027,CO,Custer,,2012,6.5,1853,1981,128
8027,CO,Custer,,2013,6.3,1799,1920,121
8027,CO,Custer,,2014,4.6,1888,1979,91
8027,CO,Custer,,2015,3.4,1921,1988,67
8027,CO,Custer,,2016,3,1958,2019,61
8027,CO,Custer,,2017,2.8,1958,2015,57
8027,CO,Custer,,2018,3.4,1992,2062,70
8027,CO,Custer,,2019,2.8,1987,2045,58
8027,CO,Custer,,2020,4.7,1986,2085,99
8027,CO,Custer,,2021,4,2232,2325,93
8029,CO,Delta,,2007,3.3,16014,16555,541
8029,CO,Delta,,2008,4.4,15878,16608,730
8029,CO,Delta,,2009,7.7,15704,17017,1313
8029,CO,Delta,,2010,11.2,12860,14477,1617
8029,CO,Delta,,2011,10.8,12834,14388,1554
8029,CO,Delta,,2012,9.8,12958,14365,1407
8029,CO,Delta,,2013,8.8,12627,13842,1215
8029,CO,Delta,,2014,7,12638,13592,954
8029,CO,Delta,,2015,5.5,12693,13432,739
8029,CO,Delta,,2016,4.7,13293,13948,655
8029,CO,Delta,,2017,3.6,13641,14149,508
8029,CO,Delta,,2018,3.7,13732,14262,530
8029,CO,Delta,,2019,3.2,13765,14213,448
8029,CO,Delta,,2020,6.3,13273,14159,886
8029,CO,Delta,,2021,5.3,13599,14360,761
8031,CO,Denver,,2007,4.1,304470,317494,13024
8031,CO,Denver,,2008,5.4,307910,325465,17555
8031,CO,Denver,,2009,8.8,296981,325469,28488
8031,CO,Denver,,2010,9.5,313456,346523,33067
8031,CO,Denver,,2011,8.9,320182,351436,31254
8031,CO,Denver,,2012,7.9,328259,356577,28318
8031,CO,Denver,,2013,6.5,338950,362629,23679
8031,CO,Denver,,2014,4.8,351002,368663,17661
8031,CO,Denver,,2015,3.6,362250,375631,13381
8031,CO,Denver,,2016,3,373645,385108,11463
8031,CO,Denver,,2017,2.5,385501,395587,10086
8031,CO,Denver,,2018,2.9,395573,407482,11909
8031,CO,Denver,,2019,2.5,405807,416384,10577
8031,CO,Denver,,2020,7.8,387275,419844,32569
8031,CO,Denver,,2021,5.9,402123,427421,25298
8033,CO,Dolores,,2007,4.9,988,1039,51
8033,CO,Dolores,,2008,7.2,919,990,71
8033,CO,Dolores,,2009,14.2,903,1052,149
8033,CO,Dolores,,2010,18.5,817,1003,186
8033,CO,Dolores,,2011,13.3,821,947,126
8033,CO,Dolores,,2012,10.3,849,947,98
8033,CO,Dolores,,2013,8.2,931,1014,83
8033,CO,Dolores,,2014,3.9,1277,1329,52
8033,CO,Dolores,,2015,3,1283,1323,40
8033,CO,Dolores,,2016,3.7,1031,1071,40
8033,CO,Dolores,,2017,2.7,1089,1119,30
8033,CO,Dolores,,2018,2.6,1106,1136,30
8033,CO,Dolores,,2019,2.8,1104,1136,32
8033,CO,Dolores,,2020,6.5,1061,1135,74
8033,CO,Dolores,,2021,4.7,1121,1176,55
8035,CO,Douglas,,2007,3.1,151479,156306,4827
8035,CO,Douglas,,2008,4.2,155246,162039,6793
8035,CO,Douglas,,2009,6.7,150859,161640,10781
8035,CO,Douglas,,2010,7.3,145418,156945,11527
8035,CO,Douglas,,2011,6.7,147339,157884,10545
8035,CO,Douglas,,2012,6.1,150643,160408,9765
8035,CO,Douglas,,2013,5.2,155829,164423,8594
8035,CO,Douglas,,2014,4,162392,169151,6759
8035,CO,Douglas,,2015,3,167066,172204,5138
8035,CO,Douglas,,2016,2.5,173042,177570,4528
8035,CO,Douglas,,2017,2.2,179180,183237,4057
8035,CO,Douglas,,2018,2.6,184850,189833,4983
8035,CO,Douglas,,2019,2.2,191411,195801,4390
8035,CO,Douglas,,2020,5.4,185505,196099,10594
8035,CO,Douglas,,2021,4.1,192563,200746,8183
8037,CO,Eagle,,2007,2.8,30324,31199,875
8037,CO,Eagle,,2008,3.6,30731,31874,1143
8037,CO,Eagle,,2009,7.6,28284,30603,2319
8037,CO,Eagle,,2010,8.9,29465,32342,2877
8037,CO,Eagle,,2011,8.1,29461,32072,2611
8037,CO,Eagle,,2012,7.3,29912,32251,2339
8037,CO,Eagle,,2013,5.9,29970,31864,1894
8037,CO,Eagle,,2014,4.2,31036,32381,1345
8037,CO,Eagle,,2015,3,31765,32755,990
8037,CO,Eagle,,2016,2.6,32848,33733,885
8037,CO,Eagle,,2017,2.2,33775,34520,745
8037,CO,Eagle,,2018,2.5,34891,35782,891
8037,CO,Eagle,,2019,2.1,35553,36327,774
8037,CO,Eagle,,2020,9,32204,35383,3179
8037,CO,Eagle,,2021,4.4,35177,36813,1636
8039,CO,Elbert,,2007,3.6,12438,12909,471
8039,CO,Elbert,,2008,4.8,12475,13105,630
8039,CO,Elbert,,2009,7.6,11986,12967,981
8039,CO,Elbert,,2010,8.5,11635,12712,1077
8039,CO,Elbert,,2011,7.8,11660,12645,985
8039,CO,Elbert,,2012,7.2,11742,12654,912
8039,CO,Elbert,,2013,5.8,11956,12691,735
8039,CO,Elbert,,2014,4.3,12403,12954,551
8039,CO,Elbert,,2015,3,12862,13264,402
8039,CO,Elbert,,2016,2.5,13460,13802,342
8039,CO,Elbert,,2017,2.2,13952,14273,321
8039,CO,Elbert,,2018,2.6,14501,14885,384
8039,CO,Elbert,,2019,2.1,14888,15201,313
8039,CO,Elbert,,2020,4.4,14339,15000,661
8039,CO,Elbert,,2021,3.8,14881,15468,587
8041,CO,El Paso,,2007,4.2,287425,300057,12632
8041,CO,El Paso,,2008,5.7,285022,302182,17160
8041,CO,El Paso,,2009,8.5,275602,301220,25618
8041,CO,El Paso,,2010,9.8,275510,305347,29837
8041,CO,El Paso,,2011,9.4,278004,306825,28821
8041,CO,El Paso,,2012,9,278707,306176,27469
8041,CO,El Paso,,2013,7.8,282804,306626,23822
8041,CO,El Paso,,2014,6,288214,306538,18324
8041,CO,El Paso,,2015,4.4,293988,307595,13607
8041,CO,El Paso,,2016,3.6,303352,314650,11298
8041,CO,El Paso,,2017,3,313035,322818,9783
8041,CO,El Paso,,2018,3.6,319727,331759,12032
8041,CO,El Paso,,2019,3.1,327573,338068,10495
8041,CO,El Paso,,2020,6.9,318462,341997,23535
8041,CO,El Paso,,2021,5.6,330916,350677,19761
8043,CO,Fremont,,2007,4.7,18888,19814,926
8043,CO,Fremont,,2008,6.4,18605,19868,1263
8043,CO,Fremont,,2009,9.2,18214,20059,1845
8043,CO,Fremont,,2010,12.2,13864,15798,1934
8043,CO,Fremont,,2011,12.5,13928,15913,1985
8043,CO,Fremont,,2012,11.8,13755,15596,1841
8043,CO,Fremont,,2013,10.5,13359,14929,1570
8043,CO,Fremont,,2014,8.2,13336,14524,1188
8043,CO,Fremont,,2015,5.9,13627,14489,862
8043,CO,Fremont,,2016,4.9,13968,14695,727
8043,CO,Fremont,,2017,4,14231,14817,586
8043,CO,Fremont,,2018,4.8,14170,14886,716
8043,CO,Fremont,,2019,4.3,14276,14922,646
8043,CO,Fremont,,2020,7.4,14104,15223,1119
8043,CO,Fremont,,2021,6.9,14764,15860,1096
8045,CO,Garfield,,2007,2.4,34395,35252,857
8045,CO,Garfield,,2008,3.1,35836,36991,1155
8045,CO,Garfield,,2009,7.5,32161,34775,2614
8045,CO,Garfield,,2010,10.8,27896,31281,3385
8045,CO,Garfield,,2011,9.8,28248,31320,3072
8045,CO,Garfield,,2012,8.6,28698,31397,2699
8045,CO,Garfield,,2013,7.3,28657,30923,2266
8045,CO,Garfield,,2014,5.2,29525,31156,1631
8045,CO,Garfield,,2015,4,29247,30462,1215
8045,CO,Garfield,,2016,3.3,29959,30994,1035
8045,CO,Garfield,,2017,2.7,30420,31257,837
8045,CO,Garfield,,2018,2.9,31108,32051,943
8045,CO,Garfield,,2019,2.6,31520,32347,827
8045,CO,Garfield,,2020,6.5,29376,31405,2029
8045,CO,Garfield,,2021,4.7,30749,32254,1505
8047,CO,Gilpin,,2007,3.5,3325,3444,119
8047,CO,Gilpin,,2008,4.2,3344,3492,148
8047,CO,Gilpin,,2009,6.5,3441,3682,241
8047,CO,Gilpin,,2010,8.4,3036,3316,280
8047,CO,Gilpin,,2011,7.5,3017,3262,245
8047,CO,Gilpin,,2012,6.8,3037,3257,220
8047,CO,Gilpin,,2013,5.9,3118,3313,195
8047,CO,Gilpin,,2014,4.4,3298,3448,150
8047,CO,Gilpin,,2015,3,3297,3399,102
8047,CO,Gilpin,,2016,2.3,3406,3485,79
8047,CO,Gilpin,,2017,1.9,3505,3572,67
8047,CO,Gilpin,,2018,2.3,3601,3687,86
8047,CO,Gilpin,,2019,2.2,3712,3794,82
8047,CO,Gilpin,,2020,10.9,3501,3930,429
8047,CO,Gilpin,,2021,6.2,3641,3880,239
8049,CO,Grand,,2007,2.6,9001,9239,238
8049,CO,Grand,,2008,3.7,8866,9207,341
8049,CO,Grand,,2009,7.2,8418,9073,655
8049,CO,Grand,,2010,9.2,8102,8924,822
8049,CO,Grand,,2011,8.4,8042,8777,735
8049,CO,Grand,,2012,7.3,8081,8722,641
8049,CO,Grand,,2013,5.7,8264,8768,504
8049,CO,Grand,,2014,4,8570,8927,357
8049,CO,Grand,,2015,3.1,8775,9056,281
8049,CO,Grand,,2016,2.6,8955,9191,236
8049,CO,Grand,,2017,2.1,9265,9463,198
8049,CO,Grand,,2018,2.5,9573,9815,242
8049,CO,Grand,,2019,2,9579,9777,198
8049,CO,Grand,,2020,8,8505,9245,740
8049,CO,Grand,,2021,4.2,9309,9718,409
8051,CO,Gunnison,,2007,2.8,9337,9604,267
8051,CO,Gunnison,,2008,3.6,9221,9566,345
8051,CO,Gunnison,,2009,5.9,8883,9438,555
8051,CO,Gunnison,,2010,6.8,9365,10047,682
8051,CO,Gunnison,,2011,6.3,9284,9906,622
8051,CO,Gunnison,,2012,6.1,9207,9801,594
8051,CO,Gunnison,,2013,5.4,9115,9633,518
8051,CO,Gunnison,,2014,4,9281,9670,389
8051,CO,Gunnison,,2015,2.8,9515,9793,278
8051,CO,Gunnison,,2016,2.2,9918,10140,222
8051,CO,Gunnison,,2017,1.9,10403,10603,200
8051,CO,Gunnison,,2018,2.3,10981,11239,258
8051,CO,Gunnison,,2019,2,11126,11357,231
8051,CO,Gunnison,,2020,6.3,10587,11296,709
8051,CO,Gunnison,,2021,3.7,11402,11837,435
8053,CO,Hinsdale,,2007,2.9,597,615,18
8053,CO,Hinsdale,,2008,3.4,626,648,22
8053,CO,Hinsdale,,2009,3.5,641,664,23
8053,CO,Hinsdale,,2010,6,440,468,28
8053,CO,Hinsdale,,2011,5.3,446,471,25
8053,CO,Hinsdale,,2012,4.8,414,435,21
8053,CO,Hinsdale,,2013,4.6,412,432,20
8053,CO,Hinsdale,,2014,3.7,418,434,16
8053,CO,Hinsdale,,2015,3,427,440,13
8053,CO,Hinsdale,,2016,2.2,437,447,10
8053,CO,Hinsdale,,2017,2.1,459,469,10
8053,CO,Hinsdale,,2018,2.5,428,439,11
8053,CO,Hinsdale,,2019,3.2,421,435,14
8053,CO,Hinsdale,,2020,4,406,423,17
8053,CO,Hinsdale,,2021,3.6,434,450,16
8055,CO,Huerfano,,2007,4.7,3223,3382,159
8055,CO,Huerfano,,2008,6.4,3235,3457,222
8055,CO,Huerfano,,2009,9.4,3174,3503,329
8055,CO,Huerfano,,2010,14.6,2309,2703,394
8055,CO,Huerfano,,2011,14.1,2285,2659,374
8055,CO,Huerfano,,2012,14.4,2250,2629,379
8055,CO,Huerfano,,2013,13.5,2194,2536,342
8055,CO,Huerfano,,2014,10,2169,2409,240
8055,CO,Huerfano,,2015,7.4,2190,2366,176
8055,CO,Huerfano,,2016,6,2346,2497,151
8055,CO,Huerfano,,2017,5.3,2390,2525,135
8055,CO,Huerfano,,2018,6.1,2398,2554,156
8055,CO,Huerfano,,2019,5.4,2370,2506,136
8055,CO,Huerfano,,2020,9,2362,2597,235
8055,CO,Huerfano,,2021,8.2,2428,2645,217
8057,CO,Jackson,,2007,2.5,1085,1113,28
8057,CO,Jackson,,2008,3.3,1053,1089,36
8057,CO,Jackson,,2009,4.5,1235,1293,58
8057,CO,Jackson,,2010,9.3,832,917,85
8057,CO,Jackson,,2011,6.4,834,891,57
8057,CO,Jackson,,2012,5.3,780,824,44
8057,CO,Jackson,,2013,4.7,755,792,37
8057,CO,Jackson,,2014,3.6,804,834,30
8057,CO,Jackson,,2015,3.6,804,834,30
8057,CO,Jackson,,2016,2.6,869,892,23
8057,CO,Jackson,,2017,1.7,937,953,16
8057,CO,Jackson,,2018,2.5,955,979,24
8057,CO,Jackson,,2019,2.2,951,972,21
8057,CO,Jackson,,2020,4,898,935,37
8057,CO,Jackson,,2021,3.3,955,988,33
8059,CO,Jefferson,,2007,3.6,294922,305986,11064
8059,CO,Jefferson,,2008,4.7,295301,309867,14566
8059,CO,Jefferson,,2009,7.7,281264,304742,23478
8059,CO,Jefferson,,2010,8.8,276614,303208,26594
8059,CO,Jefferson,,2011,8.3,276822,301767,24945
8059,CO,Jefferson,,2012,7.5,280682,303422,22740
8059,CO,Jefferson,,2013,6.2,286333,305164,18831
8059,CO,Jefferson,,2014,4.5,293571,307519,13948
8059,CO,Jefferson,,2015,3.4,298400,308899,10499
8059,CO,Jefferson,,2016,2.8,306493,315406,8913
8059,CO,Jefferson,,2017,2.4,312568,320378,7810
8059,CO,Jefferson,,2018,2.8,318566,327698,9132
8059,CO,Jefferson,,2019,2.4,323425,331396,7971
8059,CO,Jefferson,,2020,6.8,305440,327550,22110
8059,CO,Jefferson,,2021,5,317284,334051,16767
8061,CO,Kiowa,,2007,2.6,895,919,24
8061,CO,Kiowa,,2008,3.7,823,855,32
8061,CO,Kiowa,,2009,4.6,956,1002,46
8061,CO,Kiowa,,2010,6.7,724,776,52
8061,CO,Kiowa,,2011,5.2,790,833,43
8061,CO,Kiowa,,2012,4.7,777,815,38
8061,CO,Kiowa,,2013,4.3,730,763,33
8061,CO,Kiowa,,2014,3.3,727,752,25
8061,CO,Kiowa,,2015,2.5,771,791,20
8061,CO,Kiowa,,2016,1.9,830,846,16
8061,CO,Kiowa,,2017,1.6,901,916,15
8061,CO,Kiowa,,2018,1.7,919,935,16
8061,CO,Kiowa,,2019,1.5,934,948,14
8061,CO,Kiowa,,2020,2.3,931,953,22
8061,CO,Kiowa,,2021,3.3,925,957,32
8063,CO,Kit Carson,,2007,2.7,4394,4514,120
8063,CO,Kit Carson,,2008,3.4,4228,4375,147
8063,CO,Kit Carson,,2009,4.2,4653,4859,206
8063,CO,Kit Carson,,2010,4.8,4158,4368,210
8063,CO,Kit Carson,,2011,4.9,4042,4250,208
8063,CO,Kit Carson,,2012,4.5,4025,4214,189
8063,CO,Kit Carson,,2013,3.9,3924,4082,158
8063,CO,Kit Carson,,2014,3,4180,4311,131
8063,CO,Kit Carson,,2015,2.3,4222,4322,100
8063,CO,Kit Carson,,2016,2,4448,4540,92
8063,CO,Kit Carson,,2017,1.6,4276,4345,69
8063,CO,Kit Carson,,2018,1.9,4171,4252,81
8063,CO,Kit Carson,,2019,1.6,4216,4283,67
8063,CO,Kit Carson,,2020,2.7,4098,4211,113
8063,CO,Kit Carson,,2021,3,4135,4261,126
8065,CO,Lake,,2007,3.5,3919,4062,143
8065,CO,Lake,,2008,4.6,3938,4128,190
8065,CO,Lake,,2009,9.2,3558,3920,362
8065,CO,Lake,,2010,11.5,3860,4362,502
8065,CO,Lake,,2011,10.4,3914,4370,456
8065,CO,Lake,,2012,8.7,4117,4511,394
8065,CO,Lake,,2013,7.1,4123,4437,314
8065,CO,Lake,,2014,4.6,4296,4504,208
8065,CO,Lake,,2015,3.7,4397,4567,170
8065,CO,Lake,,2016,2.7,4492,4618,126
8065,CO,Lake,,2017,2,4580,4673,93
8065,CO,Lake,,2018,2.4,4638,4754,116
8065,CO,Lake,,2019,2.2,4807,4916,109
8065,CO,Lake,,2020,7.7,4434,4803,369
8065,CO,Lake,,2021,4.4,4756,4974,218
8067,CO,La Plata,,2007,2.8,30415,31278,863
8067,CO,La Plata,,2008,3.6,30487,31631,1144
8067,CO,La Plata,,2009,5.8,29527,31353,1826
8067,CO,La Plata,,2010,7.5,27527,29766,2239
8067,CO,La Plata,,2011,7.3,27257,29402,2145
8067,CO,La Plata,,2012,6.7,27583,29577,1994
8067,CO,La Plata,,2013,5.6,27894,29552,1658
8067,CO,La Plata,,2014,4.2,28651,29907,1256
8067,CO,La Plata,,2015,3.3,28871,29862,991
8067,CO,La Plata,,2016,2.7,30141,30992,851
8067,CO,La Plata,,2017,2.3,30449,31155,706
8067,CO,La Plata,,2018,2.7,31083,31958,875
8067,CO,La Plata,,2019,2.4,30878,31627,749
8067,CO,La Plata,,2020,6.6,28897,30924,2027
8067,CO,La Plata,,2021,5.2,30248,31905,1657
8069,CO,Larimer,,2007,3.3,167722,173516,5794
8069,CO,Larimer,,2008,4.2,169158,176659,7501
8069,CO,Larimer,,2009,6.8,165232,177237,12005
8069,CO,Larimer,,2010,8.1,155799,169439,13640
8069,CO,Larimer,,2011,7.4,157831,170527,12696
8069,CO,Larimer,,2012,6.8,160643,172358,11715
8069,CO,Larimer,,2013,5.7,164174,174130,9956
8069,CO,Larimer,,2014,4.2,169514,177024,7510
8069,CO,Larimer,,2015,3.2,174867,180622,5755
8069,CO,Larimer,,2016,2.7,182374,187400,5026
8069,CO,Larimer,,2017,2.3,189157,193515,4358
8069,CO,Larimer,,2018,2.6,194154,199314,5160
8069,CO,Larimer,,2019,2.2,198526,203074,4548
8069,CO,Larimer,,2020,6,189216,201273,12057
8069,CO,Larimer,,2021,4.7,196875,206492,9617
8071,CO,Las Animas,,2007,3.6,8456,8769,313
8071,CO,Las Animas,,2008,4.5,8452,8852,400
8071,CO,Las Animas,,2009,8.8,7889,8649,760
8071,CO,Las Animas,,2010,11.1,6381,7178,797
8071,CO,Las Animas,,2011,11.5,6174,6973,799
8071,CO,Las Animas,,2012,12.2,6102,6947,845
8071,CO,Las Animas,,2013,11,5988,6727,739
8071,CO,Las Animas,,2014,7.5,5940,6422,482
8071,CO,Las Animas,,2015,5.4,5793,6124,331
8071,CO,Las Animas,,2016,4.8,5884,6183,299
8071,CO,Las Animas,,2017,3.7,5970,6200,230
8071,CO,Las Animas,,2018,4.3,6202,6483,281
8071,CO,Las Animas,,2019,3.7,6240,6480,240
8071,CO,Las Animas,,2020,7,5947,6398,451
8071,CO,Las Animas,,2021,6.5,6087,6513,426
8073,CO,Lincoln,,2007,3,2949,3041,92
8073,CO,Lincoln,,2008,3.7,2800,2908,108
8073,CO,Lincoln,,2009,4.5,2969,3108,139
8073,CO,Lincoln,,2010,6.3,2009,2144,135
8073,CO,Lincoln,,2011,6.6,2043,2187,144
8073,CO,Lincoln,,2012,6.6,2009,2150,141
8073,CO,Lincoln,,2013,5.7,1984,2105,121
8073,CO,Lincoln,,2014,4,2046,2132,86
8073,CO,Lincoln,,2015,3.3,2098,2169,71
8073,CO,Lincoln,,2016,2.5,2224,2280,56
8073,CO,Lincoln,,2017,1.9,2313,2358,45
8073,CO,Lincoln,,2018,2.2,2382,2436,54
8073,CO,Lincoln,,2019,2.2,2346,2398,52
8073,CO,Lincoln,,2020,4.2,2241,2340,99
8073,CO,Lincoln,,2021,4.2,2265,2364,99
8075,CO,Logan,,2007,3,11074,11421,347
8075,CO,Logan,,2008,3.9,10836,11273,437
8075,CO,Logan,,2009,5.4,11393,12040,647
8075,CO,Logan,,2010,6.7,10469,11215,746
8075,CO,Logan,,2011,6.5,10331,11052,721
8075,CO,Logan,,2012,6.1,10363,11033,670
8075,CO,Logan,,2013,5,10253,10797,544
8075,CO,Logan,,2014,3.8,10577,10992,415
8075,CO,Logan,,2015,2.9,10614,10935,321
8075,CO,Logan,,2016,2.8,10707,11017,310
8075,CO,Logan,,2017,2.2,10770,11009,239
8075,CO,Logan,,2018,2.6,10819,11106,287
8075,CO,Logan,,2019,2.3,10793,11045,252
8075,CO,Logan,,2020,4.4,10385,10867,482
8075,CO,Logan,,2021,4.4,10505,10985,480
8077,CO,Mesa,,2007,3.1,76092,78551,2459
8077,CO,Mesa,,2008,3.9,79116,82329,3213
8077,CO,Mesa,,2009,9,74934,82368,7434
8077,CO,Mesa,,2010,11.4,67247,75893,8646
8077,CO,Mesa,,2011,10.6,67366,75347,7981
8077,CO,Mesa,,2012,9.8,67409,74728,7319
8077,CO,Mesa,,2013,8.6,67161,73481,6320
8077,CO,Mesa,,2014,6.2,68640,73179,4539
8077,CO,Mesa,,2015,5.3,67929,71758,3829
8077,CO,Mesa,,2016,5.1,68374,72044,3670
8077,CO,Mesa,,2017,3.7,70295,72973,2678
8077,CO,Mesa,,2018,3.7,72024,74823,2799
8077,CO,Mesa,,2019,3.2,72931,75371,2440
8077,CO,Mesa,,2020,7.1,69424,74725,5301
8077,CO,Mesa,,2021,5.7,72798,77219,4421
8079,CO,Mineral,,2007,4.2,455,475,20
8079,CO,Mineral,,2008,5.4,452,478,26
8079,CO,Mineral,,2009,7.1,445,479,34
8079,CO,Mineral,,2010,7.2,384,414,30
8079,CO,Mineral,,2011,5.6,401,425,24
8079,CO,Mineral,,2012,5.4,419,443,24
8079,CO,Mineral,,2013,5.9,400,425,25
8079,CO,Mineral,,2014,5,403,424,21
8079,CO,Mineral,,2015,3.4,429,444,15
8079,CO,Mineral,,2016,2.2,454,464,10
8079,CO,Mineral,,2017,1.7,453,461,8
8079,CO,Mineral,,2018,2.6,494,507,13
8079,CO,Mineral,,2019,2.3,504,516,12
8079,CO,Mineral,,2020,5.6,438,464,26
8079,CO,Mineral,,2021,5,440,463,23
8081,CO,Moffat,,2007,3,8335,8596,261
8081,CO,Moffat,,2008,3.8,8447,8782,335
8081,CO,Moffat,,2009,6.7,8482,9093,611
8081,CO,Moffat,,2010,10.5,7220,8063,843
8081,CO,Moffat,,2011,9.7,7091,7851,760
8081,CO,Moffat,,2012,8.4,7076,7723,647
8081,CO,Moffat,,2013,6.8,7019,7532,513
8081,CO,Moffat,,2014,5.7,6884,7303,419
8081,CO,Moffat,,2015,4.4,6793,7104,311
8081,CO,Moffat,,2016,3.8,6908,7180,272
8081,CO,Moffat,,2017,3.1,7036,7260,224
8081,CO,Moffat,,2018,3.4,7109,7357,248
8081,CO,Moffat,,2019,3.2,7100,7336,236
8081,CO,Moffat,,2020,5.8,6749,7162,413
8081,CO,Moffat,,2021,4.8,6939,7286,347
8083,CO,Montezuma,,2007,3.8,12778,13286,508
8083,CO,Montezuma,,2008,5.2,12305,12986,681
8083,CO,Montezuma,,2009,7.9,12253,13308,1055
8083,CO,Montezuma,,2010,9.6,11774,13018,1244
8083,CO,Montezuma,,2011,9.1,11785,12962,1177
8083,CO,Montezuma,,2012,8.7,11766,12881,1115
8083,CO,Montezuma,,2013,7.6,11739,12705,966
8083,CO,Montezuma,,2014,6.1,11883,12650,767
8083,CO,Montezuma,,2015,5.5,11655,12330,675
8083,CO,Montezuma,,2016,4.7,12112,12715,603
8083,CO,Montezuma,,2017,3.7,12260,12726,466
8083,CO,Montezuma,,2018,4.4,12271,12839,568
8083,CO,Montezuma,,2019,4,12239,12749,510
8083,CO,Montezuma,,2020,6.9,11760,12626,866
8083,CO,Montezuma,,2021,5.6,12480,13215,735
8085,CO,Montrose,,2007,3.5,20184,20924,740
8085,CO,Montrose,,2008,5,19853,20902,1049
8085,CO,Montrose,,2009,8.8,19322,21175,1853
8085,CO,Montrose,,2010,11.4,18217,20572,2355
8085,CO,Montrose,,2011,11.4,17706,19990,2284
8085,CO,Montrose,,2012,10.5,17716,19785,2069
8085,CO,Montrose,,2013,9.3,17487,19279,1792
8085,CO,Montrose,,2014,6.8,17958,19260,1302
8085,CO,Montrose,,2015,4.9,18379,19319,940
8085,CO,Montrose,,2016,4,19268,20062,794
8085,CO,Montrose,,2017,3,19993,20621,628
8085,CO,Montrose,,2018,3.4,20681,21410,729
8085,CO,Montrose,,2019,2.9,20955,21589,634
8085,CO,Montrose,,2020,6.3,20134,21491,1357
8085,CO,Montrose,,2021,5,21270,22392,1122
8087,CO,Morgan,,2007,3.3,13870,14344,474
8087,CO,Morgan,,2008,4.3,13570,14174,604
8087,CO,Morgan,,2009,5.8,14221,15101,880
8087,CO,Morgan,,2010,7.4,13318,14383,1065
8087,CO,Morgan,,2011,6.9,13963,15005,1042
8087,CO,Morgan,,2012,6.9,13911,14937,1026
8087,CO,Morgan,,2013,6.4,13713,14655,942
8087,CO,Morgan,,2014,4.6,14125,14802,677
8087,CO,Morgan,,2015,3.7,14132,14669,537
8087,CO,Morgan,,2016,3.3,14542,15039,497
8087,CO,Morgan,,2017,2.3,15098,15446,348
8087,CO,Morgan,,2018,2.7,15754,16189,435
8087,CO,Morgan,,2019,2.5,15913,16318,405
8087,CO,Morgan,,2020,5.1,15089,15899,810
8087,CO,Morgan,,2021,4.9,15419,16212,793
8089,CO,Otero,,2007,4.9,8449,8887,438
8089,CO,Otero,,2008,6,8241,8763,522
8089,CO,Otero,,2009,7.4,8640,9330,690
8089,CO,Otero,,2010,9.6,7650,8464,814
8089,CO,Otero,,2011,10.4,7587,8463,876
8089,CO,Otero,,2012,10.4,7508,8379,871
8089,CO,Otero,,2013,9.7,7405,8199,794
8089,CO,Otero,,2014,7.6,7360,7966,606
8089,CO,Otero,,2015,5.6,7437,7877,440
8089,CO,Otero,,2016,4.5,7745,8110,365
8089,CO,Otero,,2017,3.9,7878,8194,316
8089,CO,Otero,,2018,4.7,7921,8309,388
8089,CO,Otero,,2019,3.9,7917,8235,318
8089,CO,Otero,,2020,5.8,7701,8179,478
8089,CO,Otero,,2021,6.1,7854,8366,512
8091,CO,Ouray,,2007,2.9,2988,3077,89
8091,CO,Ouray,,2008,3.7,2924,3037,113
8091,CO,Ouray,,2009,6.1,2729,2905,176
8091,CO,Ouray,,2010,10.4,1925,2148,223
8091,CO,Ouray,,2011,10.6,1807,2022,215
8091,CO,Ouray,,2012,9.5,1882,2079,197
8091,CO,Ouray,,2013,7.5,1967,2126,159
8091,CO,Ouray,,2014,5.8,2010,2133,123
8091,CO,Ouray,,2015,4.2,2064,2154,90
8091,CO,Ouray,,2016,3.6,2088,2166,78
8091,CO,Ouray,,2017,2.7,2182,2242,60
8091,CO,Ouray,,2018,3.2,2287,2363,76
8091,CO,Ouray,,2019,2.8,2350,2417,67
8091,CO,Ouray,,2020,7.7,2291,2481,190
8091,CO,Ouray,,2021,4.5,2586,2708,122
8093,CO,Park,,2007,3.6,9339,9684,345
8093,CO,Park,,2008,4.8,9275,9741,466
8093,CO,Park,,2009,7.5,8656,9360,704
8093,CO,Park,,2010,8.5,8786,9605,819
8093,CO,Park,,2011,7.9,8636,9377,741
8093,CO,Park,,2012,6.9,8627,9270,643
8093,CO,Park,,2013,6,8698,9249,551
8093,CO,Park,,2014,4.6,8924,9352,428
8093,CO,Park,,2015,3.3,9060,9370,310
8093,CO,Park,,2016,2.7,9574,9836,262
8093,CO,Park,,2017,2.2,10147,10375,228
8093,CO,Park,,2018,2.6,10636,10922,286
8093,CO,Park,,2019,2.3,10905,11167,262
8093,CO,Park,,2020,5.5,10370,10969,599
8093,CO,Park,,2021,4.1,10810,11273,463
8095,CO,Phillips,,2007,2.7,2376,2442,66
8095,CO,Phillips,,2008,3.4,2176,2253,77
8095,CO,Phillips,,2009,3.9,2505,2606,101
8095,CO,Phillips,,2010,5.6,2065,2187,122
8095,CO,Phillips,,2011,5.6,2028,2148,120
8095,CO,Phillips,,2012,5.2,2022,2134,112
8095,CO,Phillips,,2013,4.5,2028,2124,96
8095,CO,Phillips,,2014,3.3,2178,2252,74
8095,CO,Phillips,,2015,2.3,2304,2358,54
8095,CO,Phillips,,2016,1.9,2426,2472,46
8095,CO,Phillips,,2017,1.5,2514,2552,38
8095,CO,Phillips,,2018,1.8,2524,2570,46
8095,CO,Phillips,,2019,1.5,2539,2578,39
8095,CO,Phillips,,2020,2.6,2396,2459,63
8095,CO,Phillips,,2021,2.9,2419,2490,71
8097,CO,Pitkin,,2007,2.7,11066,11370,304
8097,CO,Pitkin,,2008,3.3,11260,11646,386
8097,CO,Pitkin,,2009,6.5,10435,11161,726
8097,CO,Pitkin,,2010,8.5,9922,10845,923
8097,CO,Pitkin,,2011,8.1,10016,10904,888
8097,CO,Pitkin,,2012,7.3,10085,10877,792
8097,CO,Pitkin,,2013,6.4,10092,10779,687
8097,CO,Pitkin,,2014,4.8,10486,11020,534
8097,CO,Pitkin,,2015,3.7,10337,10737,400
8097,CO,Pitkin,,2016,3.2,10390,10736,346
8097,CO,Pitkin,,2017,2.9,10578,10889,311
8097,CO,Pitkin,,2018,3.5,10727,11117,390
8097,CO,Pitkin,,2019,3,10704,11032,328
8097,CO,Pitkin,,2020,9.9,10017,11122,1105
8097,CO,Pitkin,,2021,5.5,10514,11127,613
8099,CO,Prowers,,2007,3.4,6615,6849,234
8099,CO,Prowers,,2008,4.5,6276,6572,296
8099,CO,Prowers,,2009,6.3,6577,7019,442
8099,CO,Prowers,,2010,7.4,5691,6143,452
8099,CO,Prowers,,2011,6.9,5797,6228,431
8099,CO,Prowers,,2012,7.1,5649,6081,432
8099,CO,Prowers,,2013,6.2,5493,5856,363
8099,CO,Prowers,,2014,4.7,5457,5724,267
8099,CO,Prowers,,2015,3.9,5586,5812,226
8099,CO,Prowers,,2016,3.1,5820,6006,186
8099,CO,Prowers,,2017,2.4,5994,6143,149
8099,CO,Prowers,,2018,3.1,6034,6225,191
8099,CO,Prowers,,2019,2.5,6128,6282,154
8099,CO,Prowers,,2020,4.2,5856,6114,258
8099,CO,Prowers,,2021,4.5,5981,6265,284
8101,CO,Pueblo,,2007,4.7,69048,72422,3374
8101,CO,Pueblo,,2008,6.1,69262,73763,4501
8101,CO,Pueblo,,2009,8.8,68290,74910,6620
8101,CO,Pueblo,,2010,10.9,66147,74239,8092
8101,CO,Pueblo,,2011,10.9,66842,75046,8204
8101,CO,Pueblo,,2012,10.8,66256,74301,8045
8101,CO,Pueblo,,2013,9.7,66166,73270,7104
8101,CO,Pueblo,,2014,7.3,67010,72273,5263
8101,CO,Pueblo,,2015,5.4,67755,71657,3902
8101,CO,Pueblo,,2016,4.6,69714,73058,3344
8101,CO,Pueblo,,2017,4,71082,74024,2942
8101,CO,Pueblo,,2018,4.5,71382,74736,3354
8101,CO,Pueblo,,2019,3.9,72263,75161,2898
8101,CO,Pueblo,,2020,7.8,70230,76155,5925
8101,CO,Pueblo,,2021,7.9,71347,77498,6151
8103,CO,Rio Blanco,,2007,2,5281,5391,110
8103,CO,Rio Blanco,,2008,2.6,5013,5148,135
8103,CO,Rio Blanco,,2009,5.3,4416,4662,246
8103,CO,Rio Blanco,,2010,9.4,2844,3139,295
8103,CO,Rio Blanco,,2011,8.2,2858,3114,256
8103,CO,Rio Blanco,,2012,8.5,2822,3084,262
8103,CO,Rio Blanco,,2013,7.7,2833,3071,238
8103,CO,Rio Blanco,,2014,5.9,2765,2939,174
8103,CO,Rio Blanco,,2015,5.1,2663,2805,142
8103,CO,Rio Blanco,,2016,4.8,2603,2735,132
8103,CO,Rio Blanco,,2017,3.6,2658,2756,98
8103,CO,Rio Blanco,,2018,3.9,2795,2907,112
8103,CO,Rio Blanco,,2019,3.5,2861,2964,103
8103,CO,Rio Blanco,,2020,5.2,2754,2905,151
8103,CO,Rio Blanco,,2021,5.5,2769,2931,162
8105,CO,Rio Grande,,2007,3.9,6340,6599,259
8105,CO,Rio Grande,,2008,5.7,6098,6464,366
8105,CO,Rio Grande,,2009,6.6,6352,6799,447
8105,CO,Rio Grande,,2010,11.2,4618,5201,583
8105,CO,Rio Grande,,2011,12.8,4494,5153,659
8105,CO,Rio Grande,,2012,12.4,4463,5093,630
8105,CO,Rio Grande,,2013,11.4,4317,4873,556
8105,CO,Rio Grande,,2014,9.2,4376,4817,441
8105,CO,Rio Grande,,2015,6.1,4566,4861,295
8105,CO,Rio Grande,,2016,4.7,4909,5153,244
8105,CO,Rio Grande,,2017,4,5105,5318,213
8105,CO,Rio Grande,,2018,4.5,5122,5364,242
8105,CO,Rio Grande,,2019,3.9,5190,5400,210
8105,CO,Rio Grande,,2020,6.8,4993,5360,367
8105,CO,Rio Grande,,2021,6.5,5169,5529,360
8107,CO,Routt,,2007,2.6,15423,15831,408
8107,CO,Routt,,2008,3.4,15157,15692,535
8107,CO,Routt,,2009,7,14197,15272,1075
8107,CO,Routt,,2010,9.7,13089,14497,1408
8107,CO,Routt,,2011,8.5,13039,14255,1216
8107,CO,Routt,,2012,7.3,13285,14329,1044
8107,CO,Routt,,2013,5.8,13642,14488,846
8107,CO,Routt,,2014,4.1,13782,14378,596
8107,CO,Routt,,2015,3.1,13835,14282,447
8107,CO,Routt,,2016,2.5,14539,14912,373
8107,CO,Routt,,2017,2.2,15080,15421,341
8107,CO,Routt,,2018,2.5,15678,16078,400
8107,CO,Routt,,2019,2.1,15843,16175,332
8107,CO,Routt,,2020,7.5,14729,15923,1194
8107,CO,Routt,,2021,4.2,15343,16024,681
8109,CO,Saguache,,2007,5.2,3020,3185,165
8109,CO,Saguache,,2008,7.2,2839,3060,221
8109,CO,Saguache,,2009,8.7,3136,3433,297
8109,CO,Saguache,,2010,10.6,2734,3059,325
8109,CO,Saguache,,2011,11.6,2664,3012,348
8109,CO,Saguache,,2012,11.2,2705,3047,342
8109,CO,Saguache,,2013,11.1,2622,2949,327
8109,CO,Saguache,,2014,8.7,2742,3003,261
8109,CO,Saguache,,2015,5.9,2893,3075,182
8109,CO,Saguache,,2016,4.7,3075,3226,151
8109,CO,Saguache,,2017,4.1,3264,3404,140
8109,CO,Saguache,,2018,4.3,3345,3497,152
8109,CO,Saguache,,2019,3.8,3379,3513,134
8109,CO,Saguache,,2020,6.7,3176,3405,229
8109,CO,Saguache,,2021,5.9,3290,3496,206
8111,CO,San Juan,,2007,4,545,568,23
8111,CO,San Juan,,2008,5.6,539,571,32
8111,CO,San Juan,,2009,7.9,513,557,44
8111,CO,San Juan,,2010,13.1,439,505,66
8111,CO,San Juan,,2011,12.1,458,521,63
8111,CO,San Juan,,2012,10.1,480,534,54
8111,CO,San Juan,,2013,8.6,436,477,41
8111,CO,San Juan,,2014,5.3,450,475,25
8111,CO,San Juan,,2015,4,451,470,19
8111,CO,San Juan,,2016,3.5,462,479,17
8111,CO,San Juan,,2017,2.1,512,523,11
8111,CO,San Juan,,2018,2.9,504,519,15
8111,CO,San Juan,,2019,2.7,536,551,15
8111,CO,San Juan,,2020,6.4,486,519,33
8111,CO,San Juan,,2021,3.5,587,608,21
8113,CO,San Miguel,,2007,3.1,5526,5701,175
8113,CO,San Miguel,,2008,3.9,5339,5556,217
8113,CO,San Miguel,,2009,6.4,4894,5230,336
8113,CO,San Miguel,,2010,8.2,4473,4874,401
8113,CO,San Miguel,,2011,8.3,4467,4873,406
8113,CO,San Miguel,,2012,8,4457,4844,387
8113,CO,San Miguel,,2013,6.6,4462,4776,314
8113,CO,San Miguel,,2014,4.7,4687,4919,232
8113,CO,San Miguel,,2015,3.6,4888,5073,185
8113,CO,San Miguel,,2016,3.1,5024,5185,161
8113,CO,San Miguel,,2017,2.6,5158,5298,140
8113,CO,San Miguel,,2018,3.2,5331,5506,175
8113,CO,San Miguel,,2019,2.7,5559,5711,152
8113,CO,San Miguel,,2020,10.3,4865,5425,560
8113,CO,San Miguel,,2021,5,5542,5836,294
8115,CO,Sedgwick,,2007,2.2,1802,1842,40
8115,CO,Sedgwick,,2008,3.2,1493,1542,49
8115,CO,Sedgwick,,2009,4.1,1649,1719,70
8115,CO,Sedgwick,,2010,7.8,1011,1097,86
8115,CO,Sedgwick,,2011,8.3,1003,1094,91
8115,CO,Sedgwick,,2012,7.1,1037,1116,79
8115,CO,Sedgwick,,2013,6.1,1023,1090,67
8115,CO,Sedgwick,,2014,4.6,1036,1086,50
8115,CO,Sedgwick,,2015,3.2,1109,1146,37
8115,CO,Sedgwick,,2016,2.2,1152,1178,26
8115,CO,Sedgwick,,2017,2,1157,1181,24
8115,CO,Sedgwick,,2018,2.4,1149,1177,28
8115,CO,Sedgwick,,2019,1.9,1164,1186,22
8115,CO,Sedgwick,,2020,3.4,1115,1154,39
8115,CO,Sedgwick,,2021,3.7,1141,1185,44
8117,CO,Summit,,2007,2.7,16813,17279,466
8117,CO,Summit,,2008,3.8,16466,17110,644
8117,CO,Summit,,2009,6.6,15578,16673,1095
8117,CO,Summit,,2010,7.1,17698,19050,1352
8117,CO,Summit,,2011,6.8,17904,19205,1301
8117,CO,Summit,,2012,6.1,18085,19265,1180
8117,CO,Summit,,2013,4.9,18394,19349,955
8117,CO,Summit,,2014,3.4,19398,20071,673
8117,CO,Summit,,2015,2.4,20070,20570,500
8117,CO,Summit,,2016,2,20722,21140,418
8117,CO,Summit,,2017,1.7,21287,21663,376
8117,CO,Summit,,2018,2,21841,22291,450
8117,CO,Summit,,2019,1.7,22383,22770,387
8117,CO,Summit,,2020,9.3,19912,21962,2050
8117,CO,Summit,,2021,4,21818,22727,909
8119,CO,Teller,,2007,3.8,12043,12522,479
8119,CO,Teller,,2008,5.5,11678,12360,682
8119,CO,Teller,,2009,8.2,11147,12137,990
8119,CO,Teller,,2010,9.8,11110,12312,1202
8119,CO,Teller,,2011,9.6,10964,12129,1165
8119,CO,Teller,,2012,8.5,10869,11879,1010
8119,CO,Teller,,2013,7.7,10806,11706,900
8119,CO,Teller,,2014,5.8,10902,11577,675
8119,CO,Teller,,2015,4.3,10912,11402,490
8119,CO,Teller,,2016,3.5,11315,11731,416
8119,CO,Teller,,2017,3,11774,12135,361
8119,CO,Teller,,2018,3.4,11992,12414,422
8119,CO,Teller,,2019,2.9,12315,12684,369
8119,CO,Teller,,2020,7.1,11924,12836,912
8119,CO,Teller,,2021,4.9,12429,13074,645
8121,CO,Washington,,2007,2.7,2828,2905,77
8121,CO,Washington,,2008,3.3,2586,2673,87
8121,CO,Washington,,2009,4.3,2854,2983,129
8121,CO,Washington,,2010,6.2,2418,2579,161
8121,CO,Washington,,2011,5.7,2434,2580,146
8121,CO,Washington,,2012,4.9,2497,2627,130
8121,CO,Washington,,2013,4.5,2434,2549,115
8121,CO,Washington,,2014,3.1,2562,2645,83
8121,CO,Washington,,2015,2.5,2717,2786,69
8121,CO,Washington,,2016,2.1,2861,2921,60
8121,CO,Washington,,2017,1.8,2948,3002,54
8121,CO,Washington,,2018,2.3,2957,3027,70
8121,CO,Washington,,2019,1.9,2898,2953,55
8121,CO,Washington,,2020,3,2759,2844,85
8121,CO,Washington,,2021,3.2,2738,2828,90
8123,CO,Weld,,2007,4,113283,118051,4768
8123,CO,Weld,,2008,5.2,113448,119726,6278
8123,CO,Weld,,2009,8.8,110676,121392,10716
8123,CO,Weld,,2010,9.6,118861,131495,12634
8123,CO,Weld,,2011,8.9,122063,133960,11897
8123,CO,Weld,,2012,7.9,125752,136480,10728
8123,CO,Weld,,2013,6.5,130021,138995,8974
8123,CO,Weld,,2014,4.4,138877,145343,6466
8123,CO,Weld,,2015,3.7,142298,147778,5480
8123,CO,Weld,,2016,3.3,145047,149941,4894
8123,CO,Weld,,2017,2.5,152480,156367,3887
8123,CO,Weld,,2018,2.8,158866,163409,4543
8123,CO,Weld,,2019,2.4,163792,167882,4090
8123,CO,Weld,,2020,6.6,153943,164840,10897
8123,CO,Weld,,2021,5.7,156182,165660,9478
8125,CO,Yuma,,2007,2.1,6650,6793,143
8125,CO,Yuma,,2008,2.7,6371,6547,176
8125,CO,Yuma,,2009,3.6,6852,7107,255
8125,CO,Yuma,,2010,5.9,4614,4905,291
8125,CO,Yuma,,2011,5.5,4675,4946,271
8125,CO,Yuma,,2012,5.2,4614,4868,254
8125,CO,Yuma,,2013,4.7,4515,4737,222
8125,CO,Yuma,,2014,3.3,4792,4956,164
8125,CO,Yuma,,2015,2.5,5004,5133,129
8125,CO,Yuma,,2016,2,5330,5441,111
8125,CO,Yuma,,2017,1.5,5546,5630,84
8125,CO,Yuma,,2018,1.8,5842,5952,110
8125,CO,Yuma,,2019,1.5,5974,6065,91
8125,CO,Yuma,,2020,2.7,5404,5552,148
8125,CO,Yuma,,2021,2.7,5513,5668,155
9000,CT,Connecticut,,2007,4.5,1773047,1856008,82961
9000,CT,Connecticut,,2008,5.6,1772393,1878120,105727
9000,CT,Connecticut,,2009,8.3,1731361,1888374,157013
9000,CT,Connecticut,,2010,9.6,1728121,1911289,183168
9000,CT,Connecticut,,2011,9,1741971,1914449,172478
9000,CT,Connecticut,,2012,8.4,1729687,1887545,157858
9000,CT,Connecticut,,2013,8,1718834,1867378,148544
9000,CT,Connecticut,,2014,6.6,1764118,1889102,124984
9000,CT,Connecticut,,2015,5.6,1785788,1892087,106299
9000,CT,Connecticut,,2016,4.8,1801390,1893200,91810
9000,CT,Connecticut,,2017,4.4,1838833,1923711,84878
9000,CT,Connecticut,,2018,3.9,1855969,1931495,75526
9000,CT,Connecticut,,2019,3.5,1881688,1950349,68661
9000,CT,Connecticut,,2020,7.8,1749954,1897782,147828
9000,CT,Connecticut,,2021,6.3,1739815,1855923,116108
9001,CT,Fairfield,,2007,3.9,448160,466477,18317
9001,CT,Fairfield,,2008,5.1,446436,470482,24046
9001,CT,Fairfield,,2009,7.8,434256,471164,36908
9001,CT,Fairfield,,2010,8.8,431251,473108,41857
9001,CT,Fairfield,,2011,8.4,436824,476825,40001
9001,CT,Fairfield,,2012,7.8,435691,472539,36848
9001,CT,Fairfield,,2013,7.4,433968,468678,34710
9001,CT,Fairfield,,2014,6.2,446866,476338,29472
9001,CT,Fairfield,,2015,5.3,453727,478990,25263
9001,CT,Fairfield,,2016,4.6,458116,480229,22113
9001,CT,Fairfield,,2017,4.3,464383,485084,20701
9001,CT,Fairfield,,2018,3.8,467592,485919,18327
9001,CT,Fairfield,,2019,3.4,472261,489083,16822
9001,CT,Fairfield,,2020,7.8,436155,473208,37053
9001,CT,Fairfield,,2021,6.1,437051,465448,28397
9003,CT,Hartford,,2007,4.9,430719,452702,21983
9003,CT,Hartford,,2008,6,432011,459529,27518
9003,CT,Hartford,,2009,8.7,423624,464189,40565
9003,CT,Hartford,,2010,9.9,431989,479530,47541
9003,CT,Hartford,,2011,9.2,435305,479656,44351
9003,CT,Hartford,,2012,8.5,432127,472526,40399
9003,CT,Hartford,,2013,8.1,429826,467838,38012
9003,CT,Hartford,,2014,6.8,441855,473887,32032
9003,CT,Hartford,,2015,5.8,447489,474825,27336
9003,CT,Hartford,,2016,5,450542,474494,23952
9003,CT,Hartford,,2017,4.6,461941,483999,22058
9003,CT,Hartford,,2018,4,466922,486605,19683
9003,CT,Hartford,,2019,3.7,475091,493135,18044
9003,CT,Hartford,,2020,8,443952,482601,38649
9003,CT,Hartford,,2021,6.5,438180,468861,30681
9005,CT,Litchfield,,2007,4.2,100126,104527,4401
9005,CT,Litchfield,,2008,5.3,99943,105491,5548
9005,CT,Litchfield,,2009,8.3,96847,105572,8725
9005,CT,Litchfield,,2010,9.2,98339,108289,9950
9005,CT,Litchfield,,2011,8.3,98938,107912,8974
9005,CT,Litchfield,,2012,7.6,97982,106066,8084
9005,CT,Litchfield,,2013,7.3,97045,104633,7588
9005,CT,Litchfield,,2014,6,99183,105542,6359
9005,CT,Litchfield,,2015,5.1,99925,105271,5346
9005,CT,Litchfield,,2016,4.5,100083,104750,4667
9005,CT,Litchfield,,2017,4.1,101111,105418,4307
9005,CT,Litchfield,,2018,3.6,102370,106245,3875
9005,CT,Litchfield,,2019,3.3,103418,106930,3512
9005,CT,Litchfield,,2020,6.7,96504,103484,6980
9005,CT,Litchfield,,2021,5.5,95963,101537,5574
9007,CT,Middlesex,,2007,3.9,89392,93003,3611
9007,CT,Middlesex,,2008,4.8,89871,94388,4517
9007,CT,Middlesex,,2009,7,88320,94949,6629
9007,CT,Middlesex,,2010,8.3,85502,93234,7732
9007,CT,Middlesex,,2011,7.8,86316,93617,7301
9007,CT,Middlesex,,2012,7.2,85447,92041,6594
9007,CT,Middlesex,,2013,6.8,84956,91177,6221
9007,CT,Middlesex,,2014,5.7,87058,92331,5273
9007,CT,Middlesex,,2015,4.8,87905,92377,4472
9007,CT,Middlesex,,2016,4.2,88623,92489,3866
9007,CT,Middlesex,,2017,3.8,90439,94022,3583
9007,CT,Middlesex,,2018,3.3,91324,94486,3162
9007,CT,Middlesex,,2019,3,92857,95740,2883
9007,CT,Middlesex,,2020,6.4,87216,93209,5993
9007,CT,Middlesex,,2021,5.2,86362,91071,4709
9009,CT,New Haven,,2007,4.9,422220,444169,21949
9009,CT,New Haven,,2008,6.2,420791,448557,27766
9009,CT,New Haven,,2009,9,409934,450352,40418
9009,CT,New Haven,,2010,10.5,413886,462399,48513
9009,CT,New Haven,,2011,9.9,416898,462620,45722
9009,CT,New Haven,,2012,9.1,415358,456958,41600
9009,CT,New Haven,,2013,8.7,412914,452119,39205
9009,CT,New Haven,,2014,7.2,423672,456659,32987
9009,CT,New Haven,,2015,6.1,428605,456475,27870
9009,CT,New Haven,,2016,5.2,433288,457003,23715
9009,CT,New Haven,,2017,4.7,442959,464965,22006
9009,CT,New Haven,,2018,4.2,447589,467068,19479
9009,CT,New Haven,,2019,3.7,454140,471549,17409
9009,CT,New Haven,,2020,7.9,426061,462508,36447
9009,CT,New Haven,,2021,6.6,424057,453791,29734
9011,CT,New London,,2007,4.2,141390,147542,6152
9011,CT,New London,,2008,5.4,141882,149933,8051
9011,CT,New London,,2009,7.8,138935,150711,11776
9011,CT,New London,,2010,9.4,130327,143832,13505
9011,CT,New London,,2011,9.1,130113,143083,12970
9011,CT,New London,,2012,8.7,127497,139608,12111
9011,CT,New London,,2013,8.3,125765,137127,11362
9011,CT,New London,,2014,6.8,127534,136834,9300
9011,CT,New London,,2015,5.8,128427,136381,7954
9011,CT,New London,,2016,4.8,129595,136181,6586
9011,CT,New London,,2017,4.2,133507,139407,5900
9011,CT,New London,,2018,3.8,133887,139122,5235
9011,CT,New London,,2019,3.4,135051,139818,4767
9011,CT,New London,,2020,9.5,121093,133743,12650
9011,CT,New London,,2021,6.9,120631,129504,8873
9013,CT,Tolland,,2007,3.8,80737,83960,3223
9013,CT,Tolland,,2008,4.8,81087,85152,4065
9013,CT,Tolland,,2009,7,80367,86378,6011
9013,CT,Tolland,,2010,8.2,79251,86340,7089
9013,CT,Tolland,,2011,7.7,79650,86299,6649
9013,CT,Tolland,,2012,7.4,78466,84693,6227
9013,CT,Tolland,,2013,7,77709,83554,5845
9013,CT,Tolland,,2014,5.8,79875,84809,4934
9013,CT,Tolland,,2015,4.9,81079,85228,4149
9013,CT,Tolland,,2016,4.2,81803,85416,3613
9013,CT,Tolland,,2017,3.8,83777,87052,3275
9013,CT,Tolland,,2018,3.4,84661,87655,2994
9013,CT,Tolland,,2019,3.1,86113,88848,2735
9013,CT,Tolland,,2020,6.1,80682,85905,5223
9013,CT,Tolland,,2021,5.1,79597,83876,4279
9015,CT,Windham,,2007,5.2,60299,63618,3319
9015,CT,Windham,,2008,6.5,60371,64587,4216
9015,CT,Windham,,2009,9.2,59083,65070,5987
9015,CT,Windham,,2010,10.8,57576,64559,6983
9015,CT,Windham,,2011,10.1,57926,64436,6510
9015,CT,Windham,,2012,9.5,57120,63116,5996
9015,CT,Windham,,2013,9,56651,62250,5599
9015,CT,Windham,,2014,7.4,58074,62700,4626
9015,CT,Windham,,2015,6.3,58629,62538,3909
9015,CT,Windham,,2016,5.3,59342,62639,3297
9015,CT,Windham,,2017,4.8,60717,63765,3048
9015,CT,Windham,,2018,4.3,61624,64397,2773
9015,CT,Windham,,2019,3.8,62758,65247,2489
9015,CT,Windham,,2020,7.7,58291,63124,4833
9015,CT,Windham,,2021,6.2,57975,61835,3860
10000,DE,Delaware,,2007,3.6,429203,445306,16103
10000,DE,Delaware,,2008,5,427694,450265,22571
10000,DE,Delaware,,2009,8.4,401718,438383,36665
10000,DE,Delaware,,2010,8.7,398388,436196,37808
10000,DE,Delaware,,2011,7.6,410229,443971,33742
10000,DE,Delaware,,2012,7.1,414489,445962,31473
10000,DE,Delaware,,2013,6.6,414215,443551,29336
10000,DE,Delaware,,2014,5.6,427400,452712,25312
10000,DE,Delaware,,2015,4.8,440555,462752,22197
10000,DE,Delaware,,2016,4.5,447640,468808,21168
10000,DE,Delaware,,2017,4.5,453949,475214,21265
10000,DE,Delaware,,2018,3.8,462143,480154,18011
10000,DE,Delaware,,2019,3.7,466856,484845,17989
10000,DE,Delaware,,2020,7.6,449114,485813,36699
10000,DE,Delaware,,2021,5.3,469875,496430,26555
10001,DE,Kent,,2007,3.5,72668,75328,2660
10001,DE,Kent,,2008,5,72229,76008,3779
10001,DE,Kent,,2009,8.2,67857,73933,6076
10001,DE,Kent,,2010,9.2,66336,73026,6690
10001,DE,Kent,,2011,8.3,68023,74196,6173
10001,DE,Kent,,2012,7.8,68567,74346,5779
10001,DE,Kent,,2013,7.3,68587,73955,5368
10001,DE,Kent,,2014,6.3,70391,75102,4711
10001,DE,Kent,,2015,5.3,71772,75799,4027
10001,DE,Kent,,2016,4.9,72935,76699,3764
10001,DE,Kent,,2017,4.9,73509,77277,3768
10001,DE,Kent,,2018,4.1,74578,77802,3224
10001,DE,Kent,,2019,4.1,75360,78609,3249
10001,DE,Kent,,2020,8.3,73170,79826,6656
10001,DE,Kent,,2021,6.2,76320,81389,5069
10003,DE,New Castle,,2007,3.7,266780,276948,10168
10003,DE,New Castle,,2008,5,265800,279751,13951
10003,DE,New Castle,,2009,8.4,248960,271845,22885
10003,DE,New Castle,,2010,8.5,249470,272650,23180
10003,DE,New Castle,,2011,7.3,257356,277758,20402
10003,DE,New Castle,,2012,6.9,259505,278591,19086
10003,DE,New Castle,,2013,6.4,259476,277211,17735
10003,DE,New Castle,,2014,5.4,267664,282923,15259
10003,DE,New Castle,,2015,4.6,276051,289489,13438
10003,DE,New Castle,,2016,4.4,278853,291757,12904
10003,DE,New Castle,,2017,4.4,281937,294849,12912
10003,DE,New Castle,,2018,3.7,285953,296795,10842
10003,DE,New Castle,,2019,3.6,287970,298726,10756
10003,DE,New Castle,,2020,7.5,276479,298781,22302
10003,DE,New Castle,,2021,5.3,287298,303427,16129
10005,DE,Sussex,,2007,3.5,89754,93029,3275
10005,DE,Sussex,,2008,5.1,89664,94505,4841
10005,DE,Sussex,,2009,8.3,84901,92605,7704
10005,DE,Sussex,,2010,8.8,82581,90518,7937
10005,DE,Sussex,,2011,7.8,84850,92017,7167
10005,DE,Sussex,,2012,7.1,86418,93026,6608
10005,DE,Sussex,,2013,6.7,86152,92384,6232
10005,DE,Sussex,,2014,5.6,89345,94687,5342
10005,DE,Sussex,,2015,4.9,92732,97463,4731
10005,DE,Sussex,,2016,4.5,95852,100352,4500
10005,DE,Sussex,,2017,4.4,98503,103087,4584
10005,DE,Sussex,,2018,3.7,101613,105558,3945
10005,DE,Sussex,,2019,3.7,103526,107511,3985
10005,DE,Sussex,,2020,7.2,99465,107206,7741
10005,DE,Sussex,,2021,4.8,106257,111615,5358
11000,DC,District of Columbia,,2007,6,307071,326557,19486
11000,DC,District of Columbia,,2008,6.8,311588,334487,22899
11000,DC,District of Columbia,,2009,10,304277,338113,33836
11000,DC,District of Columbia,,2010,10,312132,346707,34575
11000,DC,District of Columbia,,2011,10.2,316372,352193,35821
11000,DC,District of Columbia,,2012,9,332412,365176,32764
11000,DC,District of Columbia,,2013,8.4,342609,374199,31590
11000,DC,District of Columbia,,2014,7.7,350415,379678,29263
11000,DC,District of Columbia,,2015,6.9,361556,388446,26890
11000,DC,District of Columbia,,2016,6.2,370553,395124,24571
11000,DC,District of Columbia,,2017,6.1,369388,393326,23938
11000,DC,District of Columbia,,2018,5.6,373772,396039,22267
11000,DC,District of Columbia,,2019,5.4,379016,400577,21561
11000,DC,District of Columbia,,2020,8,358370,389384,31014
11000,DC,District of Columbia,,2021,6.6,356578,381673,25095
11001,DC,District of Columbia,,2007,6,307071,326557,19486
11001,DC,District of Columbia,,2008,6.8,311588,334487,22899
11001,DC,District of Columbia,,2009,10,304277,338113,33836
11001,DC,District of Columbia,,2010,10,312132,346707,34575
11001,DC,District of Columbia,,2011,10.2,316372,352193,35821
11001,DC,District of Columbia,,2012,9,332412,365176,32764
11001,DC,District of Columbia,,2013,8.4,342609,374199,31590
11001,DC,District of Columbia,,2014,7.7,350415,379678,29263
11001,DC,District of Columbia,,2015,6.9,361556,388446,26890
11001,DC,District of Columbia,,2016,6.2,370553,395124,24571
11001,DC,District of Columbia,,2017,6.1,369388,393326,23938
11001,DC,District of Columbia,,2018,5.6,373772,396039,22267
11001,DC,District of Columbia,,2019,5.4,379016,400577,21561
11001,DC,District of Columbia,,2020,8,358370,389384,31014
11001,DC,District of Columbia,,2021,6.6,356578,381673,25095
12000,FL,Florida,,2007,3.3,8813449,9113604,300155
12000,FL,Florida,,2008,5.7,8636212,9156458,520246
12000,FL,Florida,,2009,9.6,8127251,8987789,860538
12000,FL,Florida,,2010,10.8,8155401,9147107,991706
12000,FL,Florida,,2011,10,8334119,9260348,926229
12000,FL,Florida,,2012,8.6,8529063,9335727,806664
12000,FL,Florida,,2013,7.5,8706060,9414664,708604
12000,FL,Florida,,2014,6.4,8931440,9546407,614967
12000,FL,Florida,,2015,5.5,9106772,9639737,532965
12000,FL,Florida,,2016,4.9,9360237,9841301,481064
12000,FL,Florida,,2017,4.3,9544892,9972990,428098
12000,FL,Florida,,2018,3.7,9734029,10107191,373162
12000,FL,Florida,,2019,3.2,9928235,10259198,330963
12000,FL,Florida,,2020,8.2,9267151,10094878,827727
12000,FL,Florida,,2021,4.6,9843057,10312768,469711
12001,FL,Alachua,,2007,2.5,125393,128559,3166
12001,FL,Alachua,,2008,4,125407,130644,5237
12001,FL,Alachua,,2009,6.6,120235,128714,8479
12001,FL,Alachua,,2010,7.8,117504,127384,9880
12001,FL,Alachua,,2011,7.6,118574,128282,9708
12001,FL,Alachua,,2012,6.8,120238,129079,8841
12001,FL,Alachua,,2013,6,121314,129007,7693
12001,FL,Alachua,,2014,5.4,122367,129301,6934
12001,FL,Alachua,,2015,4.7,123941,129993,6052
12001,FL,Alachua,,2016,4.3,127302,133055,5753
12001,FL,Alachua,,2017,3.9,129134,134348,5214
12001,FL,Alachua,,2018,3.4,131666,136262,4596
12001,FL,Alachua,,2019,3,133643,137788,4145
12001,FL,Alachua,,2020,5.8,126648,134486,7838
12001,FL,Alachua,,2021,3.7,133316,138458,5142
12003,FL,Baker,,2007,3,11503,11856,353
12003,FL,Baker,,2008,5.3,11529,12171,642
12003,FL,Baker,,2009,9.4,10856,11979,1123
12003,FL,Baker,,2010,11,10197,11453,1256
12003,FL,Baker,,2011,10.2,10274,11441,1167
12003,FL,Baker,,2012,8.9,10277,11275,998
12003,FL,Baker,,2013,7.7,10377,11246,869
12003,FL,Baker,,2014,6.6,10454,11192,738
12003,FL,Baker,,2015,5.6,10584,11217,633
12003,FL,Baker,,2016,4.9,10892,11456,564
12003,FL,Baker,,2017,4.2,11070,11561,491
12003,FL,Baker,,2018,3.5,11144,11553,409
12003,FL,Baker,,2019,3.2,11533,11913,380
12003,FL,Baker,,2020,5.4,11020,11655,635
12003,FL,Baker,,2021,3.7,11640,12089,449
12005,FL,Bay,,2007,3,83727,86338,2611
12005,FL,Bay,,2008,5.1,83615,88132,4517
12005,FL,Bay,,2009,8.5,80463,87890,7427
12005,FL,Bay,,2010,10.2,76683,85366,8683
12005,FL,Bay,,2011,10.2,77872,86727,8855
12005,FL,Bay,,2012,8.9,78467,86154,7687
12005,FL,Bay,,2013,7.6,79650,86210,6560
12005,FL,Bay,,2014,6.5,81720,87426,5706
12005,FL,Bay,,2015,5.5,83026,87884,4858
12005,FL,Bay,,2016,4.8,83963,88209,4246
12005,FL,Bay,,2017,4.2,83855,87547,3692
12005,FL,Bay,,2018,4.2,83677,87320,3643
12005,FL,Bay,,2019,3.8,80572,83772,3200
12005,FL,Bay,,2020,6.4,77353,82680,5327
12005,FL,Bay,,2021,3.9,82604,85937,3333
12007,FL,Bradford,,2007,2.8,11945,12288,343
12007,FL,Bradford,,2008,4.5,11854,12410,556
12007,FL,Bradford,,2009,7.5,11434,12356,922
12007,FL,Bradford,,2010,9.5,10393,11490,1097
12007,FL,Bradford,,2011,9.1,10403,11439,1036
12007,FL,Bradford,,2012,7.8,10210,11074,864
12007,FL,Bradford,,2013,6.6,10232,10951,719
12007,FL,Bradford,,2014,5.8,10110,10733,623
12007,FL,Bradford,,2015,4.9,10260,10786,526
12007,FL,Bradford,,2016,4.3,10427,10896,469
12007,FL,Bradford,,2017,3.7,10750,11164,414
12007,FL,Bradford,,2018,3.5,10674,11059,385
12007,FL,Bradford,,2019,3.3,10494,10853,359
12007,FL,Bradford,,2020,6.5,10018,10713,695
12007,FL,Bradford,,2021,4.2,10343,10791,448
12009,FL,Brevard,,2007,3.6,254689,264160,9471
12009,FL,Brevard,,2008,6.1,250711,266986,16275
12009,FL,Brevard,,2009,9.6,238302,263752,25450
12009,FL,Brevard,,2010,10.9,234627,263342,28715
12009,FL,Brevard,,2011,10.9,235001,263679,28678
12009,FL,Brevard,,2012,9.7,235751,261046,25295
12009,FL,Brevard,,2013,8.7,235821,258158,22337
12009,FL,Brevard,,2014,7.2,239073,257569,18496
12009,FL,Brevard,,2015,6,241882,257457,15575
12009,FL,Brevard,,2016,5.2,249817,263418,13601
12009,FL,Brevard,,2017,4.4,255041,266773,11732
12009,FL,Brevard,,2018,3.6,264555,274551,9996
12009,FL,Brevard,,2019,3.3,272198,281422,9224
12009,FL,Brevard,,2020,7.2,261302,281504,20202
12009,FL,Brevard,,2021,4,277951,289653,11702
12011,FL,Broward,,2007,2.9,966723,995871,29148
12011,FL,Broward,,2008,5,950653,1000985,50332
12011,FL,Broward,,2009,8.5,888508,970562,82054
12011,FL,Broward,,2010,9.8,837443,928815,91372
12011,FL,Broward,,2011,9.4,856799,946171,89372
12011,FL,Broward,,2012,8.2,878506,957268,78762
12011,FL,Broward,,2013,7.1,903073,971733,68660
12011,FL,Broward,,2014,6.1,925482,985640,60158
12011,FL,Broward,,2015,5.2,940668,992033,51365
12011,FL,Broward,,2016,4.5,961500,1007259,45759
12011,FL,Broward,,2017,4,973134,1014014,40880
12011,FL,Broward,,2018,3.5,988673,1024312,35639
12011,FL,Broward,,2019,3.1,1000261,1032434,32173
12011,FL,Broward,,2020,9.6,923137,1021021,97884
12011,FL,Broward,,2021,4.9,979064,1029454,50390
12013,FL,Calhoun,,2007,3,5357,5523,166
12013,FL,Calhoun,,2008,5,5438,5724,286
12013,FL,Calhoun,,2009,7.9,5397,5859,462
12013,FL,Calhoun,,2010,9.8,4754,5269,515
12013,FL,Calhoun,,2011,10.4,4672,5212,540
12013,FL,Calhoun,,2012,9.4,4583,5060,477
12013,FL,Calhoun,,2013,8.2,4503,4906,403
12013,FL,Calhoun,,2014,7.1,4586,4939,353
12013,FL,Calhoun,,2015,6.2,4654,4960,306
12013,FL,Calhoun,,2016,5.8,4713,5003,290
12013,FL,Calhoun,,2017,4.9,4690,4934,244
12013,FL,Calhoun,,2018,4.4,4690,4905,215
12013,FL,Calhoun,,2019,4.1,4569,4762,193
12013,FL,Calhoun,,2020,5.6,4479,4744,265
12013,FL,Calhoun,,2021,4.5,4648,4866,218
12015,FL,Charlotte,,2007,4.2,66422,69354,2932
12015,FL,Charlotte,,2008,7.6,63722,68940,5218
12015,FL,Charlotte,,2009,11,60508,67995,7487
12015,FL,Charlotte,,2010,12.4,57567,65696,8129
12015,FL,Charlotte,,2011,11.3,57979,65342,7363
12015,FL,Charlotte,,2012,9.8,59064,65484,6420
12015,FL,Charlotte,,2013,8.4,60527,66055,5528
12015,FL,Charlotte,,2014,7.1,62075,66794,4719
12015,FL,Charlotte,,2015,6.1,63810,67928,4118
12015,FL,Charlotte,,2016,5.4,65781,69519,3738
12015,FL,Charlotte,,2017,4.8,66140,69485,3345
12015,FL,Charlotte,,2018,4.2,67332,70252,2920
12015,FL,Charlotte,,2019,3.8,68620,71321,2701
12015,FL,Charlotte,,2020,7.9,65764,71385,5621
12015,FL,Charlotte,,2021,4.4,70060,73248,3188
12017,FL,Citrus,,2007,4.2,52919,55226,2307
12017,FL,Citrus,,2008,7.6,51883,56134,4251
12017,FL,Citrus,,2009,11.2,49750,56040,6290
12017,FL,Citrus,,2010,13.3,45375,52351,6976
12017,FL,Citrus,,2011,12.5,45289,51756,6467
12017,FL,Citrus,,2012,11.1,45575,51257,5682
12017,FL,Citrus,,2013,10.1,44323,49302,4979
12017,FL,Citrus,,2014,8.8,43951,48186,4235
12017,FL,Citrus,,2015,7.6,44364,48006,3642
12017,FL,Citrus,,2016,6.8,44748,48006,3258
12017,FL,Citrus,,2017,6,44662,47498,2836
12017,FL,Citrus,,2018,5.4,44605,47150,2545
12017,FL,Citrus,,2019,5,44621,46955,2334
12017,FL,Citrus,,2020,9.1,42350,46588,4238
12017,FL,Citrus,,2021,5.7,44656,47343,2687
12019,FL,Clay,,2007,2.9,90686,93384,2698
12019,FL,Clay,,2008,5,90694,95447,4753
12019,FL,Clay,,2009,8.6,85748,93803,8055
12019,FL,Clay,,2010,9.6,85944,95069,9125
12019,FL,Clay,,2011,9.1,86914,95595,8681
12019,FL,Clay,,2012,7.9,88172,95686,7514
12019,FL,Clay,,2013,6.6,90255,96658,6403
12019,FL,Clay,,2014,5.9,91867,97643,5776
12019,FL,Clay,,2015,5.1,93804,98837,5033
12019,FL,Clay,,2016,4.5,96747,101345,4598
12019,FL,Clay,,2017,4,99254,103336,4082
12019,FL,Clay,,2018,3.4,101420,105002,3582
12019,FL,Clay,,2019,3.1,103260,106583,3323
12019,FL,Clay,,2020,5.8,98510,104580,6070
12019,FL,Clay,,2021,3.5,104015,107819,3804
12021,FL,Collier,,2007,3.6,145515,151003,5488
12021,FL,Collier,,2008,6.4,137802,147300,9498
12021,FL,Collier,,2009,10.3,127073,141675,14602
12021,FL,Collier,,2010,11.3,127810,144056,16246
12021,FL,Collier,,2011,10.1,132970,147941,14971
12021,FL,Collier,,2012,8.7,138572,151770,13198
12021,FL,Collier,,2013,7.4,143731,155187,11456
12021,FL,Collier,,2014,6.1,149982,159799,9817
12021,FL,Collier,,2015,5.3,155607,164330,8723
12021,FL,Collier,,2016,4.7,161752,169758,8006
12021,FL,Collier,,2017,4.2,164712,171952,7240
12021,FL,Collier,,2018,3.6,170050,176352,6302
12021,FL,Collier,,2019,3.2,173276,179009,5733
12021,FL,Collier,,2020,7.5,163139,176321,13182
12021,FL,Collier,,2021,3.7,174274,180891,6617
12023,FL,Columbia,,2007,3,29892,30810,918
12023,FL,Columbia,,2008,5.2,29759,31375,1616
12023,FL,Columbia,,2009,8.6,28592,31274,2682
12023,FL,Columbia,,2010,10.5,25546,28547,3001
12023,FL,Columbia,,2011,10.3,25194,28080,2886
12023,FL,Columbia,,2012,9.1,25329,27864,2535
12023,FL,Columbia,,2013,7.9,25607,27805,2198
12023,FL,Columbia,,2014,6.8,26384,28321,1937
12023,FL,Columbia,,2015,5.6,27474,29089,1615
12023,FL,Columbia,,2016,4.9,28387,29856,1469
12023,FL,Columbia,,2017,4.4,27806,29098,1292
12023,FL,Columbia,,2018,3.9,28056,29195,1139
12023,FL,Columbia,,2019,3.3,28578,29568,990
12023,FL,Columbia,,2020,6.4,27537,29435,1898
12023,FL,Columbia,,2021,4.5,27896,29220,1324
12027,FL,DeSoto,,2007,4,13651,14227,576
12027,FL,DeSoto,,2008,6.3,13757,14676,919
12027,FL,DeSoto,,2009,9.4,13420,14806,1386
12027,FL,DeSoto,,2010,11.9,11425,12965,1540
12027,FL,DeSoto,,2011,10.4,12378,13811,1433
12027,FL,DeSoto,,2012,10.3,11507,12823,1316
12027,FL,DeSoto,,2013,8.6,11984,13106,1122
12027,FL,DeSoto,,2014,7.4,12185,13152,967
12027,FL,DeSoto,,2015,5.9,12643,13431,788
12027,FL,DeSoto,,2016,5.3,12797,13516,719
12027,FL,DeSoto,,2017,4.5,13306,13938,632
12027,FL,DeSoto,,2018,4.1,13050,13604,554
12027,FL,DeSoto,,2019,3.6,13588,14099,511
12027,FL,DeSoto,,2020,5.6,13549,14350,801
12027,FL,DeSoto,,2021,3.8,14070,14631,561
12029,FL,Dixie,,2007,3.6,5303,5501,198
12029,FL,Dixie,,2008,6.9,5079,5453,374
12029,FL,Dixie,,2009,10.6,4930,5515,585
12029,FL,Dixie,,2010,12.5,4983,5694,711
12029,FL,Dixie,,2011,12.3,5018,5720,702
12029,FL,Dixie,,2012,10.5,5166,5774,608
12029,FL,Dixie,,2013,8.9,5316,5834,518
12029,FL,Dixie,,2014,7.6,5126,5549,423
12029,FL,Dixie,,2015,6.3,5256,5609,353
12029,FL,Dixie,,2016,5.5,5358,5669,311
12029,FL,Dixie,,2017,4.8,5428,5704,276
12029,FL,Dixie,,2018,4.3,5486,5734,248
12029,FL,Dixie,,2019,3.9,5579,5803,224
12029,FL,Dixie,,2020,6,5495,5845,350
12029,FL,Dixie,,2021,4.3,5653,5910,257
12031,FL,Duval,,2007,3.4,423659,438685,15026
12031,FL,Duval,,2008,5.8,418382,443919,25537
12031,FL,Duval,,2009,9.8,394060,436659,42599
12031,FL,Duval,,2010,11,401244,450860,49616
12031,FL,Duval,,2011,10.2,407240,453697,46457
12031,FL,Duval,,2012,9,412793,453464,40671
12031,FL,Duval,,2013,7.8,420747,456507,35760
12031,FL,Duval,,2014,6.9,427557,459322,31765
12031,FL,Duval,,2015,5.9,435287,462381,27094
12031,FL,Duval,,2016,5,445908,469165,23257
12031,FL,Duval,,2017,4.3,453958,474465,20507
12031,FL,Duval,,2018,3.7,461935,479833,17898
12031,FL,Duval,,2019,3.4,466986,483355,16369
12031,FL,Duval,,2020,7.4,444860,480408,35548
12031,FL,Duval,,2021,4.5,470506,492463,21957
12033,FL,Escambia,,2007,3.2,135527,140062,4535
12033,FL,Escambia,,2008,5.6,129477,137128,7651
12033,FL,Escambia,,2009,9.1,123155,135551,12396
12033,FL,Escambia,,2010,9.7,125154,138672,13518
12033,FL,Escambia,,2011,9.6,126413,139891,13478
12033,FL,Escambia,,2012,8.7,126754,138780,12026
12033,FL,Escambia,,2013,7.6,128161,138641,10480
12033,FL,Escambia,,2014,6.6,129917,139128,9211
12033,FL,Escambia,,2015,5.6,130843,138671,7828
12033,FL,Escambia,,2016,5,134347,141419,7072
12033,FL,Escambia,,2017,4.3,134980,140984,6004
12033,FL,Escambia,,2018,3.7,136726,141974,5248
12033,FL,Escambia,,2019,3.3,138852,143613,4761
12033,FL,Escambia,,2020,7.3,133112,143637,10525
12033,FL,Escambia,,2021,4.5,139420,146033,6613
12035,FL,Flagler,,2007,5.4,28954,30608,1654
12035,FL,Flagler,,2008,9,28765,31611,2846
12035,FL,Flagler,,2009,13.7,27830,32247,4417
12035,FL,Flagler,,2010,12,36034,40956,4922
12035,FL,Flagler,,2011,11.4,36957,41691,4734
12035,FL,Flagler,,2012,10.2,37643,41902,4259
12035,FL,Flagler,,2013,8.7,40101,43931,3830
12035,FL,Flagler,,2014,7.5,39906,43164,3258
12035,FL,Flagler,,2015,6.3,41064,43845,2781
12035,FL,Flagler,,2016,5.6,42967,45492,2525
12035,FL,Flagler,,2017,4.9,43561,45799,2238
12035,FL,Flagler,,2018,4.2,44337,46301,1964
12035,FL,Flagler,,2019,3.9,45471,47330,1859
12035,FL,Flagler,,2020,8.1,43263,47089,3826
12035,FL,Flagler,,2021,4.6,46067,48309,2242
12037,FL,Franklin,,2007,2.6,4774,4903,129
12037,FL,Franklin,,2008,4.4,4581,4792,211
12037,FL,Franklin,,2009,6.9,4541,4875,334
12037,FL,Franklin,,2010,7.7,4522,4899,377
12037,FL,Franklin,,2011,7.6,4639,5022,383
12037,FL,Franklin,,2012,6.7,4680,5015,335
12037,FL,Franklin,,2013,5.8,4688,4975,287
12037,FL,Franklin,,2014,5.8,4650,4936,286
12037,FL,Franklin,,2015,4.8,4563,4791,228
12037,FL,Franklin,,2016,4.4,4544,4752,208
12037,FL,Franklin,,2017,3.7,4492,4663,171
12037,FL,Franklin,,2018,3.6,4520,4689,169
12037,FL,Franklin,,2019,3.7,4455,4626,171
12037,FL,Franklin,,2020,5.8,4380,4651,271
12037,FL,Franklin,,2021,3.8,4540,4719,179
12039,FL,Gadsden,,2007,3.6,19899,20643,744
12039,FL,Gadsden,,2008,5.7,19781,20971,1190
12039,FL,Gadsden,,2009,9.2,19092,21030,1938
12039,FL,Gadsden,,2010,11.4,17629,19897,2268
12039,FL,Gadsden,,2011,11.6,17244,19500,2256
12039,FL,Gadsden,,2012,10.6,16794,18790,1996
12039,FL,Gadsden,,2013,9.5,17037,18835,1798
12039,FL,Gadsden,,2014,8.5,17202,18794,1592
12039,FL,Gadsden,,2015,7.3,16957,18285,1328
12039,FL,Gadsden,,2016,6.3,17114,18269,1155
12039,FL,Gadsden,,2017,5.6,17018,18023,1005
12039,FL,Gadsden,,2018,4.7,17380,18238,858
12039,FL,Gadsden,,2019,4.2,17626,18406,780
12039,FL,Gadsden,,2020,7.5,16840,18212,1372
12039,FL,Gadsden,,2021,5.4,18250,19283,1033
12041,FL,Gilchrist,,2007,3.2,7335,7574,239
12041,FL,Gilchrist,,2008,5.3,7372,7781,409
12041,FL,Gilchrist,,2009,8.6,6973,7633,660
12041,FL,Gilchrist,,2010,10.4,6102,6814,712
12041,FL,Gilchrist,,2011,10.3,6116,6817,701
12041,FL,Gilchrist,,2012,9.3,6051,6675,624
12041,FL,Gilchrist,,2013,8.2,6066,6608,542
12041,FL,Gilchrist,,2014,6.9,6094,6548,454
12041,FL,Gilchrist,,2015,5.7,6151,6524,373
12041,FL,Gilchrist,,2016,5,6360,6698,338
12041,FL,Gilchrist,,2017,4.5,6463,6768,305
12041,FL,Gilchrist,,2018,3.9,6704,6974,270
12041,FL,Gilchrist,,2019,3.5,6989,7240,251
12041,FL,Gilchrist,,2020,5.3,6661,7035,374
12041,FL,Gilchrist,,2021,3.7,6956,7226,270
12043,FL,Glades,,2007,3.9,4570,4757,187
12043,FL,Glades,,2008,6.4,4344,4641,297
12043,FL,Glades,,2009,8.6,4381,4793,412
12043,FL,Glades,,2010,9.2,4993,5498,505
12043,FL,Glades,,2011,9.5,4761,5261,500
12043,FL,Glades,,2012,7.9,5213,5663,450
12043,FL,Glades,,2013,7.8,5032,5455,423
12043,FL,Glades,,2014,7.9,4527,4915,388
12043,FL,Glades,,2015,7.2,4388,4729,341
12043,FL,Glades,,2016,6.3,4436,4734,298
12043,FL,Glades,,2017,5.4,4646,4913,267
12043,FL,Glades,,2018,4.1,4976,5187,211
12043,FL,Glades,,2019,4.1,5088,5303,215
12043,FL,Glades,,2020,6.2,4755,5070,315
12043,FL,Glades,,2021,4.2,4862,5073,211
12045,FL,Gulf,,2007,3.1,6041,6237,196
12045,FL,Gulf,,2008,5.8,5956,6326,370
12045,FL,Gulf,,2009,8.8,5737,6294,557
12045,FL,Gulf,,2010,10,5564,6180,616
12045,FL,Gulf,,2011,9.6,5606,6203,597
12045,FL,Gulf,,2012,8.3,5546,6050,504
12045,FL,Gulf,,2013,7,5712,6145,433
12045,FL,Gulf,,2014,6.2,5732,6114,382
12045,FL,Gulf,,2015,5.3,5699,6019,320
12045,FL,Gulf,,2016,4.7,5704,5985,281
12045,FL,Gulf,,2017,4,5729,5965,236
12045,FL,Gulf,,2018,4.6,5677,5951,274
12045,FL,Gulf,,2019,4.9,4905,5156,251
12045,FL,Gulf,,2020,6.3,4754,5074,320
12045,FL,Gulf,,2021,3.6,5080,5270,190
12047,FL,Hamilton,,2007,3.8,4422,4597,175
12047,FL,Hamilton,,2008,6.6,4441,4755,314
12047,FL,Hamilton,,2009,10.4,4294,4790,496
12047,FL,Hamilton,,2010,11.1,4238,4766,528
12047,FL,Hamilton,,2011,10.4,4364,4869,505
12047,FL,Hamilton,,2012,9.1,4673,5142,469
12047,FL,Hamilton,,2013,9,4211,4625,414
12047,FL,Hamilton,,2014,7.8,4241,4602,361
12047,FL,Hamilton,,2015,6.5,4243,4540,297
12047,FL,Hamilton,,2016,5.7,4406,4673,267
12047,FL,Hamilton,,2017,4.9,4069,4279,210
12047,FL,Hamilton,,2018,4.3,4151,4338,187
12047,FL,Hamilton,,2019,4.2,4089,4270,181
12047,FL,Hamilton,,2020,8.4,3856,4210,354
12047,FL,Hamilton,,2021,6,3887,4137,250
12049,FL,Hardee,,2007,3.8,11338,11782,444
12049,FL,Hardee,,2008,6.2,10951,11677,726
12049,FL,Hardee,,2009,9.8,10671,11831,1160
12049,FL,Hardee,,2010,11.2,10359,11664,1305
12049,FL,Hardee,,2011,10.1,10658,11851,1193
12049,FL,Hardee,,2012,9.2,10690,11769,1079
12049,FL,Hardee,,2013,8.6,10080,11028,948
12049,FL,Hardee,,2014,7.9,9516,10332,816
12049,FL,Hardee,,2015,7.1,9416,10131,715
12049,FL,Hardee,,2016,6.7,8664,9287,623
12049,FL,Hardee,,2017,6,8367,8898,531
12049,FL,Hardee,,2018,5.4,8272,8742,470
12049,FL,Hardee,,2019,5.2,7870,8302,432
12049,FL,Hardee,,2020,7,7871,8466,595
12049,FL,Hardee,,2021,4.8,8471,8895,424
12051,FL,Hendry,,2007,6.2,16692,17795,1103
12051,FL,Hendry,,2008,10.1,15618,17372,1754
12051,FL,Hendry,,2009,13.3,14702,16951,2249
12051,FL,Hendry,,2010,13.6,15707,18174,2467
12051,FL,Hendry,,2011,13.8,15394,17853,2459
12051,FL,Hendry,,2012,13.1,14690,16911,2221
12051,FL,Hendry,,2013,12.4,14574,16644,2070
12051,FL,Hendry,,2014,11.6,13984,15825,1841
12051,FL,Hendry,,2015,10.7,13535,15162,1627
12051,FL,Hendry,,2016,8.6,14133,15462,1329
12051,FL,Hendry,,2017,7.4,14712,15888,1176
12051,FL,Hendry,,2018,6.3,14533,15513,980
12051,FL,Hendry,,2019,6.1,14299,15229,930
12051,FL,Hendry,,2020,9,13907,15287,1380
12051,FL,Hendry,,2021,6.1,14782,15734,952
12053,FL,Hernando,,2007,4.8,58194,61131,2937
12053,FL,Hernando,,2008,8,57571,62591,5020
12053,FL,Hernando,,2009,12.3,53902,61470,7568
12053,FL,Hernando,,2010,13.1,57188,65828,8640
12053,FL,Hernando,,2011,12.5,57597,65807,8210
12053,FL,Hernando,,2012,10.9,58728,65910,7182
12053,FL,Hernando,,2013,9.4,60023,66220,6197
12053,FL,Hernando,,2014,8.2,60781,66188,5407
12053,FL,Hernando,,2015,7,61707,66373,4666
12053,FL,Hernando,,2016,6.1,63991,68152,4161
12053,FL,Hernando,,2017,5.3,65184,68859,3675
12053,FL,Hernando,,2018,4.7,66821,70110,3289
12053,FL,Hernando,,2019,4.3,68222,71297,3075
12053,FL,Hernando,,2020,8.6,65730,71952,6222
12053,FL,Hernando,,2021,5.1,69734,73476,3742
12055,FL,Highlands,,2007,4,38371,39968,1597
12055,FL,Highlands,,2008,6.7,37913,40633,2720
12055,FL,Highlands,,2009,10,36011,40018,4007
12055,FL,Highlands,,2010,12.1,32428,36899,4471
12055,FL,Highlands,,2011,11.5,33583,37930,4347
12055,FL,Highlands,,2012,10.6,33227,37162,3935
12055,FL,Highlands,,2013,9.9,32494,36075,3581
12055,FL,Highlands,,2014,8.7,32705,35813,3108
12055,FL,Highlands,,2015,7.6,32799,35485,2686
12055,FL,Highlands,,2016,6.6,33481,35846,2365
12055,FL,Highlands,,2017,5.7,34046,36123,2077
12055,FL,Highlands,,2018,5,34397,36211,1814
12055,FL,Highlands,,2019,4.7,33817,35493,1676
12055,FL,Highlands,,2020,8.4,31723,34624,2901
12055,FL,Highlands,,2021,5.9,32919,34977,2058
12057,FL,Hillsborough,,2007,3.4,571863,591899,20036
12057,FL,Hillsborough,,2008,5.9,559987,595242,35255
12057,FL,Hillsborough,,2009,9.8,532167,590111,57944
12057,FL,Hillsborough,,2010,10.4,573638,640114,66476
12057,FL,Hillsborough,,2011,9.6,594729,657569,62840
12057,FL,Hillsborough,,2012,8.1,609993,664074,54081
12057,FL,Hillsborough,,2013,6.9,625343,671504,46161
12057,FL,Hillsborough,,2014,6,641101,681695,40594
12057,FL,Hillsborough,,2015,5.1,656690,692032,35342
12057,FL,Hillsborough,,2016,4.5,677812,709538,31726
12057,FL,Hillsborough,,2017,4,690198,718852,28654
12057,FL,Hillsborough,,2018,3.5,705101,730756,25655
12057,FL,Hillsborough,,2019,3.2,726662,750562,23900
12057,FL,Hillsborough,,2020,7.7,695631,754031,58400
12057,FL,Hillsborough,,2021,4.3,736399,769097,32698
12059,FL,Holmes,,2007,2.9,8475,8729,254
12059,FL,Holmes,,2008,4.7,8530,8951,421
12059,FL,Holmes,,2009,7.4,8150,8800,650
12059,FL,Holmes,,2010,10,6414,7130,716
12059,FL,Holmes,,2011,9.8,6452,7156,704
12059,FL,Holmes,,2012,9.1,6473,7122,649
12059,FL,Holmes,,2013,8.2,6422,6996,574
12059,FL,Holmes,,2014,7.2,6361,6852,491
12059,FL,Holmes,,2015,6.2,6301,6718,417
12059,FL,Holmes,,2016,5.4,6367,6734,367
12059,FL,Holmes,,2017,4.8,6507,6837,330
12059,FL,Holmes,,2018,4.1,6554,6833,279
12059,FL,Holmes,,2019,3.6,6637,6887,250
12059,FL,Holmes,,2020,6,6407,6814,407
12059,FL,Holmes,,2021,4.1,6652,6935,283
12061,FL,Indian River,,2007,4.7,59292,62191,2899
12061,FL,Indian River,,2008,7.5,57741,62413,4672
12061,FL,Indian River,,2009,12,54107,61483,7376
12061,FL,Indian River,,2010,13.5,52594,60783,8189
12061,FL,Indian River,,2011,12.6,53791,61573,7782
12061,FL,Indian River,,2012,11.3,54700,61660,6960
12061,FL,Indian River,,2013,10,55238,61401,6163
12061,FL,Indian River,,2014,8.1,56676,61680,5004
12061,FL,Indian River,,2015,6.9,57212,61460,4248
12061,FL,Indian River,,2016,6.1,58604,62394,3790
12061,FL,Indian River,,2017,5.1,60211,63455,3244
12061,FL,Indian River,,2018,4.5,61580,64452,2872
12061,FL,Indian River,,2019,3.9,62496,65061,2565
12061,FL,Indian River,,2020,8,59027,64151,5124
12061,FL,Indian River,,2021,4.7,62043,65119,3076
12063,FL,Jackson,,2007,3.2,20727,21422,695
12063,FL,Jackson,,2008,4.8,20971,22034,1063
12063,FL,Jackson,,2009,6.9,20270,21763,1493
12063,FL,Jackson,,2010,8.8,17131,18782,1651
12063,FL,Jackson,,2011,9.4,16438,18151,1713
12063,FL,Jackson,,2012,8.9,16348,17949,1601
12063,FL,Jackson,,2013,7.9,16340,17735,1395
12063,FL,Jackson,,2014,6.9,16256,17458,1202
12063,FL,Jackson,,2015,5.9,16345,17379,1034
12063,FL,Jackson,,2016,5.3,16480,17396,916
12063,FL,Jackson,,2017,4.6,16382,17169,787
12063,FL,Jackson,,2018,4.1,16401,17108,707
12063,FL,Jackson,,2019,3.6,16349,16959,610
12063,FL,Jackson,,2020,5.9,16107,17124,1017
12063,FL,Jackson,,2021,4.6,16413,17202,789
12065,FL,Jefferson,,2007,2.8,6534,6720,186
12065,FL,Jefferson,,2008,4.7,6490,6807,317
12065,FL,Jefferson,,2009,7.5,6024,6515,491
12065,FL,Jefferson,,2010,9.6,5417,5992,575
12065,FL,Jefferson,,2011,10,5293,5884,591
12065,FL,Jefferson,,2012,9.5,4950,5472,522
12065,FL,Jefferson,,2013,8.1,5015,5456,441
12065,FL,Jefferson,,2014,6.8,5116,5489,373
12065,FL,Jefferson,,2015,6,5071,5395,324
12065,FL,Jefferson,,2016,5.3,5117,5404,287
12065,FL,Jefferson,,2017,4.4,5213,5455,242
12065,FL,Jefferson,,2018,3.9,5312,5528,216
12065,FL,Jefferson,,2019,3.4,5306,5494,188
12065,FL,Jefferson,,2020,6.1,5085,5413,328
12065,FL,Jefferson,,2021,4.2,5345,5580,235
12067,FL,Lafayette,,2007,2.4,2839,2910,71
12067,FL,Lafayette,,2008,4.2,2839,2964,125
12067,FL,Lafayette,,2009,6.9,2836,3046,210
12067,FL,Lafayette,,2010,7,3141,3379,238
12067,FL,Lafayette,,2011,6.2,3390,3615,225
12067,FL,Lafayette,,2012,5.9,3256,3460,204
12067,FL,Lafayette,,2013,5.4,3300,3489,189
12067,FL,Lafayette,,2014,5.3,3171,3348,177
12067,FL,Lafayette,,2015,4.6,3068,3217,149
12067,FL,Lafayette,,2016,4.4,2846,2977,131
12067,FL,Lafayette,,2017,3.8,2807,2918,111
12067,FL,Lafayette,,2018,3.5,2709,2808,99
12067,FL,Lafayette,,2019,3,2739,2824,85
12067,FL,Lafayette,,2020,4.7,2640,2769,129
12067,FL,Lafayette,,2021,4,2676,2787,111
12069,FL,Lake,,2007,3.4,127458,131984,4526
12069,FL,Lake,,2008,6,127800,135919,8119
12069,FL,Lake,,2009,10.3,120405,134272,13867
12069,FL,Lake,,2010,11.4,117680,132826,15146
12069,FL,Lake,,2011,10.6,118993,133044,14051
12069,FL,Lake,,2012,9.1,121063,133178,12115
12069,FL,Lake,,2013,7.7,124697,135123,10426
12069,FL,Lake,,2014,6.6,129049,138134,9085
12069,FL,Lake,,2015,5.6,133475,141343,7868
12069,FL,Lake,,2016,4.9,139389,146577,7188
12069,FL,Lake,,2017,4.3,143453,149859,6406
12069,FL,Lake,,2018,3.7,148689,154363,5674
12069,FL,Lake,,2019,3.3,155121,160397,5276
12069,FL,Lake,,2020,9.4,142000,156772,14772
12069,FL,Lake,,2021,4.7,152035,159493,7458
12071,FL,Lee,,2007,3.9,277702,288940,11238
12071,FL,Lee,,2008,7.6,262190,283660,21470
12071,FL,Lee,,2009,11.4,243832,275235,31403
12071,FL,Lee,,2010,12.1,246599,280605,34006
12071,FL,Lee,,2011,10.8,254435,285363,30928
12071,FL,Lee,,2012,9.1,264043,290468,26425
12071,FL,Lee,,2013,7.6,275689,298348,22659
12071,FL,Lee,,2014,6.2,290623,309859,19236
12071,FL,Lee,,2015,5.2,303892,320586,16694
12071,FL,Lee,,2016,4.7,314990,330398,15408
12071,FL,Lee,,2017,4.2,318774,332639,13865
12071,FL,Lee,,2018,3.6,326661,338687,12026
12071,FL,Lee,,2019,3.2,334789,346012,11223
12071,FL,Lee,,2020,7.9,317759,345113,27354
12071,FL,Lee,,2021,4.2,342117,357018,14901
12073,FL,Leon,,2007,2.6,140652,144350,3698
12073,FL,Leon,,2008,4.2,140351,146511,6160
12073,FL,Leon,,2009,6.5,136571,146115,9544
12073,FL,Leon,,2010,7.7,137411,148825,11414
12073,FL,Leon,,2011,7.8,137538,149095,11557
12073,FL,Leon,,2012,7.2,137606,148301,10695
12073,FL,Leon,,2013,6.4,138410,147808,9398
12073,FL,Leon,,2014,5.7,141074,149611,8537
12073,FL,Leon,,2015,5.1,140607,148125,7518
12073,FL,Leon,,2016,4.6,143808,150702,6894
12073,FL,Leon,,2017,4,144964,150963,5999
12073,FL,Leon,,2018,3.5,147395,152728,5333
12073,FL,Leon,,2019,3.2,148751,153627,4876
12073,FL,Leon,,2020,6.3,141137,150692,9555
12073,FL,Leon,,2021,4.2,147861,154331,6470
12075,FL,Levy,,2007,3.5,16109,16694,585
12075,FL,Levy,,2008,6.6,15664,16766,1102
12075,FL,Levy,,2009,10.6,14782,16539,1757
12075,FL,Levy,,2010,11.6,15189,17175,1986
12075,FL,Levy,,2011,10.9,15039,16872,1833
12075,FL,Levy,,2012,9.6,15035,16630,1595
12075,FL,Levy,,2013,8.5,14911,16299,1388
12075,FL,Levy,,2014,7,15129,16276,1147
12075,FL,Levy,,2015,5.8,15547,16510,963
12075,FL,Levy,,2016,5.2,15831,16702,871
12075,FL,Levy,,2017,4.5,15892,16648,756
12075,FL,Levy,,2018,4,16015,16684,669
12075,FL,Levy,,2019,3.8,15942,16578,636
12075,FL,Levy,,2020,6.6,15398,16479,1081
12075,FL,Levy,,2021,4.5,16095,16849,754
12077,FL,Liberty,,2007,2.3,3571,3655,84
12077,FL,Liberty,,2008,3.9,3682,3833,151
12077,FL,Liberty,,2009,5.3,3634,3839,205
12077,FL,Liberty,,2010,8.5,2663,2910,247
12077,FL,Liberty,,2011,9.1,2586,2846,260
12077,FL,Liberty,,2012,8.2,2505,2729,224
12077,FL,Liberty,,2013,7,2638,2838,200
12077,FL,Liberty,,2014,6.8,2560,2748,188
12077,FL,Liberty,,2015,5.9,2491,2648,157
12077,FL,Liberty,,2016,5.2,2509,2646,137
12077,FL,Liberty,,2017,4.6,2480,2600,120
12077,FL,Liberty,,2018,4,2489,2594,105
12077,FL,Liberty,,2019,3.6,2536,2630,94
12077,FL,Liberty,,2020,5.2,2457,2592,135
12077,FL,Liberty,,2021,4.2,2474,2582,108
12079,FL,Madison,,2007,5,6541,6887,346
12079,FL,Madison,,2008,6.5,6529,6982,453
12079,FL,Madison,,2009,9.9,6360,7059,699
12079,FL,Madison,,2010,9.7,7114,7878,764
12079,FL,Madison,,2011,9.6,7262,8029,767
12079,FL,Madison,,2012,8.8,7245,7947,702
12079,FL,Madison,,2013,8.1,7252,7893,641
12079,FL,Madison,,2014,7.3,7161,7727,566
12079,FL,Madison,,2015,6.2,7039,7504,465
12079,FL,Madison,,2016,5.3,6960,7350,390
12079,FL,Madison,,2017,4.5,6982,7313,331
12079,FL,Madison,,2018,4,6944,7236,292
12079,FL,Madison,,2019,3.9,7112,7399,287
12079,FL,Madison,,2020,6.7,7042,7546,504
12079,FL,Madison,,2021,4.9,7339,7720,381
12081,FL,Manatee,,2007,3.4,141707,146713,5006
12081,FL,Manatee,,2008,6.5,133917,143216,9299
12081,FL,Manatee,,2009,10.7,125543,140663,15120
12081,FL,Manatee,,2010,11.1,130121,146334,16213
12081,FL,Manatee,,2011,9.9,132628,147279,14651
12081,FL,Manatee,,2012,8.4,137215,149768,12553
12081,FL,Manatee,,2013,7,144059,154900,10841
12081,FL,Manatee,,2014,5.9,150831,160276,9445
12081,FL,Manatee,,2015,5.1,157051,165527,8476
12081,FL,Manatee,,2016,4.6,163281,171148,7867
12081,FL,Manatee,,2017,4.1,166400,173427,7027
12081,FL,Manatee,,2018,3.5,170437,176671,6234
12081,FL,Manatee,,2019,3.2,173414,179186,5772
12081,FL,Manatee,,2020,7.3,162804,175685,12881
12081,FL,Manatee,,2021,3.9,175379,182554,7175
12083,FL,Marion,,2007,3.8,131155,136346,5191
12083,FL,Marion,,2008,7.3,127207,137240,10033
12083,FL,Marion,,2009,11.9,117671,133492,15821
12083,FL,Marion,,2010,13.2,113748,131068,17320
12083,FL,Marion,,2011,12.3,114256,130254,15998
12083,FL,Marion,,2012,10.5,116046,129686,13640
12083,FL,Marion,,2013,8.9,119141,130783,11642
12083,FL,Marion,,2014,7.5,121579,131442,9863
12083,FL,Marion,,2015,6.6,122131,130698,8567
12083,FL,Marion,,2016,5.9,124689,132466,7777
12083,FL,Marion,,2017,5.1,125915,132717,6802
12083,FL,Marion,,2018,4.5,128740,134737,5997
12083,FL,Marion,,2019,3.9,132637,138048,5411
12083,FL,Marion,,2020,7.6,128343,138952,10609
12083,FL,Marion,,2021,4.9,135009,141992,6983
12085,FL,Martin,,2007,3.6,62200,64540,2340
12085,FL,Martin,,2008,6.5,59118,63211,4093
12085,FL,Martin,,2009,10.2,55865,62196,6331
12085,FL,Martin,,2010,10.4,59186,66056,6870
12085,FL,Martin,,2011,9.9,59867,66410,6543
12085,FL,Martin,,2012,8.6,60993,66705,5712
12085,FL,Martin,,2013,7.5,62256,67316,5060
12085,FL,Martin,,2014,6.2,64296,68572,4276
12085,FL,Martin,,2015,5.4,65987,69769,3782
12085,FL,Martin,,2016,4.9,67646,71125,3479
12085,FL,Martin,,2017,4.3,68459,71501,3042
12085,FL,Martin,,2018,3.7,69650,72297,2647
12085,FL,Martin,,2019,3.3,70373,72737,2364
12085,FL,Martin,,2020,6.6,66677,71353,4676
12085,FL,Martin,,2021,3.6,70878,73492,2614
12086,FL,Miami-Dade,,2007,2.7,1194185,1227055,32870
12086,FL,Miami-Dade,,2008,4.4,1169309,1222595,53286
12086,FL,Miami-Dade,,2009,9.1,1083040,1191175,108135
12086,FL,Miami-Dade,,2010,11.7,1085051,1229381,144330
12086,FL,Miami-Dade,,2011,9.6,1140476,1261955,121479
12086,FL,Miami-Dade,,2012,7.9,1185974,1287313,101339
12086,FL,Miami-Dade,,2013,7.6,1176128,1272817,96689
12086,FL,Miami-Dade,,2014,6.8,1210346,1298195,87849
12086,FL,Miami-Dade,,2015,6.1,1215857,1295273,79416
12086,FL,Miami-Dade,,2016,5.5,1233029,1305259,72230
12086,FL,Miami-Dade,,2017,4.8,1284543,1348920,64377
12086,FL,Miami-Dade,,2018,3.9,1302089,1354308,52219
12086,FL,Miami-Dade,,2019,2.7,1340491,1377449,36958
12086,FL,Miami-Dade,,2020,7.4,1177701,1271646,93945
12086,FL,Miami-Dade,,2021,5.2,1239474,1307815,68341
12087,FL,Monroe,,2007,2.2,43633,44625,992
12087,FL,Monroe,,2008,3.8,44706,46452,1746
12087,FL,Monroe,,2009,6.3,42158,45003,2845
12087,FL,Monroe,,2010,7.5,38716,41862,3146
12087,FL,Monroe,,2011,7,39566,42535,2969
12087,FL,Monroe,,2012,5.9,41044,43603,2559
12087,FL,Monroe,,2013,5.1,41922,44153,2231
12087,FL,Monroe,,2014,4.2,43038,44941,1903
12087,FL,Monroe,,2015,3.5,44332,45948,1616
12087,FL,Monroe,,2016,3.2,45095,46592,1497
12087,FL,Monroe,,2017,3.3,43809,45311,1502
12087,FL,Monroe,,2018,2.6,43582,44763,1181
12087,FL,Monroe,,2019,2.1,45205,46171,966
12087,FL,Monroe,,2020,8.4,40725,44444,3719
12087,FL,Monroe,,2021,3,44558,45926,1368
12089,FL,Nassau,,2007,2.8,34073,35043,970
12089,FL,Nassau,,2008,5,34256,36068,1812
12089,FL,Nassau,,2009,8.9,32376,35542,3166
12089,FL,Nassau,,2010,10.3,31842,35491,3649
12089,FL,Nassau,,2011,9.6,32372,35806,3434
12089,FL,Nassau,,2012,8.3,32750,35715,2965
12089,FL,Nassau,,2013,7,33542,36074,2532
12089,FL,Nassau,,2014,6.1,33989,36208,2219
12089,FL,Nassau,,2015,5.2,34798,36703,1905
12089,FL,Nassau,,2016,4.5,36176,37897,1721
12089,FL,Nassau,,2017,4,37298,38835,1537
12089,FL,Nassau,,2018,3.3,38856,40191,1335
12089,FL,Nassau,,2019,3,40248,41497,1249
12089,FL,Nassau,,2020,6.1,39035,41553,2518
12089,FL,Nassau,,2021,3.4,41268,42729,1461
12091,FL,Okaloosa,,2007,2.5,94772,97182,2410
12091,FL,Okaloosa,,2008,4.3,92255,96383,4128
12091,FL,Okaloosa,,2009,6.6,89244,95578,6334
12091,FL,Okaloosa,,2010,8.1,81155,88348,7193
12091,FL,Okaloosa,,2011,7.8,83334,90385,7051
12091,FL,Okaloosa,,2012,6.9,84517,90810,6293
12091,FL,Okaloosa,,2013,6,86383,91866,5483
12091,FL,Okaloosa,,2014,5.3,87023,91890,4867
12091,FL,Okaloosa,,2015,4.6,87870,92079,4209
12091,FL,Okaloosa,,2016,4.1,89740,93533,3793
12091,FL,Okaloosa,,2017,3.5,90353,93658,3305
12091,FL,Okaloosa,,2018,3.1,91591,94517,2926
12091,FL,Okaloosa,,2019,2.8,93198,95860,2662
12091,FL,Okaloosa,,2020,5.9,89599,95234,5635
12091,FL,Okaloosa,,2021,3.3,96102,99417,3315
12093,FL,Okeechobee,,2007,4.3,16646,17402,756
12093,FL,Okeechobee,,2008,7.6,16181,17513,1332
12093,FL,Okeechobee,,2009,11,15994,17975,1981
12093,FL,Okeechobee,,2010,12.2,15740,17934,2194
12093,FL,Okeechobee,,2011,11.9,15607,17718,2111
12093,FL,Okeechobee,,2012,10.3,16341,18211,1870
12093,FL,Okeechobee,,2013,9.1,16421,18066,1645
12093,FL,Okeechobee,,2014,7.6,16316,17652,1336
12093,FL,Okeechobee,,2015,6.4,16216,17318,1102
12093,FL,Okeechobee,,2016,5.2,17261,18205,944
12093,FL,Okeechobee,,2017,4.5,17390,18200,810
12093,FL,Okeechobee,,2018,3.8,16904,17576,672
12093,FL,Okeechobee,,2019,3.6,16972,17600,628
12093,FL,Okeechobee,,2020,5.9,16089,17090,1001
12093,FL,Okeechobee,,2021,4.1,16768,17488,720
12095,FL,Orange,,2007,3.1,573278,591776,18498
12095,FL,Orange,,2008,5.5,566785,599559,32774
12095,FL,Orange,,2009,9.7,532347,589318,56971
12095,FL,Orange,,2010,10.5,563766,629808,66042
12095,FL,Orange,,2011,9.8,575967,638380,62413
12095,FL,Orange,,2012,8.5,594652,649668,55016
12095,FL,Orange,,2013,7.1,614487,661332,46845
12095,FL,Orange,,2014,6,634818,675438,40620
12095,FL,Orange,,2015,5.1,653788,688737,34949
12095,FL,Orange,,2016,4.4,677671,708817,31146
12095,FL,Orange,,2017,3.8,695684,723383,27699
12095,FL,Orange,,2018,3.3,715936,740643,24707
12095,FL,Orange,,2019,3,730279,752910,22631
12095,FL,Orange,,2020,11.5,656788,741842,85054
12095,FL,Orange,,2021,5.2,702684,741002,38318
12097,FL,Osceola,,2007,3.5,127460,132114,4654
12097,FL,Osceola,,2008,5.9,129078,137160,8082
12097,FL,Osceola,,2009,10.4,122861,137167,14306
12097,FL,Osceola,,2010,12.1,119677,136117,16440
12097,FL,Osceola,,2011,11.3,123764,139454,15690
12097,FL,Osceola,,2012,9.7,128766,142662,13896
12097,FL,Osceola,,2013,8.3,135390,147566,12176
12097,FL,Osceola,,2014,6.9,141903,152455,10552
12097,FL,Osceola,,2015,5.8,148689,157892,9203
12097,FL,Osceola,,2016,5,156541,164792,8251
12097,FL,Osceola,,2017,4.4,164153,171704,7551
12097,FL,Osceola,,2018,3.8,172446,179225,6779
12097,FL,Osceola,,2019,3.4,177876,184097,6221
12097,FL,Osceola,,2020,14.4,162828,190165,27337
12097,FL,Osceola,,2021,6.3,174170,185839,11669
12099,FL,Palm Beach,,2007,3.6,599605,622198,22593
12099,FL,Palm Beach,,2008,6.1,585877,624078,38201
12099,FL,Palm Beach,,2009,9.9,548109,608457,60348
12099,FL,Palm Beach,,2010,10.6,572130,640308,68178
12099,FL,Palm Beach,,2011,10,583845,648941,65096
12099,FL,Palm Beach,,2012,8.8,598903,656413,57510
12099,FL,Palm Beach,,2013,7.5,620621,670585,49964
12099,FL,Palm Beach,,2014,6,642418,683721,41303
12099,FL,Palm Beach,,2015,5.2,657771,693582,35811
12099,FL,Palm Beach,,2016,4.7,677839,711609,33770
12099,FL,Palm Beach,,2017,4.2,686091,716528,30437
12099,FL,Palm Beach,,2018,3.7,694667,721421,26754
12099,FL,Palm Beach,,2019,3.4,704365,728819,24454
12099,FL,Palm Beach,,2020,8.2,656556,715415,58859
12099,FL,Palm Beach,,2021,4.3,702386,734055,31669
12101,FL,Pasco,,2007,4.1,183976,191833,7857
12101,FL,Pasco,,2008,6.9,182451,196070,13619
12101,FL,Pasco,,2009,11.1,171526,192835,21309
12101,FL,Pasco,,2010,11.6,181719,205550,23831
12101,FL,Pasco,,2011,10.8,183302,205503,22201
12101,FL,Pasco,,2012,9.3,188053,207412,19359
12101,FL,Pasco,,2013,8,193095,209918,16823
12101,FL,Pasco,,2014,6.9,198120,212730,14610
12101,FL,Pasco,,2015,5.9,203402,216242,12840
12101,FL,Pasco,,2016,5.2,211693,223250,11557
12101,FL,Pasco,,2017,4.5,216222,226509,10287
12101,FL,Pasco,,2018,4,222514,231755,9241
12101,FL,Pasco,,2019,3.6,229604,238171,8567
12101,FL,Pasco,,2020,7.7,222182,240726,18544
12101,FL,Pasco,,2021,4.4,235484,246350,10866
12103,FL,Pinellas,,2007,3.4,432618,447795,15177
12103,FL,Pinellas,,2008,6,418164,444720,26556
12103,FL,Pinellas,,2009,10,392019,435605,43586
12103,FL,Pinellas,,2010,10.5,412869,461265,48396
12103,FL,Pinellas,,2011,9.7,416575,461249,44674
12103,FL,Pinellas,,2012,8.2,425850,463951,38101
12103,FL,Pinellas,,2013,6.9,436393,468883,32490
12103,FL,Pinellas,,2014,5.9,442921,470895,27974
12103,FL,Pinellas,,2015,5,448842,472466,23624
12103,FL,Pinellas,,2016,4.4,458724,479772,21048
12103,FL,Pinellas,,2017,3.9,461683,480350,18667
12103,FL,Pinellas,,2018,3.4,464814,481305,16491
12103,FL,Pinellas,,2019,3.1,467042,481952,14910
12103,FL,Pinellas,,2020,7.7,440134,476669,36535
12103,FL,Pinellas,,2021,4,466708,486173,19465
12105,FL,Polk,,2007,3.7,256508,266472,9964
12105,FL,Polk,,2008,6.3,254459,271499,17040
12105,FL,Polk,,2009,10.5,241636,269910,28274
12105,FL,Polk,,2010,11.8,243488,275957,32469
12105,FL,Polk,,2011,11.2,244352,275294,30942
12105,FL,Polk,,2012,9.9,248119,275402,27283
12105,FL,Polk,,2013,8.6,254278,278126,23848
12105,FL,Polk,,2014,7.4,257543,278128,20585
12105,FL,Polk,,2015,6.4,263119,281059,17940
12105,FL,Polk,,2016,5.6,271786,287843,16057
12105,FL,Polk,,2017,4.9,276937,291121,14184
12105,FL,Polk,,2018,4.3,283912,296551,12639
12105,FL,Polk,,2019,3.8,292210,303868,11658
12105,FL,Polk,,2020,9.8,288447,319699,31252
12105,FL,Polk,,2021,5.4,311005,328590,17585
12107,FL,Putnam,,2007,3.9,30491,31727,1236
12107,FL,Putnam,,2008,6.9,29615,31809,2194
12107,FL,Putnam,,2009,10.9,28433,31913,3480
12107,FL,Putnam,,2010,13,26307,30235,3928
12107,FL,Putnam,,2011,12.8,25822,29603,3781
12107,FL,Putnam,,2012,12.2,25274,28775,3501
12107,FL,Putnam,,2013,10.8,25124,28179,3055
12107,FL,Putnam,,2014,9,25416,27922,2506
12107,FL,Putnam,,2015,7.7,25266,27376,2110
12107,FL,Putnam,,2016,6.4,25332,27071,1739
12107,FL,Putnam,,2017,5.5,25340,26824,1484
12107,FL,Putnam,,2018,5,25220,26552,1332
12107,FL,Putnam,,2019,4.4,25178,26345,1167
12107,FL,Putnam,,2020,8.7,24111,26398,2287
12107,FL,Putnam,,2021,6.1,25501,27149,1648
12109,FL,St. Johns,,2007,2.7,89590,92058,2468
12109,FL,St. Johns,,2008,4.7,91354,95847,4493
12109,FL,St. Johns,,2009,7.8,88208,95640,7432
12109,FL,St. Johns,,2010,8.5,90007,98319,8312
12109,FL,St. Johns,,2011,7.7,93024,100810,7786
12109,FL,St. Johns,,2012,6.7,96348,103312,6964
12109,FL,St. Johns,,2013,5.7,100940,107005,6065
12109,FL,St. Johns,,2014,4.8,105091,110429,5338
12109,FL,St. Johns,,2015,4,109271,113798,4527
12109,FL,St. Johns,,2016,3.8,114422,118966,4544
12109,FL,St. Johns,,2017,3.5,119635,123910,4275
12109,FL,St. Johns,,2018,3,125271,129131,3860
12109,FL,St. Johns,,2019,2.7,130970,134614,3644
12109,FL,St. Johns,,2020,5.6,130012,137667,7655
12109,FL,St. Johns,,2021,3,137591,141901,4310
12111,FL,St. Lucie,,2007,4.8,116935,122774,5839
12111,FL,St. Lucie,,2008,8.1,113341,123358,10017
12111,FL,St. Lucie,,2009,12.4,106794,121977,15183
12111,FL,St. Lucie,,2010,13.3,110442,127436,16994
12111,FL,St. Lucie,,2011,12.6,111837,127910,16073
12111,FL,St. Lucie,,2012,11.3,113893,128364,14471
12111,FL,St. Lucie,,2013,10.4,115651,129041,13390
12111,FL,St. Lucie,,2014,8.2,119663,130404,10741
12111,FL,St. Lucie,,2015,6.4,123346,131823,8477
12111,FL,St. Lucie,,2016,5.8,127736,135657,7921
12111,FL,St. Lucie,,2017,5.2,130882,138130,7248
12111,FL,St. Lucie,,2018,4.5,135201,141643,6442
12111,FL,St. Lucie,,2019,4,139422,145290,5868
12111,FL,St. Lucie,,2020,8.3,134666,146919,12253
12111,FL,St. Lucie,,2021,4.9,143002,150366,7364
12113,FL,Santa Rosa,,2007,3,67217,69313,2096
12113,FL,Santa Rosa,,2008,5.2,66281,69942,3661
12113,FL,Santa Rosa,,2009,8.4,63677,69504,5827
12113,FL,Santa Rosa,,2010,9,64403,70749,6346
12113,FL,Santa Rosa,,2011,8.6,66024,72241,6217
12113,FL,Santa Rosa,,2012,7.8,66565,72170,5605
12113,FL,Santa Rosa,,2013,6.7,67968,72833,4865
12113,FL,Santa Rosa,,2014,5.6,68881,72991,4110
12113,FL,Santa Rosa,,2015,4.9,70622,74246,3624
12113,FL,Santa Rosa,,2016,4.6,72892,76371,3479
12113,FL,Santa Rosa,,2017,4,75315,78420,3105
12113,FL,Santa Rosa,,2018,3.4,77931,80705,2774
12113,FL,Santa Rosa,,2019,3,80577,83105,2528
12113,FL,Santa Rosa,,2020,5.6,78224,82862,4638
12113,FL,Santa Rosa,,2021,3.5,81942,84880,2938
12115,FL,Sarasota,,2007,3.7,164161,170519,6358
12115,FL,Sarasota,,2008,6.7,154806,165899,11093
12115,FL,Sarasota,,2009,10.5,143057,159852,16795
12115,FL,Sarasota,,2010,11.2,147114,165757,18643
12115,FL,Sarasota,,2011,10.2,148948,165867,16919
12115,FL,Sarasota,,2012,8.7,152422,166931,14509
12115,FL,Sarasota,,2013,7.3,157879,170288,12409
12115,FL,Sarasota,,2014,6,164132,174637,10505
12115,FL,Sarasota,,2015,5.1,169363,178504,9141
12115,FL,Sarasota,,2016,4.6,173272,181607,8335
12115,FL,Sarasota,,2017,4,175840,183191,7351
12115,FL,Sarasota,,2018,3.5,179203,185716,6513
12115,FL,Sarasota,,2019,3.2,181384,187387,6003
12115,FL,Sarasota,,2020,7.4,170423,183985,13562
12115,FL,Sarasota,,2021,3.8,184019,191384,7365
12117,FL,Seminole,,2007,3,230464,237532,7068
12117,FL,Seminole,,2008,5.2,227177,239743,12566
12117,FL,Seminole,,2009,9.1,211892,233139,21247
12117,FL,Seminole,,2010,10.3,205181,228713,23532
12117,FL,Seminole,,2011,9.6,207265,229263,21998
12117,FL,Seminole,,2012,8.3,210480,229622,19142
12117,FL,Seminole,,2013,7,216145,232309,16164
12117,FL,Seminole,,2014,5.9,221800,235652,13852
12117,FL,Seminole,,2015,5,225741,237549,11808
12117,FL,Seminole,,2016,4.3,232335,242812,10477
12117,FL,Seminole,,2017,3.8,235999,245295,9296
12117,FL,Seminole,,2018,3.3,239979,248232,8253
12117,FL,Seminole,,2019,3,244386,251959,7573
12117,FL,Seminole,,2020,7.8,219095,237580,18485
12117,FL,Seminole,,2021,4.1,234590,244546,9956
12119,FL,Sumter,,2007,2.9,30459,31366,907
12119,FL,Sumter,,2008,5.2,29141,30750,1609
12119,FL,Sumter,,2009,8.5,28884,31550,2666
12119,FL,Sumter,,2010,12.9,21850,25080,3230
12119,FL,Sumter,,2011,12.2,22746,25901,3155
12119,FL,Sumter,,2012,10.9,23804,26712,2908
12119,FL,Sumter,,2013,9.7,24872,27530,2658
12119,FL,Sumter,,2014,8.6,25819,28243,2424
12119,FL,Sumter,,2015,7.8,26518,28750,2232
12119,FL,Sumter,,2016,7.2,27358,29490,2132
12119,FL,Sumter,,2017,6.2,28163,30029,1866
12119,FL,Sumter,,2018,5.3,29435,31086,1651
12119,FL,Sumter,,2019,4.8,30789,32346,1557
12119,FL,Sumter,,2020,8.5,29876,32660,2784
12119,FL,Sumter,,2021,5.3,32790,34621,1831
12121,FL,Suwannee,,2007,3,16746,17268,522
12121,FL,Suwannee,,2008,5.5,15977,16903,926
12121,FL,Suwannee,,2009,8.9,15720,17265,1545
12121,FL,Suwannee,,2010,9.5,17184,18988,1804
12121,FL,Suwannee,,2011,9.2,17028,18751,1723
12121,FL,Suwannee,,2012,8.3,16714,18220,1506
12121,FL,Suwannee,,2013,7.2,16726,18028,1302
12121,FL,Suwannee,,2014,6.5,16781,17944,1163
12121,FL,Suwannee,,2015,5.5,17014,18005,991
12121,FL,Suwannee,,2016,4.9,17342,18243,901
12121,FL,Suwannee,,2017,4.3,17410,18200,790
12121,FL,Suwannee,,2018,3.8,17343,18030,687
12121,FL,Suwannee,,2019,3.5,17502,18129,627
12121,FL,Suwannee,,2020,6.2,16549,17637,1088
12121,FL,Suwannee,,2021,4.5,16637,17414,777
12123,FL,Taylor,,2007,3.5,8450,8760,310
12123,FL,Taylor,,2008,6.1,8524,9077,553
12123,FL,Taylor,,2009,10,8158,9060,902
12123,FL,Taylor,,2010,10.2,8430,9390,960
12123,FL,Taylor,,2011,10,8445,9388,943
12123,FL,Taylor,,2012,9.3,8484,9350,866
12123,FL,Taylor,,2013,8.2,8690,9464,774
12123,FL,Taylor,,2014,7.1,8689,9349,660
12123,FL,Taylor,,2015,6.8,8404,9015,611
12123,FL,Taylor,,2016,5.4,8383,8866,483
12123,FL,Taylor,,2017,4.6,8304,8701,397
12123,FL,Taylor,,2018,3.9,8254,8592,338
12123,FL,Taylor,,2019,3.7,7858,8159,301
12123,FL,Taylor,,2020,6.9,7586,8151,565
12123,FL,Taylor,,2021,5,7708,8112,404
12125,FL,Union,,2007,2.6,4985,5117,132
12125,FL,Union,,2008,4.5,5044,5282,238
12125,FL,Union,,2009,7,4968,5341,373
12125,FL,Union,,2010,8.2,4989,5436,447
12125,FL,Union,,2011,8.2,4727,5148,421
12125,FL,Union,,2012,7.4,4676,5052,376
12125,FL,Union,,2013,6.6,4641,4968,327
12125,FL,Union,,2014,6.2,4436,4727,291
12125,FL,Union,,2015,4.9,4520,4753,233
12125,FL,Union,,2016,4.4,4601,4811,210
12125,FL,Union,,2017,3.8,4593,4775,182
12125,FL,Union,,2018,3.3,4425,4578,153
12125,FL,Union,,2019,3.1,4429,4569,140
12125,FL,Union,,2020,5.1,4299,4532,233
12125,FL,Union,,2021,3.7,4376,4546,170
12127,FL,Volusia,,2007,3.4,242458,251049,8591
12127,FL,Volusia,,2008,6.1,237272,252800,15528
12127,FL,Volusia,,2009,10,224533,249544,25011
12127,FL,Volusia,,2010,11.9,207981,236074,28093
12127,FL,Volusia,,2011,11.2,209938,236526,26588
12127,FL,Volusia,,2012,9.8,212873,235956,23083
12127,FL,Volusia,,2013,8.6,215040,235149,20109
12127,FL,Volusia,,2014,7,220799,237504,16705
12127,FL,Volusia,,2015,5.9,225449,239604,14155
12127,FL,Volusia,,2016,5.1,233701,246286,12585
12127,FL,Volusia,,2017,4.5,236589,247779,11190
12127,FL,Volusia,,2018,3.9,241060,250808,9748
12127,FL,Volusia,,2019,3.6,242915,251861,8946
12127,FL,Volusia,,2020,8.2,228265,248723,20458
12127,FL,Volusia,,2021,4.6,243303,255093,11790
12129,FL,Wakulla,,2007,2.5,14685,15057,372
12129,FL,Wakulla,,2008,4.2,15176,15840,664
12129,FL,Wakulla,,2009,6.4,15525,16590,1065
12129,FL,Wakulla,,2010,8.1,13304,14475,1171
12129,FL,Wakulla,,2011,8.2,13322,14518,1196
12129,FL,Wakulla,,2012,7.5,12970,14025,1055
12129,FL,Wakulla,,2013,6.2,13160,14036,876
12129,FL,Wakulla,,2014,5.3,13520,14282,762
12129,FL,Wakulla,,2015,4.7,13353,14013,660
12129,FL,Wakulla,,2016,4.2,13743,14342,599
12129,FL,Wakulla,,2017,3.7,13848,14373,525
12129,FL,Wakulla,,2018,3.2,14151,14626,475
12129,FL,Wakulla,,2019,3,14817,15271,454
12129,FL,Wakulla,,2020,4.8,14272,14994,722
12129,FL,Wakulla,,2021,3.2,14941,15429,488
12131,FL,Walton,,2007,2.3,30451,31158,707
12131,FL,Walton,,2008,4.2,29680,30979,1299
12131,FL,Walton,,2009,7,28417,30556,2139
12131,FL,Walton,,2010,9.1,23433,25774,2341
12131,FL,Walton,,2011,8.5,23914,26136,2222
12131,FL,Walton,,2012,7.5,24133,26092,1959
12131,FL,Walton,,2013,6.4,25178,26890,1712
12131,FL,Walton,,2014,5.5,25811,27301,1490
12131,FL,Walton,,2015,4.7,26623,27949,1326
12131,FL,Walton,,2016,4.3,27776,29035,1259
12131,FL,Walton,,2017,3.7,28692,29805,1113
12131,FL,Walton,,2018,3.3,29768,30769,1001
12131,FL,Walton,,2019,2.9,30914,31848,934
12131,FL,Walton,,2020,6.3,30321,32348,2027
12131,FL,Walton,,2021,3.5,32597,33792,1195
12133,FL,Washington,,2007,3.3,9281,9599,318
12133,FL,Washington,,2008,5.9,9233,9815,582
12133,FL,Washington,,2009,9.3,8897,9811,914
12133,FL,Washington,,2010,10.2,9166,10206,1040
12133,FL,Washington,,2011,10,9316,10348,1032
12133,FL,Washington,,2012,9.1,9090,9999,909
12133,FL,Washington,,2013,8,9040,9830,790
12133,FL,Washington,,2014,6.9,9010,9681,671
12133,FL,Washington,,2015,6,9068,9648,580
12133,FL,Washington,,2016,5.2,9228,9732,504
12133,FL,Washington,,2017,4.4,9277,9709,432
12133,FL,Washington,,2018,4,9295,9681,386
12133,FL,Washington,,2019,3.6,9282,9625,343
12133,FL,Washington,,2020,6.3,8843,9438,595
12133,FL,Washington,,2021,4.5,9079,9507,428
13000,GA,Georgia,,2007,4.9,4573302,4810264,236962
13000,GA,Georgia,,2008,6.8,4534790,4863225,328435
13000,GA,Georgia,,2009,10.4,4292830,4792150,499320
13000,GA,Georgia,,2010,10.7,4207266,4709781,502515
13000,GA,Georgia,,2011,10.1,4258833,4739281,480448
13000,GA,Georgia,,2012,9,4339369,4770618,431249
13000,GA,Georgia,,2013,8.1,4363292,4750046,386754
13000,GA,Georgia,,2014,7.1,4407067,4745859,338792
13000,GA,Georgia,,2015,6.1,4446515,4734088,287573
13000,GA,Georgia,,2016,5.4,4653740,4921814,268074
13000,GA,Georgia,,2017,4.8,4864813,5107889,243076
13000,GA,Georgia,,2018,4,4915713,5121172,205459
13000,GA,Georgia,,2019,3.6,4967503,5152944,185441
13000,GA,Georgia,,2020,6.5,4751105,5079555,328450
13000,GA,Georgia,,2021,3.9,4983732,5186969,203237
13001,GA,Appling,,2007,5.7,8553,9074,521
13001,GA,Appling,,2008,7.6,8625,9330,705
13001,GA,Appling,,2009,10.6,8462,9465,1003
13001,GA,Appling,,2010,12,7720,8771,1051
13001,GA,Appling,,2011,12.2,7770,8854,1084
13001,GA,Appling,,2012,11,7959,8947,988
13001,GA,Appling,,2013,10.7,7736,8661,925
13001,GA,Appling,,2014,8.9,7886,8653,767
13001,GA,Appling,,2015,7.4,7940,8578,638
13001,GA,Appling,,2016,6.5,8596,9191,595
13001,GA,Appling,,2017,5.5,8837,9354,517
13001,GA,Appling,,2018,4.4,8679,9076,397
13001,GA,Appling,,2019,4.1,8906,9285,379
13001,GA,Appling,,2020,4.7,8767,9197,430
13001,GA,Appling,,2021,3.6,8956,9288,332
13003,GA,Atkinson,,2007,6.2,3181,3390,209
13003,GA,Atkinson,,2008,9,3079,3384,305
13003,GA,Atkinson,,2009,15.6,2785,3301,516
13003,GA,Atkinson,,2010,15.4,2929,3463,534
13003,GA,Atkinson,,2011,12.7,3044,3487,443
13003,GA,Atkinson,,2012,11.4,3042,3433,391
13003,GA,Atkinson,,2013,9.3,3157,3480,323
13003,GA,Atkinson,,2014,7.6,3335,3610,275
13003,GA,Atkinson,,2015,5.8,3598,3821,223
13003,GA,Atkinson,,2016,5.3,3765,3976,211
13003,GA,Atkinson,,2017,4.5,4017,4207,190
13003,GA,Atkinson,,2018,3.6,4212,4368,156
13003,GA,Atkinson,,2019,3.3,4416,4566,150
13003,GA,Atkinson,,2020,3.9,4280,4453,173
13003,GA,Atkinson,,2021,2.9,4372,4503,131
13005,GA,Bacon,,2007,5.2,4487,4734,247
13005,GA,Bacon,,2008,6.8,4455,4778,323
13005,GA,Bacon,,2009,9.9,4188,4646,458
13005,GA,Bacon,,2010,10.8,4064,4554,490
13005,GA,Bacon,,2011,10.4,4030,4499,469
13005,GA,Bacon,,2012,9.6,4108,4542,434
13005,GA,Bacon,,2013,8.4,4234,4622,388
13005,GA,Bacon,,2014,7,4501,4840,339
13005,GA,Bacon,,2015,5.8,4557,4840,283
13005,GA,Bacon,,2016,5.3,4717,4981,264
13005,GA,Bacon,,2017,4.5,4874,5104,230
13005,GA,Bacon,,2018,3.9,4853,5048,195
13005,GA,Bacon,,2019,3.8,4776,4963,187
13005,GA,Bacon,,2020,4.6,4622,4847,225
13005,GA,Bacon,,2021,3.2,4680,4837,157
13007,GA,Baker,,2007,5.4,1565,1655,90
13007,GA,Baker,,2008,6.9,1556,1672,116
13007,GA,Baker,,2009,9.7,1432,1586,154
13007,GA,Baker,,2010,12.4,1084,1237,153
13007,GA,Baker,,2011,11.5,1035,1170,135
13007,GA,Baker,,2012,10.9,1041,1168,127
13007,GA,Baker,,2013,10.5,1010,1128,118
13007,GA,Baker,,2014,9.1,1012,1113,101
13007,GA,Baker,,2015,7.4,1029,1111,82
13007,GA,Baker,,2016,7.8,1089,1181,92
13007,GA,Baker,,2017,6.2,1171,1249,78
13007,GA,Baker,,2018,5.3,1104,1166,62
13007,GA,Baker,,2019,4.8,1104,1160,56
13007,GA,Baker,,2020,6,1059,1126,67
13007,GA,Baker,,2021,4.9,1079,1135,56
13009,GA,Baldwin,,2007,6,19486,20740,1254
13009,GA,Baldwin,,2008,8.5,19274,21062,1788
13009,GA,Baldwin,,2009,13,17789,20444,2655
13009,GA,Baldwin,,2010,15.6,16264,19261,2997
13009,GA,Baldwin,,2011,13.6,16037,18572,2535
13009,GA,Baldwin,,2012,11.4,16655,18806,2151
13009,GA,Baldwin,,2013,10.1,16637,18502,1865
13009,GA,Baldwin,,2014,8.8,16836,18451,1615
13009,GA,Baldwin,,2015,7.8,16186,17554,1368
13009,GA,Baldwin,,2016,6.9,16414,17637,1223
13009,GA,Baldwin,,2017,5.9,16720,17770,1050
13009,GA,Baldwin,,2018,5,16837,17725,888
13009,GA,Baldwin,,2019,4.4,16946,17729,783
13009,GA,Baldwin,,2020,6.9,16453,17666,1213
13009,GA,Baldwin,,2021,4.8,16885,17731,846
13011,GA,Banks,,2007,3.3,10229,10574,345
13011,GA,Banks,,2008,4.9,10463,11002,539
13011,GA,Banks,,2009,8,9704,10550,846
13011,GA,Banks,,2010,9.8,7649,8479,830
13011,GA,Banks,,2011,9.2,7712,8490,778
13011,GA,Banks,,2012,8.1,7869,8562,693
13011,GA,Banks,,2013,7.8,7360,7985,625
13011,GA,Banks,,2014,6.7,7595,8137,542
13011,GA,Banks,,2015,5.7,7666,8127,461
13011,GA,Banks,,2016,4.9,8382,8816,434
13011,GA,Banks,,2017,3.9,8995,9363,368
13011,GA,Banks,,2018,3.2,9261,9566,305
13011,GA,Banks,,2019,2.8,9528,9807,279
13011,GA,Banks,,2020,4.3,9407,9825,418
13011,GA,Banks,,2021,2.6,9854,10116,262
13013,GA,Barrow,,2007,4.5,32275,33812,1537
13013,GA,Barrow,,2008,6.8,32811,35217,2406
13013,GA,Barrow,,2009,11.1,31340,35260,3920
13013,GA,Barrow,,2010,10.9,30977,34778,3801
13013,GA,Barrow,,2011,9.9,31141,34550,3409
13013,GA,Barrow,,2012,8.5,31517,34445,2928
13013,GA,Barrow,,2013,7.3,32095,34638,2543
13013,GA,Barrow,,2014,6.3,32915,35131,2216
13013,GA,Barrow,,2015,5.4,33793,35704,1911
13013,GA,Barrow,,2016,4.8,35894,37699,1805
13013,GA,Barrow,,2017,4.1,37959,39577,1618
13013,GA,Barrow,,2018,3.3,38878,40221,1343
13013,GA,Barrow,,2019,3,40107,41331,1224
13013,GA,Barrow,,2020,5,38791,40846,2055
13013,GA,Barrow,,2021,2.9,40882,42115,1233
13015,GA,Bartow,,2007,5.3,43388,45827,2439
13015,GA,Bartow,,2008,7.7,43209,46819,3610
13015,GA,Bartow,,2009,12.7,40630,46539,5909
13015,GA,Bartow,,2010,12.3,42059,47979,5920
13015,GA,Bartow,,2011,11.4,42235,47656,5421
13015,GA,Bartow,,2012,9.8,42631,47254,4623
13015,GA,Bartow,,2013,8.6,42946,46991,4045
13015,GA,Bartow,,2014,7.2,43190,46539,3349
13015,GA,Bartow,,2015,6,43548,46322,2774
13015,GA,Bartow,,2016,5.2,45690,48194,2504
13015,GA,Bartow,,2017,4.7,47718,50051,2333
13015,GA,Bartow,,2018,3.9,48427,50368,1941
13015,GA,Bartow,,2019,3.5,49108,50872,1764
13015,GA,Bartow,,2020,6.2,46932,50018,3086
13015,GA,Bartow,,2021,3.5,49456,51257,1801
13017,GA,Ben Hill,,2007,7.4,7309,7897,588
13017,GA,Ben Hill,,2008,11.7,6660,7542,882
13017,GA,Ben Hill,,2009,16.3,6121,7315,1194
13017,GA,Ben Hill,,2010,16.1,5488,6538,1050
13017,GA,Ben Hill,,2011,15.5,5273,6237,964
13017,GA,Ben Hill,,2012,13.7,5310,6156,846
13017,GA,Ben Hill,,2013,12.4,5052,5767,715
13017,GA,Ben Hill,,2014,10,5028,5589,561
13017,GA,Ben Hill,,2015,9.2,4922,5418,496
13017,GA,Ben Hill,,2016,8.3,5089,5550,461
13017,GA,Ben Hill,,2017,7.8,5091,5523,432
13017,GA,Ben Hill,,2018,5.9,5171,5498,327
13017,GA,Ben Hill,,2019,5.7,5156,5465,309
13017,GA,Ben Hill,,2020,6.8,5120,5495,375
13017,GA,Ben Hill,,2021,5.2,5276,5568,292
13019,GA,Berrien,,2007,4.7,8375,8791,416
13019,GA,Berrien,,2008,7.5,7990,8642,652
13019,GA,Berrien,,2009,13.7,7108,8232,1124
13019,GA,Berrien,,2010,13.2,6959,8013,1054
13019,GA,Berrien,,2011,12.4,6879,7850,971
13019,GA,Berrien,,2012,10.1,7040,7830,790
13019,GA,Berrien,,2013,9.5,6698,7400,702
13019,GA,Berrien,,2014,8.6,6605,7225,620
13019,GA,Berrien,,2015,7.3,6458,6966,508
13019,GA,Berrien,,2016,6.2,6772,7220,448
13019,GA,Berrien,,2017,5.2,7077,7462,385
13019,GA,Berrien,,2018,4.2,7174,7491,317
13019,GA,Berrien,,2019,4.2,7283,7601,318
13019,GA,Berrien,,2020,5.7,7000,7425,425
13019,GA,Berrien,,2021,3.7,7363,7648,285
13021,GA,Bibb,,2007,5.7,69582,73750,4168
13021,GA,Bibb,,2008,7,70173,75452,5279
13021,GA,Bibb,,2009,10.2,67084,74697,7613
13021,GA,Bibb,,2010,11.8,62130,70421,8291
13021,GA,Bibb,,2011,11.4,62969,71063,8094
13021,GA,Bibb,,2012,10.4,64047,71469,7422
13021,GA,Bibb,,2013,9.2,63362,69796,6434
13021,GA,Bibb,,2014,8.1,63364,68918,5554
13021,GA,Bibb,,2015,6.8,62617,67167,4550
13021,GA,Bibb,,2016,6,64517,68659,4142
13021,GA,Bibb,,2017,5.4,66475,70237,3762
13021,GA,Bibb,,2018,4.6,66111,69288,3177
13021,GA,Bibb,,2019,4.1,65256,68058,2802
13021,GA,Bibb,,2020,7.5,62222,67232,5010
13021,GA,Bibb,,2021,5,64471,67875,3404
13023,GA,Bleckley,,2007,5.7,5057,5361,304
13023,GA,Bleckley,,2008,7.9,4969,5393,424
13023,GA,Bleckley,,2009,10.4,4887,5456,569
13023,GA,Bleckley,,2010,12.6,4798,5490,692
13023,GA,Bleckley,,2011,13.2,4754,5478,724
13023,GA,Bleckley,,2012,12.4,4608,5260,652
13023,GA,Bleckley,,2013,13.9,4115,4780,665
13023,GA,Bleckley,,2014,11.3,4103,4625,522
13023,GA,Bleckley,,2015,8.7,3948,4323,375
13023,GA,Bleckley,,2016,8,4143,4504,361
13023,GA,Bleckley,,2017,6.8,4313,4626,313
13023,GA,Bleckley,,2018,5.8,4355,4625,270
13023,GA,Bleckley,,2019,5.3,4356,4600,244
13023,GA,Bleckley,,2020,6.5,4218,4509,291
13023,GA,Bleckley,,2021,5,4393,4622,229
13025,GA,Brantley,,2007,4.9,7182,7550,368
13025,GA,Brantley,,2008,6.9,7123,7653,530
13025,GA,Brantley,,2009,11.4,6694,7557,863
13025,GA,Brantley,,2010,12.9,6525,7492,967
13025,GA,Brantley,,2011,13.1,6474,7450,976
13025,GA,Brantley,,2012,11.9,6532,7411,879
13025,GA,Brantley,,2013,10.6,6283,7027,744
13025,GA,Brantley,,2014,9.3,6240,6880,640
13025,GA,Brantley,,2015,7.6,6311,6830,519
13025,GA,Brantley,,2016,6.8,6614,7098,484
13025,GA,Brantley,,2017,5.7,6951,7375,424
13025,GA,Brantley,,2018,4.5,7053,7388,335
13025,GA,Brantley,,2019,4.3,6944,7257,313
13025,GA,Brantley,,2020,5.3,6645,7018,373
13025,GA,Brantley,,2021,3.6,7030,7296,266
13027,GA,Brooks,,2007,4.7,8005,8396,391
13027,GA,Brooks,,2008,6.2,7857,8374,517
13027,GA,Brooks,,2009,9,7302,8023,721
13027,GA,Brooks,,2010,9.7,6614,7328,714
13027,GA,Brooks,,2011,9.9,6353,7053,700
13027,GA,Brooks,,2012,9,6172,6784,612
13027,GA,Brooks,,2013,8.3,6121,6673,552
13027,GA,Brooks,,2014,7.2,6141,6619,478
13027,GA,Brooks,,2015,6.2,6386,6805,419
13027,GA,Brooks,,2016,5.3,6638,7010,372
13027,GA,Brooks,,2017,4.5,6788,7111,323
13027,GA,Brooks,,2018,4,6704,6984,280
13027,GA,Brooks,,2019,3.5,6641,6885,244
13027,GA,Brooks,,2020,5.2,6391,6745,354
13027,GA,Brooks,,2021,3.7,6566,6821,255
13029,GA,Bryan,,2007,3.7,15969,16587,618
13029,GA,Bryan,,2008,5.3,16113,17021,908
13029,GA,Bryan,,2009,8.2,15583,16978,1395
13029,GA,Bryan,,2010,9.7,13086,14492,1406
13029,GA,Bryan,,2011,9.3,13329,14691,1362
13029,GA,Bryan,,2012,8.2,13869,15103,1234
13029,GA,Bryan,,2013,7.4,14260,15398,1138
13029,GA,Bryan,,2014,6.5,14513,15516,1003
13029,GA,Bryan,,2015,5.3,15109,15962,853
13029,GA,Bryan,,2016,4.9,16093,16928,835
13029,GA,Bryan,,2017,4.2,17025,17777,752
13029,GA,Bryan,,2018,3.4,17747,18376,629
13029,GA,Bryan,,2019,3.1,18620,19208,588
13029,GA,Bryan,,2020,5.1,18121,19103,982
13029,GA,Bryan,,2021,2.9,19321,19894,573
13031,GA,Bulloch,,2007,4.7,30830,32348,1518
13031,GA,Bulloch,,2008,6.6,30866,33044,2178
13031,GA,Bulloch,,2009,9.9,29735,32985,3250
13031,GA,Bulloch,,2010,10.2,29839,33233,3394
13031,GA,Bulloch,,2011,10.4,29946,33430,3484
13031,GA,Bulloch,,2012,9.6,30541,33801,3260
13031,GA,Bulloch,,2013,8.6,31186,34129,2943
13031,GA,Bulloch,,2014,7.4,31949,34486,2537
13031,GA,Bulloch,,2015,6.2,32226,34344,2118
13031,GA,Bulloch,,2016,5.8,33878,35965,2087
13031,GA,Bulloch,,2017,5.1,35145,37025,1880
13031,GA,Bulloch,,2018,4.3,35567,37174,1607
13031,GA,Bulloch,,2019,4,36072,37582,1510
13031,GA,Bulloch,,2020,6.5,34769,37178,2409
13031,GA,Bulloch,,2021,4.1,36495,38062,1567
13033,GA,Burke,,2007,8.4,9159,9994,835
13033,GA,Burke,,2008,9.4,9053,9991,938
13033,GA,Burke,,2009,12.4,8721,9960,1239
13033,GA,Burke,,2010,12.3,8611,9819,1208
13033,GA,Burke,,2011,12.6,8681,9930,1249
13033,GA,Burke,,2012,12.2,8500,9678,1178
13033,GA,Burke,,2013,11.9,8342,9470,1128
13033,GA,Burke,,2014,10.1,8236,9159,923
13033,GA,Burke,,2015,8.3,8285,9031,746
13033,GA,Burke,,2016,7.8,8522,9244,722
13033,GA,Burke,,2017,7.2,8752,9428,676
13033,GA,Burke,,2018,6.2,8719,9291,572
13033,GA,Burke,,2019,5.4,8652,9142,490
13033,GA,Burke,,2020,7.1,8391,9036,645
13033,GA,Burke,,2021,5.8,8621,9156,535
13035,GA,Butts,,2007,5.6,9577,10145,568
13035,GA,Butts,,2008,8.1,9589,10433,844
13035,GA,Butts,,2009,12.6,8883,10164,1281
13035,GA,Butts,,2010,11.6,9299,10521,1222
13035,GA,Butts,,2011,11.3,9260,10434,1174
13035,GA,Butts,,2012,10.1,9292,10336,1044
13035,GA,Butts,,2013,9.2,9243,10183,940
13035,GA,Butts,,2014,7.5,9258,10012,754
13035,GA,Butts,,2015,6.8,9335,10012,677
13035,GA,Butts,,2016,5.7,9786,10379,593
13035,GA,Butts,,2017,4.8,10203,10723,520
13035,GA,Butts,,2018,4.1,10278,10721,443
13035,GA,Butts,,2019,3.5,10613,10999,386
13035,GA,Butts,,2020,6.1,10183,10844,661
13035,GA,Butts,,2021,3.6,10727,11132,405
13037,GA,Calhoun,,2007,7.2,2021,2177,156
13037,GA,Calhoun,,2008,8.7,2194,2402,208
13037,GA,Calhoun,,2009,11.8,2071,2347,276
13037,GA,Calhoun,,2010,8.9,2393,2626,233
13037,GA,Calhoun,,2011,8.3,2307,2515,208
13037,GA,Calhoun,,2012,7.7,2185,2367,182
13037,GA,Calhoun,,2013,8.1,1933,2103,170
13037,GA,Calhoun,,2014,7,1987,2136,149
13037,GA,Calhoun,,2015,6.3,1972,2105,133
13037,GA,Calhoun,,2016,5.7,2040,2164,124
13037,GA,Calhoun,,2017,5.3,2149,2269,120
13037,GA,Calhoun,,2018,4.3,2154,2250,96
13037,GA,Calhoun,,2019,3.7,2182,2266,84
13037,GA,Calhoun,,2020,5.1,2122,2237,115
13037,GA,Calhoun,,2021,4,2138,2228,90
13039,GA,Camden,,2007,4.4,20633,21574,941
13039,GA,Camden,,2008,6.1,20000,21290,1290
13039,GA,Camden,,2009,9.4,18819,20765,1946
13039,GA,Camden,,2010,10.1,18666,20754,2088
13039,GA,Camden,,2011,9.5,19112,21111,1999
13039,GA,Camden,,2012,8.5,19963,21807,1844
13039,GA,Camden,,2013,7.7,19890,21550,1660
13039,GA,Camden,,2014,6.6,20471,21925,1454
13039,GA,Camden,,2015,5.6,20804,22048,1244
13039,GA,Camden,,2016,5.8,19164,20352,1188
13039,GA,Camden,,2017,5.1,19979,21055,1076
13039,GA,Camden,,2018,4.3,20075,20967,892
13039,GA,Camden,,2019,3.8,20490,21292,802
13039,GA,Camden,,2020,4.8,20100,21106,1006
13039,GA,Camden,,2021,3.2,20973,21658,685
13043,GA,Candler,,2007,4.8,4201,4413,212
13043,GA,Candler,,2008,6.8,4039,4334,295
13043,GA,Candler,,2009,9.7,3921,4344,423
13043,GA,Candler,,2010,8.9,4487,4928,441
13043,GA,Candler,,2011,9.5,4544,5021,477
13043,GA,Candler,,2012,8.5,4727,5168,441
13043,GA,Candler,,2013,8.1,4682,5095,413
13043,GA,Candler,,2014,6.9,4715,5067,352
13043,GA,Candler,,2015,5.8,4626,4910,284
13043,GA,Candler,,2016,4.9,4825,5071,246
13043,GA,Candler,,2017,4.1,5061,5279,218
13043,GA,Candler,,2018,3.5,5176,5361,185
13043,GA,Candler,,2019,3.1,5450,5623,173
13043,GA,Candler,,2020,4.4,5482,5732,250
13043,GA,Candler,,2021,3,5827,6009,182
13045,GA,Carroll,,2007,5.2,50420,53193,2773
13045,GA,Carroll,,2008,7.3,49871,53780,3909
13045,GA,Carroll,,2009,11.5,46703,52772,6069
13045,GA,Carroll,,2010,11.9,45819,51982,6163
13045,GA,Carroll,,2011,11.3,45973,51829,5856
13045,GA,Carroll,,2012,10.1,46582,51829,5247
13045,GA,Carroll,,2013,9.6,46833,51788,4955
13045,GA,Carroll,,2014,8.2,47618,51886,4268
13045,GA,Carroll,,2015,6.8,47706,51208,3502
13045,GA,Carroll,,2016,6.1,50291,53550,3259
13045,GA,Carroll,,2017,5.1,52618,55432,2814
13045,GA,Carroll,,2018,4.1,52854,55094,2240
13045,GA,Carroll,,2019,3.6,53746,55771,2025
13045,GA,Carroll,,2020,6.3,51259,54696,3437
13045,GA,Carroll,,2021,3.7,54073,56140,2067
13047,GA,Catoosa,,2007,3.9,33996,35382,1386
13047,GA,Catoosa,,2008,5.5,33650,35626,1976
13047,GA,Catoosa,,2009,8.9,31548,34615,3067
13047,GA,Catoosa,,2010,8.7,28700,31426,2726
13047,GA,Catoosa,,2011,8.1,29402,32002,2600
13047,GA,Catoosa,,2012,7.4,29780,32145,2365
13047,GA,Catoosa,,2013,6.7,29495,31608,2113
13047,GA,Catoosa,,2014,6.2,29079,30990,1911
13047,GA,Catoosa,,2015,5.3,29364,31012,1648
13047,GA,Catoosa,,2016,4.9,30595,32172,1577
13047,GA,Catoosa,,2017,4.2,31790,33171,1381
13047,GA,Catoosa,,2018,3.5,32408,33567,1159
13047,GA,Catoosa,,2019,3.1,32479,33534,1055
13047,GA,Catoosa,,2020,4.4,31183,32604,1421
13047,GA,Catoosa,,2021,2.7,32551,33457,906
13049,GA,Charlton,,2007,5.2,4354,4591,237
13049,GA,Charlton,,2008,7.3,4240,4573,333
13049,GA,Charlton,,2009,11.5,3966,4479,513
13049,GA,Charlton,,2010,10.7,4294,4811,517
13049,GA,Charlton,,2011,10.5,4433,4955,522
13049,GA,Charlton,,2012,9.2,4506,4962,456
13049,GA,Charlton,,2013,8.4,4500,4912,412
13049,GA,Charlton,,2014,7.4,4442,4797,355
13049,GA,Charlton,,2015,6.5,4407,4713,306
13049,GA,Charlton,,2016,5.7,4470,4741,271
13049,GA,Charlton,,2017,5.1,4658,4907,249
13049,GA,Charlton,,2018,4.4,4610,4821,211
13049,GA,Charlton,,2019,3.9,4729,4923,194
13049,GA,Charlton,,2020,3.8,4687,4873,186
13049,GA,Charlton,,2021,3.2,4802,4959,157
13051,GA,Chatham,,2007,4.3,127715,133454,5739
13051,GA,Chatham,,2008,6.1,125887,134094,8207
13051,GA,Chatham,,2009,9.1,119302,131201,11899
13051,GA,Chatham,,2010,10,114919,127700,12781
13051,GA,Chatham,,2011,10,116527,129417,12890
13051,GA,Chatham,,2012,9.1,119558,131535,11977
13051,GA,Chatham,,2013,8.2,120414,131196,10782
13051,GA,Chatham,,2014,7.3,121872,131529,9657
13051,GA,Chatham,,2015,6,123904,131745,7841
13051,GA,Chatham,,2016,5.3,128852,136088,7236
13051,GA,Chatham,,2017,4.5,133838,140182,6344
13051,GA,Chatham,,2018,3.8,135108,140421,5313
13051,GA,Chatham,,2019,3.4,136469,141320,4851
13051,GA,Chatham,,2020,7.6,129111,139696,10585
13051,GA,Chatham,,2021,4.3,137644,143877,6233
13053,GA,Chattahoochee,,2007,10.2,1535,1709,174
13053,GA,Chattahoochee,,2008,13.1,2226,2563,337
13053,GA,Chattahoochee,,2009,15.5,2222,2630,408
13053,GA,Chattahoochee,,2010,11.1,1978,2224,246
13053,GA,Chattahoochee,,2011,11.4,2093,2363,270
13053,GA,Chattahoochee,,2012,11.5,2292,2591,299
13053,GA,Chattahoochee,,2013,10.9,2189,2457,268
13053,GA,Chattahoochee,,2014,9.7,2009,2226,217
13053,GA,Chattahoochee,,2015,8.9,1901,2087,186
13053,GA,Chattahoochee,,2016,8.4,1887,2060,173
13053,GA,Chattahoochee,,2017,6.9,1870,2008,138
13053,GA,Chattahoochee,,2018,5.5,1927,2040,113
13053,GA,Chattahoochee,,2019,4.7,1937,2033,96
13053,GA,Chattahoochee,,2020,6.3,1798,1919,121
13053,GA,Chattahoochee,,2021,4.5,1826,1912,86
13055,GA,Chattooga,,2007,6.4,10224,10921,697
13055,GA,Chattooga,,2008,10.6,10083,11278,1195
13055,GA,Chattooga,,2009,13.9,9298,10805,1507
13055,GA,Chattooga,,2010,11.8,9436,10699,1263
13055,GA,Chattooga,,2011,10.9,9401,10554,1153
13055,GA,Chattooga,,2012,10.1,9533,10602,1069
13055,GA,Chattooga,,2013,8.9,9583,10522,939
13055,GA,Chattooga,,2014,7.6,9698,10499,801
13055,GA,Chattooga,,2015,6.3,9777,10432,655
13055,GA,Chattooga,,2016,6.4,9769,10436,667
13055,GA,Chattooga,,2017,4.8,10152,10659,507
13055,GA,Chattooga,,2018,4.1,10089,10524,435
13055,GA,Chattooga,,2019,5.2,9859,10403,544
13055,GA,Chattooga,,2020,8.3,8943,9754,811
13055,GA,Chattooga,,2021,4.8,9107,9562,455
13057,GA,Cherokee,,2007,3.9,105188,109496,4308
13057,GA,Cherokee,,2008,5.7,105550,111944,6394
13057,GA,Cherokee,,2009,9.3,100023,110278,10255
13057,GA,Cherokee,,2010,8.9,102814,112852,10038
13057,GA,Cherokee,,2011,8.1,104432,113630,9198
13057,GA,Cherokee,,2012,7,106681,114682,8001
13057,GA,Cherokee,,2013,6.1,108491,115546,7055
13057,GA,Cherokee,,2014,5.5,111330,117819,6489
13057,GA,Cherokee,,2015,4.8,113293,118953,5660
13057,GA,Cherokee,,2016,4.3,120452,125883,5431
13057,GA,Cherokee,,2017,3.8,127318,132308,4990
13057,GA,Cherokee,,2018,3.2,130961,135240,4279
13057,GA,Cherokee,,2019,2.9,133463,137413,3950
13057,GA,Cherokee,,2020,4.8,128633,135061,6428
13057,GA,Cherokee,,2021,2.6,135761,139406,3645
13059,GA,Clarke,,2007,4.2,61583,64284,2701
13059,GA,Clarke,,2008,5.5,62243,65879,3636
13059,GA,Clarke,,2009,8,58954,64063,5109
13059,GA,Clarke,,2010,9.4,51424,56779,5355
13059,GA,Clarke,,2011,9.2,51801,57069,5268
13059,GA,Clarke,,2012,8.6,52974,57948,4974
13059,GA,Clarke,,2013,7.8,53315,57805,4490
13059,GA,Clarke,,2014,7,52226,56136,3910
13059,GA,Clarke,,2015,6.2,52987,56485,3498
13059,GA,Clarke,,2016,5.6,55484,58767,3283
13059,GA,Clarke,,2017,4.8,58562,61504,2942
13059,GA,Clarke,,2018,4,58558,61020,2462
13059,GA,Clarke,,2019,3.7,57559,59791,2232
13059,GA,Clarke,,2020,6.4,54293,57996,3703
13059,GA,Clarke,,2021,3.8,56922,59167,2245
13061,GA,Clay,,2007,6,1386,1475,89
13061,GA,Clay,,2008,7.9,1358,1474,116
13061,GA,Clay,,2009,9,1287,1414,127
13061,GA,Clay,,2010,11.8,974,1104,130
13061,GA,Clay,,2011,12.1,934,1063,129
13061,GA,Clay,,2012,12.3,881,1005,124
13061,GA,Clay,,2013,11.3,846,954,108
13061,GA,Clay,,2014,11.4,810,914,104
13061,GA,Clay,,2015,12,749,851,102
13061,GA,Clay,,2016,10.5,791,884,93
13061,GA,Clay,,2017,9.1,796,876,80
13061,GA,Clay,,2018,7.6,787,852,65
13061,GA,Clay,,2019,7.1,820,883,63
13061,GA,Clay,,2020,12.2,791,901,110
13061,GA,Clay,,2021,10.2,794,884,90
13063,GA,Clayton,,2007,6.2,127764,136196,8432
13063,GA,Clayton,,2008,8.2,125133,136326,11193
13063,GA,Clayton,,2009,12.3,116941,133393,16452
13063,GA,Clayton,,2010,13.7,108377,125582,17205
13063,GA,Clayton,,2011,13.3,109832,126710,16878
13063,GA,Clayton,,2012,11.9,112073,127159,15086
13063,GA,Clayton,,2013,10.7,111468,124846,13378
13063,GA,Clayton,,2014,9.3,112890,124524,11634
13063,GA,Clayton,,2015,7.8,115296,124988,9692
13063,GA,Clayton,,2016,6.7,122049,130800,8751
13063,GA,Clayton,,2017,5.9,128439,136466,8027
13063,GA,Clayton,,2018,5,130725,137560,6835
13063,GA,Clayton,,2019,4.5,132129,138283,6154
13063,GA,Clayton,,2020,10.3,124431,138704,14273
13063,GA,Clayton,,2021,6.5,131120,140309,9189
13065,GA,Clinch,,2007,5.8,2602,2761,159
13065,GA,Clinch,,2008,7.8,2574,2791,217
13065,GA,Clinch,,2009,11.6,2471,2794,323
13065,GA,Clinch,,2010,11.2,2582,2907,325
13065,GA,Clinch,,2011,10.9,2569,2882,313
13065,GA,Clinch,,2012,9.6,2628,2906,278
13065,GA,Clinch,,2013,9.1,2569,2826,257
13065,GA,Clinch,,2014,8.4,2585,2823,238
13065,GA,Clinch,,2015,7.1,2546,2742,196
13065,GA,Clinch,,2016,6.2,2596,2769,173
13065,GA,Clinch,,2017,5.6,2647,2804,157
13065,GA,Clinch,,2018,4.6,2642,2769,127
13065,GA,Clinch,,2019,3.8,2715,2823,108
13065,GA,Clinch,,2020,3.9,2846,2961,115
13065,GA,Clinch,,2021,2.9,2933,3022,89
13067,GA,Cobb,,2007,4.4,363385,379948,16563
13067,GA,Cobb,,2008,6.1,357151,380211,23060
13067,GA,Cobb,,2009,9.6,339129,375048,35919
13067,GA,Cobb,,2010,9.4,345298,381245,35947
13067,GA,Cobb,,2011,8.8,350357,383975,33618
13067,GA,Cobb,,2012,7.6,357927,387385,29458
13067,GA,Cobb,,2013,6.6,362523,388328,25805
13067,GA,Cobb,,2014,5.9,369474,392834,23360
13067,GA,Cobb,,2015,5.2,373383,393682,20299
13067,GA,Cobb,,2016,4.7,390988,410083,19095
13067,GA,Cobb,,2017,4.1,407484,425019,17535
13067,GA,Cobb,,2018,3.5,408917,423633,14716
13067,GA,Cobb,,2019,3.1,411105,424395,13290
13067,GA,Cobb,,2020,5.9,387938,412115,24177
13067,GA,Cobb,,2021,3.3,409319,423126,13807
13069,GA,Coffee,,2007,6.4,15465,16525,1060
13069,GA,Coffee,,2008,8.9,15213,16703,1490
13069,GA,Coffee,,2009,16.1,13794,16437,2643
13069,GA,Coffee,,2010,16,14502,17260,2758
13069,GA,Coffee,,2011,12.8,15320,17563,2243
13069,GA,Coffee,,2012,11.2,15452,17408,1956
13069,GA,Coffee,,2013,9.9,15761,17486,1725
13069,GA,Coffee,,2014,8.2,16172,17611,1439
13069,GA,Coffee,,2015,6.8,15926,17096,1170
13069,GA,Coffee,,2016,5.9,17024,18092,1068
13069,GA,Coffee,,2017,5.1,17675,18633,958
13069,GA,Coffee,,2018,4.6,18017,18877,860
13069,GA,Coffee,,2019,4,18477,19251,774
13069,GA,Coffee,,2020,5.8,17845,18941,1096
13069,GA,Coffee,,2021,4.1,18079,18845,766
13071,GA,Colquitt,,2007,4.9,19458,20450,992
13071,GA,Colquitt,,2008,6.5,19350,20697,1347
13071,GA,Colquitt,,2009,9.6,18528,20485,1957
13071,GA,Colquitt,,2010,9.8,19271,21369,2098
13071,GA,Colquitt,,2011,9.4,19197,21189,1992
13071,GA,Colquitt,,2012,8.6,19123,20933,1810
13071,GA,Colquitt,,2013,8.7,18532,20299,1767
13071,GA,Colquitt,,2014,8.1,18425,20052,1627
13071,GA,Colquitt,,2015,6.5,18535,19823,1288
13071,GA,Colquitt,,2016,5.3,19979,21103,1124
13071,GA,Colquitt,,2017,4.5,21276,22288,1012
13071,GA,Colquitt,,2018,3.8,20773,21594,821
13071,GA,Colquitt,,2019,3.3,21082,21793,711
13071,GA,Colquitt,,2020,4.5,20888,21863,975
13071,GA,Colquitt,,2021,3.2,21514,22227,713
13073,GA,Columbia,,2007,4.1,57347,59806,2459
13073,GA,Columbia,,2008,5.2,57530,60657,3127
13073,GA,Columbia,,2009,7.3,56425,60839,4414
13073,GA,Columbia,,2010,7.4,57098,61662,4564
13073,GA,Columbia,,2011,7.3,58606,63212,4606
13073,GA,Columbia,,2012,6.9,60067,64503,4436
13073,GA,Columbia,,2013,6.4,61274,65488,4214
13073,GA,Columbia,,2014,5.8,62459,66326,3867
13073,GA,Columbia,,2015,5.1,64390,67851,3461
13073,GA,Columbia,,2016,4.7,67691,71036,3345
13073,GA,Columbia,,2017,4.2,71853,74967,3114
13073,GA,Columbia,,2018,3.5,73226,75896,2670
13073,GA,Columbia,,2019,3.2,73803,76219,2416
13073,GA,Columbia,,2020,4.2,72176,75307,3131
13073,GA,Columbia,,2021,2.7,74420,76478,2058
13075,GA,Cook,,2007,6.1,6695,7133,438
13075,GA,Cook,,2008,8.4,6632,7237,605
13075,GA,Cook,,2009,13.4,6051,6985,934
13075,GA,Cook,,2010,11.8,6975,7907,932
13075,GA,Cook,,2011,11.1,6739,7584,845
13075,GA,Cook,,2012,9.3,6807,7507,700
13075,GA,Cook,,2013,8.5,6798,7428,630
13075,GA,Cook,,2014,8.1,6783,7384,601
13075,GA,Cook,,2015,6.8,6716,7206,490
13075,GA,Cook,,2016,5.5,7111,7524,413
13075,GA,Cook,,2017,4.6,7433,7789,356
13075,GA,Cook,,2018,3.8,7568,7869,301
13075,GA,Cook,,2019,3.5,7887,8172,285
13075,GA,Cook,,2020,4.7,7715,8099,384
13075,GA,Cook,,2021,3.4,7957,8237,280
13077,GA,Coweta,,2007,4.3,57012,59580,2568
13077,GA,Coweta,,2008,6.2,57395,61181,3786
13077,GA,Coweta,,2009,10.3,55051,61383,6332
13077,GA,Coweta,,2010,9.8,58167,64514,6347
13077,GA,Coweta,,2011,9,59061,64884,5823
13077,GA,Coweta,,2012,7.9,60150,65278,5128
13077,GA,Coweta,,2013,6.9,61173,65734,4561
13077,GA,Coweta,,2014,6.2,62297,66402,4105
13077,GA,Coweta,,2015,5.4,63448,67073,3625
13077,GA,Coweta,,2016,5,66854,70403,3549
13077,GA,Coweta,,2017,4.2,70242,73342,3100
13077,GA,Coweta,,2018,3.5,71737,74329,2592
13077,GA,Coweta,,2019,3.1,73141,75472,2331
13077,GA,Coweta,,2020,6.1,69877,74415,4538
13077,GA,Coweta,,2021,3.4,73661,76218,2557
13079,GA,Crawford,,2007,5.1,5806,6118,312
13079,GA,Crawford,,2008,6.5,5848,6256,408
13079,GA,Crawford,,2009,10.5,5441,6082,641
13079,GA,Crawford,,2010,11.7,5116,5791,675
13079,GA,Crawford,,2011,10.7,5175,5798,623
13079,GA,Crawford,,2012,9.7,5248,5810,562
13079,GA,Crawford,,2013,8.8,5181,5681,500
13079,GA,Crawford,,2014,7.5,5183,5604,421
13079,GA,Crawford,,2015,6.4,5160,5514,354
13079,GA,Crawford,,2016,6,5339,5678,339
13079,GA,Crawford,,2017,5,5499,5786,287
13079,GA,Crawford,,2018,4.2,5469,5710,241
13079,GA,Crawford,,2019,3.8,5440,5653,213
13079,GA,Crawford,,2020,5.1,5139,5414,275
13079,GA,Crawford,,2021,3.7,5319,5523,204
13081,GA,Crisp,,2007,6.3,9958,10625,667
13081,GA,Crisp,,2008,8.3,9354,10203,849
13081,GA,Crisp,,2009,12.8,8536,9786,1250
13081,GA,Crisp,,2010,14.4,7911,9237,1326
13081,GA,Crisp,,2011,13.8,7915,9180,1265
13081,GA,Crisp,,2012,12.3,8013,9139,1126
13081,GA,Crisp,,2013,11.1,8588,9660,1072
13081,GA,Crisp,,2014,8.9,8604,9442,838
13081,GA,Crisp,,2015,7,8671,9320,649
13081,GA,Crisp,,2016,6.1,8629,9191,562
13081,GA,Crisp,,2017,5.2,8996,9493,497
13081,GA,Crisp,,2018,4.9,8962,9424,462
13081,GA,Crisp,,2019,4,9220,9606,386
13081,GA,Crisp,,2020,9,8841,9714,873
13081,GA,Crisp,,2021,8.6,9206,10068,862
13083,GA,Dade,,2007,4.6,8037,8424,387
13083,GA,Dade,,2008,6.1,7902,8419,517
13083,GA,Dade,,2009,11,7262,8157,895
13083,GA,Dade,,2010,8.8,7634,8369,735
13083,GA,Dade,,2011,7.9,7689,8349,660
13083,GA,Dade,,2012,7.5,7731,8358,627
13083,GA,Dade,,2013,7.1,7543,8117,574
13083,GA,Dade,,2014,6.3,7375,7873,498
13083,GA,Dade,,2015,5.6,7329,7761,432
13083,GA,Dade,,2016,5.1,7607,8018,411
13083,GA,Dade,,2017,4.4,7921,8287,366
13083,GA,Dade,,2018,3.7,7933,8238,305
13083,GA,Dade,,2019,3.4,7858,8137,279
13083,GA,Dade,,2020,4.1,7463,7784,321
13083,GA,Dade,,2021,2.6,7839,8049,210
13085,GA,Dawson,,2007,4,10636,11081,445
13085,GA,Dawson,,2008,6.4,10612,11334,722
13085,GA,Dawson,,2009,10.5,10089,11267,1178
13085,GA,Dawson,,2010,11,9783,10997,1214
13085,GA,Dawson,,2011,10.1,9769,10863,1094
13085,GA,Dawson,,2012,8.4,9908,10822,914
13085,GA,Dawson,,2013,7.3,9979,10769,790
13085,GA,Dawson,,2014,6.1,10121,10779,658
13085,GA,Dawson,,2015,5.2,10256,10818,562
13085,GA,Dawson,,2016,4.7,10793,11330,537
13085,GA,Dawson,,2017,3.9,11524,11991,467
13085,GA,Dawson,,2018,3.4,11875,12289,414
13085,GA,Dawson,,2019,3,12363,12740,377
13085,GA,Dawson,,2020,4.6,12082,12665,583
13085,GA,Dawson,,2021,2.7,12765,13115,350
13087,GA,Decatur,,2007,6.5,11004,11774,770
13087,GA,Decatur,,2008,8.3,11092,12090,998
13087,GA,Decatur,,2009,13.2,10358,11940,1582
13087,GA,Decatur,,2010,12.6,10910,12482,1572
13087,GA,Decatur,,2011,11.9,10608,12039,1431
13087,GA,Decatur,,2012,10,10984,12201,1217
13087,GA,Decatur,,2013,9.4,10469,11560,1091
13087,GA,Decatur,,2014,8.2,10430,11359,929
13087,GA,Decatur,,2015,6.9,10486,11265,779
13087,GA,Decatur,,2016,6.7,10703,11476,773
13087,GA,Decatur,,2017,5.6,11115,11773,658
13087,GA,Decatur,,2018,4.7,10981,11528,547
13087,GA,Decatur,,2019,3.9,11227,11684,457
13087,GA,Decatur,,2020,4.8,10778,11320,542
13087,GA,Decatur,,2021,3.7,10923,11338,415
13089,GA,DeKalb,,2007,5.2,372948,393477,20529
13089,GA,DeKalb,,2008,6.9,364679,391727,27048
13089,GA,DeKalb,,2009,10.5,341611,381692,40081
13089,GA,DeKalb,,2010,11,324087,363973,39886
13089,GA,DeKalb,,2011,10.4,327592,365804,38212
13089,GA,DeKalb,,2012,9.3,334647,368814,34167
13089,GA,DeKalb,,2013,8.4,337355,368157,30802
13089,GA,DeKalb,,2014,7.3,341429,368198,26769
13089,GA,DeKalb,,2015,6.1,346210,368863,22653
13089,GA,DeKalb,,2016,5.5,361823,382731,20908
13089,GA,DeKalb,,2017,4.8,379705,399020,19315
13089,GA,DeKalb,,2018,4.1,382178,398529,16351
13089,GA,DeKalb,,2019,3.6,384029,398467,14438
13089,GA,DeKalb,,2020,7.9,362325,393461,31136
13089,GA,DeKalb,,2021,4.6,382143,400667,18524
13091,GA,Dodge,,2007,5.4,9003,9516,513
13091,GA,Dodge,,2008,7.3,8710,9392,682
13091,GA,Dodge,,2009,11.3,8069,9092,1023
13091,GA,Dodge,,2010,13.2,7280,8389,1109
13091,GA,Dodge,,2011,12.2,7266,8275,1009
13091,GA,Dodge,,2012,11.4,7198,8121,923
13091,GA,Dodge,,2013,11.3,6892,7772,880
13091,GA,Dodge,,2014,9.8,6695,7423,728
13091,GA,Dodge,,2015,8.5,6295,6881,586
13091,GA,Dodge,,2016,7.4,6501,7018,517
13091,GA,Dodge,,2017,6.3,6748,7202,454
13091,GA,Dodge,,2018,5.2,6807,7184,377
13091,GA,Dodge,,2019,5.6,6774,7173,399
13091,GA,Dodge,,2020,6,6508,6922,414
13091,GA,Dodge,,2021,4.2,6709,7005,296
13093,GA,Dooly,,2007,5.7,4644,4926,282
13093,GA,Dooly,,2008,7.3,4442,4791,349
13093,GA,Dooly,,2009,10.4,4337,4841,504
13093,GA,Dooly,,2010,11.7,4392,4974,582
13093,GA,Dooly,,2011,12.9,4160,4778,618
13093,GA,Dooly,,2012,11.3,4252,4795,543
13093,GA,Dooly,,2013,11.4,3993,4508,515
13093,GA,Dooly,,2014,9.6,4183,4629,446
13093,GA,Dooly,,2015,7.7,4344,4705,361
13093,GA,Dooly,,2016,5.9,4660,4951,291
13093,GA,Dooly,,2017,5.1,4874,5136,262
13093,GA,Dooly,,2018,4.7,4894,5137,243
13093,GA,Dooly,,2019,3.9,4884,5082,198
13093,GA,Dooly,,2020,9,4528,4974,446
13093,GA,Dooly,,2021,7.3,4577,4936,359
13095,GA,Dougherty,,2007,6.1,39452,42001,2549
13095,GA,Dougherty,,2008,7.5,39002,42176,3174
13095,GA,Dougherty,,2009,11,37595,42259,4664
13095,GA,Dougherty,,2010,12.7,36327,41623,5296
13095,GA,Dougherty,,2011,12.1,36196,41182,4986
13095,GA,Dougherty,,2012,11.1,36216,40755,4539
13095,GA,Dougherty,,2013,10.3,35585,39661,4076
13095,GA,Dougherty,,2014,9.3,35022,38601,3579
13095,GA,Dougherty,,2015,7.9,34519,37460,2941
13095,GA,Dougherty,,2016,6.9,35525,38172,2647
13095,GA,Dougherty,,2017,6.1,36904,39291,2387
13095,GA,Dougherty,,2018,5.4,36603,38709,2106
13095,GA,Dougherty,,2019,4.8,35934,37755,1821
13095,GA,Dougherty,,2020,8.6,34250,37482,3232
13095,GA,Dougherty,,2021,6.4,35110,37494,2384
13097,GA,Douglas,,2007,5.1,61488,64762,3274
13097,GA,Douglas,,2008,7,61546,66163,4617
13097,GA,Douglas,,2009,11.3,57878,65280,7402
13097,GA,Douglas,,2010,11.4,59181,66764,7583
13097,GA,Douglas,,2011,10.8,59644,66842,7198
13097,GA,Douglas,,2012,9.5,60426,66743,6317
13097,GA,Douglas,,2013,8.5,61482,67225,5743
13097,GA,Douglas,,2014,7.4,62550,67571,5021
13097,GA,Douglas,,2015,6.5,63209,67568,4359
13097,GA,Douglas,,2016,5.6,66273,70232,3959
13097,GA,Douglas,,2017,4.9,69159,72751,3592
13097,GA,Douglas,,2018,4.2,70001,73085,3084
13097,GA,Douglas,,2019,3.7,70570,73302,2732
13097,GA,Douglas,,2020,7.3,67092,72409,5317
13097,GA,Douglas,,2021,4.4,70771,74001,3230
13099,GA,Early,,2007,6.1,5010,5333,323
13099,GA,Early,,2008,7.2,5112,5508,396
13099,GA,Early,,2009,11,4916,5524,608
13099,GA,Early,,2010,11.9,3957,4491,534
13099,GA,Early,,2011,11.4,3934,4440,506
13099,GA,Early,,2012,10,4025,4472,447
13099,GA,Early,,2013,9.1,3972,4369,397
13099,GA,Early,,2014,9,3947,4337,390
13099,GA,Early,,2015,7.1,4005,4309,304
13099,GA,Early,,2016,7,4095,4401,306
13099,GA,Early,,2017,5.5,4326,4577,251
13099,GA,Early,,2018,4.7,4335,4547,212
13099,GA,Early,,2019,4.1,4211,4390,179
13099,GA,Early,,2020,5.7,4164,4418,254
13099,GA,Early,,2021,5,4121,4338,217
13101,GA,Echols,,2007,3.3,2170,2244,74
13101,GA,Echols,,2008,4.7,2104,2207,103
13101,GA,Echols,,2009,7.6,2036,2203,167
13101,GA,Echols,,2010,8.3,1724,1880,156
13101,GA,Echols,,2011,8,1725,1875,150
13101,GA,Echols,,2012,7.3,1670,1801,131
13101,GA,Echols,,2013,6.3,1666,1778,112
13101,GA,Echols,,2014,5.9,1676,1781,105
13101,GA,Echols,,2015,4.8,1756,1844,88
13101,GA,Echols,,2016,4.4,1800,1882,82
13101,GA,Echols,,2017,4,1847,1923,76
13101,GA,Echols,,2018,3.2,1861,1923,62
13101,GA,Echols,,2019,2.9,1859,1914,55
13101,GA,Echols,,2020,3.9,1808,1882,74
13101,GA,Echols,,2021,2.7,1845,1897,52
13103,GA,Effingham,,2007,3.6,27414,28436,1022
13103,GA,Effingham,,2008,5.2,27439,28952,1513
13103,GA,Effingham,,2009,8.6,26131,28604,2473
13103,GA,Effingham,,2010,9.7,23339,25849,2510
13103,GA,Effingham,,2011,9.2,23227,25592,2365
13103,GA,Effingham,,2012,8.2,23739,25871,2132
13103,GA,Effingham,,2013,7.1,24286,26146,1860
13103,GA,Effingham,,2014,6.2,24587,26223,1636
13103,GA,Effingham,,2015,5.2,25458,26854,1396
13103,GA,Effingham,,2016,4.9,27025,28415,1390
13103,GA,Effingham,,2017,4.1,28534,29747,1213
13103,GA,Effingham,,2018,3.3,30003,31029,1026
13103,GA,Effingham,,2019,3,31320,32274,954
13103,GA,Effingham,,2020,4.9,30316,31877,1561
13103,GA,Effingham,,2021,2.9,32292,33266,974
13105,GA,Elbert,,2007,6.2,9254,9861,607
13105,GA,Elbert,,2008,9,9165,10073,908
13105,GA,Elbert,,2009,12.8,8777,10067,1290
13105,GA,Elbert,,2010,15,7615,8963,1348
13105,GA,Elbert,,2011,16,7370,8772,1402
13105,GA,Elbert,,2012,12.4,7466,8522,1056
13105,GA,Elbert,,2013,10.8,7458,8357,899
13105,GA,Elbert,,2014,8.7,7359,8056,697
13105,GA,Elbert,,2015,7.6,6960,7529,569
13105,GA,Elbert,,2016,6.6,7223,7730,507
13105,GA,Elbert,,2017,5.3,7517,7937,420
13105,GA,Elbert,,2018,4.9,7472,7854,382
13105,GA,Elbert,,2019,4.1,7541,7861,320
13105,GA,Elbert,,2020,6.9,7386,7931,545
13105,GA,Elbert,,2021,4.9,7429,7810,381
13107,GA,Emanuel,,2007,5.6,10216,10821,605
13107,GA,Emanuel,,2008,8,9919,10779,860
13107,GA,Emanuel,,2009,11.2,9397,10582,1185
13107,GA,Emanuel,,2010,13,7956,9147,1191
13107,GA,Emanuel,,2011,13.2,7936,9147,1211
13107,GA,Emanuel,,2012,12.2,7951,9057,1106
13107,GA,Emanuel,,2013,12.5,7732,8832,1100
13107,GA,Emanuel,,2014,10.5,7673,8573,900
13107,GA,Emanuel,,2015,8.9,7495,8227,732
13107,GA,Emanuel,,2016,7.8,7786,8448,662
13107,GA,Emanuel,,2017,6.7,8094,8679,585
13107,GA,Emanuel,,2018,6,7852,8352,500
13107,GA,Emanuel,,2019,5.5,7966,8429,463
13107,GA,Emanuel,,2020,7,7971,8568,597
13107,GA,Emanuel,,2021,5.3,8240,8698,458
13109,GA,Evans,,2007,4.7,4745,4977,232
13109,GA,Evans,,2008,6.8,4665,5006,341
13109,GA,Evans,,2009,9.2,4504,4959,455
13109,GA,Evans,,2010,9.2,4341,4781,440
13109,GA,Evans,,2011,9.1,4365,4800,435
13109,GA,Evans,,2012,8.4,4384,4787,403
13109,GA,Evans,,2013,7.6,4364,4721,357
13109,GA,Evans,,2014,6.5,4423,4729,306
13109,GA,Evans,,2015,5.7,4348,4610,262
13109,GA,Evans,,2016,5,4550,4788,238
13109,GA,Evans,,2017,4.4,4720,4937,217
13109,GA,Evans,,2018,3.7,4736,4920,184
13109,GA,Evans,,2019,3.5,4777,4950,173
13109,GA,Evans,,2020,5.1,4751,5008,257
13109,GA,Evans,,2021,3.5,4998,5179,181
13111,GA,Fannin,,2007,4.1,10532,10979,447
13111,GA,Fannin,,2008,6.8,10185,10923,738
13111,GA,Fannin,,2009,11,9634,10825,1191
13111,GA,Fannin,,2010,11.8,9082,10301,1219
13111,GA,Fannin,,2011,11.2,9103,10252,1149
13111,GA,Fannin,,2012,10.1,8977,9982,1005
13111,GA,Fannin,,2013,8.9,8878,9750,872
13111,GA,Fannin,,2014,7.6,9090,9840,750
13111,GA,Fannin,,2015,6.3,9369,9999,630
13111,GA,Fannin,,2016,5.4,10242,10829,587
13111,GA,Fannin,,2017,4.8,10553,11088,535
13111,GA,Fannin,,2018,4,10865,11321,456
13111,GA,Fannin,,2019,3.5,11103,11505,402
13111,GA,Fannin,,2020,4.7,10608,11132,524
13111,GA,Fannin,,2021,2.8,11463,11797,334
13113,GA,Fayette,,2007,4.2,51233,53459,2226
13113,GA,Fayette,,2008,5.7,50054,53063,3009
13113,GA,Fayette,,2009,8.8,46569,51085,4516
13113,GA,Fayette,,2010,8.4,48624,53058,4434
13113,GA,Fayette,,2011,7.9,48908,53127,4219
13113,GA,Fayette,,2012,7.4,49359,53324,3965
13113,GA,Fayette,,2013,6.7,49791,53343,3552
13113,GA,Fayette,,2014,6.1,50386,53669,3283
13113,GA,Fayette,,2015,5.3,50712,53538,2826
13113,GA,Fayette,,2016,4.8,53051,55712,2661
13113,GA,Fayette,,2017,4.1,55167,57532,2365
13113,GA,Fayette,,2018,3.5,55732,57777,2045
13113,GA,Fayette,,2019,3.1,56284,58109,1825
13113,GA,Fayette,,2020,5.3,53572,56597,3025
13113,GA,Fayette,,2021,2.9,56475,58170,1695
13115,GA,Floyd,,2007,5.1,47198,49742,2544
13115,GA,Floyd,,2008,7,46663,50172,3509
13115,GA,Floyd,,2009,11.1,44106,49588,5482
13115,GA,Floyd,,2010,12,39799,45235,5436
13115,GA,Floyd,,2011,12,39398,44760,5362
13115,GA,Floyd,,2012,10.8,39833,44642,4809
13115,GA,Floyd,,2013,9.4,39586,43712,4126
13115,GA,Floyd,,2014,7.9,39787,43217,3430
13115,GA,Floyd,,2015,6.8,39611,42497,2886
13115,GA,Floyd,,2016,6.1,40856,43503,2647
13115,GA,Floyd,,2017,5.3,42301,44645,2344
13115,GA,Floyd,,2018,4.3,42570,44504,1934
13115,GA,Floyd,,2019,4,42415,44200,1785
13115,GA,Floyd,,2020,6.2,40440,43126,2686
13115,GA,Floyd,,2021,3.7,42277,43891,1614
13117,GA,Forsyth,,2007,3.6,81089,84108,3019
13117,GA,Forsyth,,2008,5.2,83529,88105,4576
13117,GA,Forsyth,,2009,8.6,80459,87994,7535
13117,GA,Forsyth,,2010,8.1,81352,88550,7198
13117,GA,Forsyth,,2011,7.3,84225,90893,6668
13117,GA,Forsyth,,2012,6.5,87366,93459,6093
13117,GA,Forsyth,,2013,5.8,90753,96381,5628
13117,GA,Forsyth,,2014,5.3,94927,100209,5282
13117,GA,Forsyth,,2015,4.6,98435,103197,4762
13117,GA,Forsyth,,2016,4.2,106296,110988,4692
13117,GA,Forsyth,,2017,3.8,113136,117589,4453
13117,GA,Forsyth,,2018,3.2,117661,121554,3893
13117,GA,Forsyth,,2019,2.9,121604,125208,3604
13117,GA,Forsyth,,2020,4.5,117458,122975,5517
13117,GA,Forsyth,,2021,2.5,123874,127031,3157
13119,GA,Franklin,,2007,5.3,9886,10441,555
13119,GA,Franklin,,2008,7.6,9648,10437,789
13119,GA,Franklin,,2009,12.4,9002,10281,1279
13119,GA,Franklin,,2010,12.9,8478,9730,1252
13119,GA,Franklin,,2011,12,8557,9728,1171
13119,GA,Franklin,,2012,11.1,8449,9506,1057
13119,GA,Franklin,,2013,9.7,8414,9318,904
13119,GA,Franklin,,2014,8.2,8483,9236,753
13119,GA,Franklin,,2015,6.4,8594,9180,586
13119,GA,Franklin,,2016,5.3,9269,9788,519
13119,GA,Franklin,,2017,4.8,9688,10178,490
13119,GA,Franklin,,2018,3.9,9662,10053,391
13119,GA,Franklin,,2019,3.6,9842,10214,372
13119,GA,Franklin,,2020,5.8,9315,9892,577
13119,GA,Franklin,,2021,3.7,9740,10111,371
13121,GA,Fulton,,2007,5.2,462945,488450,25505
13121,GA,Fulton,,2008,7,461289,495844,34555
13121,GA,Fulton,,2009,10.6,435814,487473,51659
13121,GA,Fulton,,2010,10.6,434852,486278,51426
13121,GA,Fulton,,2011,10.1,447564,497801,50237
13121,GA,Fulton,,2012,9,463742,509382,45640
13121,GA,Fulton,,2013,8,466867,507565,40698
13121,GA,Fulton,,2014,7.1,472618,508619,36001
13121,GA,Fulton,,2015,6.1,477884,508815,30931
13121,GA,Fulton,,2016,5.5,502170,531124,28954
13121,GA,Fulton,,2017,4.9,527208,554157,26949
13121,GA,Fulton,,2018,4.1,532702,555510,22808
13121,GA,Fulton,,2019,3.7,540379,560936,20557
13121,GA,Fulton,,2020,7.9,514565,558764,44199
13121,GA,Fulton,,2021,4.7,542664,569144,26480
13123,GA,Gilmer,,2007,3.9,13643,14192,549
13123,GA,Gilmer,,2008,6.3,13172,14065,893
13123,GA,Gilmer,,2009,10.9,12152,13636,1484
13123,GA,Gilmer,,2010,11.4,11380,12848,1468
13123,GA,Gilmer,,2011,11.7,10905,12343,1438
13123,GA,Gilmer,,2012,10.4,10852,12112,1260
13123,GA,Gilmer,,2013,8.9,10829,11891,1062
13123,GA,Gilmer,,2014,7.3,11075,11946,871
13123,GA,Gilmer,,2015,6.1,10877,11589,712
13123,GA,Gilmer,,2016,5.8,11152,11833,681
13123,GA,Gilmer,,2017,5.1,11509,12125,616
13123,GA,Gilmer,,2018,4.3,11511,12023,512
13123,GA,Gilmer,,2019,3.7,11602,12043,441
13123,GA,Gilmer,,2020,4.7,11460,12019,559
13123,GA,Gilmer,,2021,3,11969,12343,374
13125,GA,Glascock,,2007,5.5,1056,1118,62
13125,GA,Glascock,,2008,7.4,1044,1127,83
13125,GA,Glascock,,2009,12,999,1135,136
13125,GA,Glascock,,2010,11.2,1179,1328,149
13125,GA,Glascock,,2011,10.6,1192,1333,141
13125,GA,Glascock,,2012,9.6,1192,1318,126
13125,GA,Glascock,,2013,9.4,1167,1288,121
13125,GA,Glascock,,2014,8.1,1162,1264,102
13125,GA,Glascock,,2015,6.7,1137,1219,82
13125,GA,Glascock,,2016,6.1,1191,1268,77
13125,GA,Glascock,,2017,5,1246,1312,66
13125,GA,Glascock,,2018,4.2,1237,1291,54
13125,GA,Glascock,,2019,3.8,1229,1278,49
13125,GA,Glascock,,2020,4,1196,1246,50
13125,GA,Glascock,,2021,2.6,1230,1263,33
13127,GA,Glynn,,2007,3.9,39067,40654,1587
13127,GA,Glynn,,2008,5.5,39055,41315,2260
13127,GA,Glynn,,2009,8.9,36839,40424,3585
13127,GA,Glynn,,2010,10.1,34551,38450,3899
13127,GA,Glynn,,2011,10.3,34231,38179,3948
13127,GA,Glynn,,2012,9.3,35044,38656,3612
13127,GA,Glynn,,2013,8.5,34797,38010,3213
13127,GA,Glynn,,2014,7.5,34255,37028,2773
13127,GA,Glynn,,2015,6.2,34962,37264,2302
13127,GA,Glynn,,2016,5.4,37071,39177,2106
13127,GA,Glynn,,2017,4.8,38282,40196,1914
13127,GA,Glynn,,2018,3.7,38556,40057,1501
13127,GA,Glynn,,2019,3.5,37488,38862,1374
13127,GA,Glynn,,2020,6.7,35722,38295,2573
13127,GA,Glynn,,2021,3.8,37727,39201,1474
13129,GA,Gordon,,2007,5.1,25463,26832,1369
13129,GA,Gordon,,2008,8,24452,26582,2130
13129,GA,Gordon,,2009,13.6,22092,25563,3471
13129,GA,Gordon,,2010,12.9,22777,26145,3368
13129,GA,Gordon,,2011,11.6,23174,26207,3033
13129,GA,Gordon,,2012,9.6,24167,26748,2581
13129,GA,Gordon,,2013,8.8,23859,26160,2301
13129,GA,Gordon,,2014,7.3,24131,26035,1904
13129,GA,Gordon,,2015,6,24302,25856,1554
13129,GA,Gordon,,2016,5.7,23865,25300,1435
13129,GA,Gordon,,2017,4.7,25675,26929,1254
13129,GA,Gordon,,2018,3.9,26503,27582,1079
13129,GA,Gordon,,2019,3.5,27505,28513,1008
13129,GA,Gordon,,2020,5.4,26579,28096,1517
13129,GA,Gordon,,2021,3.2,27923,28846,923
13131,GA,Grady,,2007,4.4,11717,12251,534
13131,GA,Grady,,2008,6.5,11178,11954,776
13131,GA,Grady,,2009,10.2,10575,11774,1199
13131,GA,Grady,,2010,10.6,9320,10427,1107
13131,GA,Grady,,2011,9.5,9807,10831,1024
13131,GA,Grady,,2012,8.5,9882,10797,915
13131,GA,Grady,,2013,7.7,9666,10470,804
13131,GA,Grady,,2014,7.4,9669,10437,768
13131,GA,Grady,,2015,6.1,9673,10304,631
13131,GA,Grady,,2016,5.5,9685,10250,565
13131,GA,Grady,,2017,4.9,10319,10852,533
13131,GA,Grady,,2018,3.9,10259,10675,416
13131,GA,Grady,,2019,3.5,10304,10677,373
13131,GA,Grady,,2020,4.3,10160,10622,462
13131,GA,Grady,,2021,3.1,10695,11040,345
13133,GA,Greene,,2007,5.8,7023,7454,431
13133,GA,Greene,,2008,7.3,7045,7603,558
13133,GA,Greene,,2009,11.9,6697,7601,904
13133,GA,Greene,,2010,13.3,5574,6432,858
13133,GA,Greene,,2011,12.2,5586,6365,779
13133,GA,Greene,,2012,10.9,5697,6396,699
13133,GA,Greene,,2013,9.9,5718,6343,625
13133,GA,Greene,,2014,8.2,5888,6416,528
13133,GA,Greene,,2015,6.7,6296,6751,455
13133,GA,Greene,,2016,6.1,6200,6605,405
13133,GA,Greene,,2017,5.2,6538,6897,359
13133,GA,Greene,,2018,4.3,6752,7059,307
13133,GA,Greene,,2019,4,7022,7314,292
13133,GA,Greene,,2020,5.8,6774,7190,416
13133,GA,Greene,,2021,3.7,6961,7231,270
13135,GA,Gwinnett,,2007,4.3,402362,420498,18136
13135,GA,Gwinnett,,2008,6.1,398541,424217,25676
13135,GA,Gwinnett,,2009,9.4,378416,417812,39396
13135,GA,Gwinnett,,2010,9.4,380264,419533,39269
13135,GA,Gwinnett,,2011,8.6,389527,426386,36859
13135,GA,Gwinnett,,2012,7.6,399656,432720,33064
13135,GA,Gwinnett,,2013,6.8,407841,437728,29887
13135,GA,Gwinnett,,2014,6.1,416686,443651,26965
13135,GA,Gwinnett,,2015,5.3,423631,447227,23596
13135,GA,Gwinnett,,2016,4.8,445147,467734,22587
13135,GA,Gwinnett,,2017,4.3,465984,486776,20792
13135,GA,Gwinnett,,2018,3.6,470734,488189,17455
13135,GA,Gwinnett,,2019,3.2,475438,491076,15638
13135,GA,Gwinnett,,2020,6.3,450036,480249,30213
13135,GA,Gwinnett,,2021,3.5,475000,492181,17181
13137,GA,Habersham,,2007,4.3,19313,20184,871
13137,GA,Habersham,,2008,6.2,19491,20775,1284
13137,GA,Habersham,,2009,10.5,18138,20263,2125
13137,GA,Habersham,,2010,10.8,16410,18396,1986
13137,GA,Habersham,,2011,10.4,16393,18297,1904
13137,GA,Habersham,,2012,9.4,16639,18359,1720
13137,GA,Habersham,,2013,8,17756,19292,1536
13137,GA,Habersham,,2014,7,17617,18941,1324
13137,GA,Habersham,,2015,5.8,17519,18602,1083
13137,GA,Habersham,,2016,5.4,18268,19302,1034
13137,GA,Habersham,,2017,4.6,18595,19492,897
13137,GA,Habersham,,2018,3.8,18734,19471,737
13137,GA,Habersham,,2019,3.5,18784,19474,690
13137,GA,Habersham,,2020,5.4,17713,18721,1008
13137,GA,Habersham,,2021,3.6,17930,18592,662
13139,GA,Hall,,2007,3.9,87050,90583,3533
13139,GA,Hall,,2008,5.9,87307,92736,5429
13139,GA,Hall,,2009,9.8,80925,89747,8822
13139,GA,Hall,,2010,9.8,78302,86778,8476
13139,GA,Hall,,2011,8.8,79868,87580,7712
13139,GA,Hall,,2012,7.7,82015,88828,6813
13139,GA,Hall,,2013,6.8,83308,89392,6084
13139,GA,Hall,,2014,5.9,84604,89924,5320
13139,GA,Hall,,2015,4.9,87171,91705,4534
13139,GA,Hall,,2016,4.6,91917,96308,4391
13139,GA,Hall,,2017,3.9,97352,101342,3990
13139,GA,Hall,,2018,3.2,99022,102344,3322
13139,GA,Hall,,2019,2.9,99859,102878,3019
13139,GA,Hall,,2020,4.7,97547,102326,4779
13139,GA,Hall,,2021,2.7,102000,104792,2792
13141,GA,Hancock,,2007,9.1,3011,3312,301
13141,GA,Hancock,,2008,14,2898,3370,472
13141,GA,Hancock,,2009,20.4,2633,3309,676
13141,GA,Hancock,,2010,23.2,2396,3119,723
13141,GA,Hancock,,2011,19.6,2372,2952,580
13141,GA,Hancock,,2012,16.8,2285,2745,460
13141,GA,Hancock,,2013,14.6,2252,2637,385
13141,GA,Hancock,,2014,11.7,2224,2520,296
13141,GA,Hancock,,2015,10,2216,2461,245
13141,GA,Hancock,,2016,8.5,2317,2532,215
13141,GA,Hancock,,2017,7.1,2372,2554,182
13141,GA,Hancock,,2018,6,2326,2475,149
13141,GA,Hancock,,2019,5.8,2372,2518,146
13141,GA,Hancock,,2020,8.8,2317,2540,223
13141,GA,Hancock,,2021,6.4,2369,2530,161
13143,GA,Haralson,,2007,5.1,12205,12859,654
13143,GA,Haralson,,2008,7.1,11995,12912,917
13143,GA,Haralson,,2009,12.6,11093,12692,1599
13143,GA,Haralson,,2010,12.4,10879,12422,1543
13143,GA,Haralson,,2011,11.5,10822,12233,1411
13143,GA,Haralson,,2012,10.1,10841,12058,1217
13143,GA,Haralson,,2013,9.2,10851,11952,1101
13143,GA,Haralson,,2014,8,10912,11856,944
13143,GA,Haralson,,2015,6.7,10955,11736,781
13143,GA,Haralson,,2016,5.9,11445,12159,714
13143,GA,Haralson,,2017,4.8,11901,12504,603
13143,GA,Haralson,,2018,3.9,12038,12527,489
13143,GA,Haralson,,2019,3.5,12151,12591,440
13143,GA,Haralson,,2020,5.8,11651,12369,718
13143,GA,Haralson,,2021,3.5,12303,12750,447
13145,GA,Harris,,2007,3.9,15408,16032,624
13145,GA,Harris,,2008,5.1,15521,16352,831
13145,GA,Harris,,2009,7.6,15148,16398,1250
13145,GA,Harris,,2010,7.8,15168,16454,1286
13145,GA,Harris,,2011,7.3,15168,16370,1202
13145,GA,Harris,,2012,7.1,15072,16223,1151
13145,GA,Harris,,2013,6.5,14766,15792,1026
13145,GA,Harris,,2014,6,14758,15700,942
13145,GA,Harris,,2015,5.3,14692,15520,828
13145,GA,Harris,,2016,4.9,15271,16066,795
13145,GA,Harris,,2017,4.2,16103,16807,704
13145,GA,Harris,,2018,3.4,16334,16917,583
13145,GA,Harris,,2019,3.2,16409,16949,540
13145,GA,Harris,,2020,4.5,16087,16845,758
13145,GA,Harris,,2021,2.9,16397,16881,484
13147,GA,Hart,,2007,7,10078,10841,763
13147,GA,Hart,,2008,9.5,9678,10692,1014
13147,GA,Hart,,2009,14.1,9011,10488,1477
13147,GA,Hart,,2010,11.7,9709,10990,1281
13147,GA,Hart,,2011,11.1,9887,11120,1233
13147,GA,Hart,,2012,10.1,9690,10783,1093
13147,GA,Hart,,2013,9.1,9527,10485,958
13147,GA,Hart,,2014,7.5,9588,10369,781
13147,GA,Hart,,2015,6.3,9635,10284,649
13147,GA,Hart,,2016,5.4,10414,11013,599
13147,GA,Hart,,2017,4.5,10851,11359,508
13147,GA,Hart,,2018,3.7,11320,11753,433
13147,GA,Hart,,2019,3.6,11198,11620,422
13147,GA,Hart,,2020,5.4,10719,11329,610
13147,GA,Hart,,2021,3.9,11184,11640,456
13149,GA,Heard,,2007,5.4,4632,4898,266
13149,GA,Heard,,2008,8.2,4547,4951,404
13149,GA,Heard,,2009,13.6,4236,4905,669
13149,GA,Heard,,2010,12.2,4621,5265,644
13149,GA,Heard,,2011,11.2,4579,5157,578
13149,GA,Heard,,2012,10.2,4584,5103,519
13149,GA,Heard,,2013,9.4,4536,5004,468
13149,GA,Heard,,2014,7.9,4565,4959,394
13149,GA,Heard,,2015,6.5,4539,4856,317
13149,GA,Heard,,2016,6,4697,4996,299
13149,GA,Heard,,2017,5,4956,5218,262
13149,GA,Heard,,2018,3.9,5027,5233,206
13149,GA,Heard,,2019,3.5,5052,5234,182
13149,GA,Heard,,2020,6.4,4778,5107,329
13149,GA,Heard,,2021,3.9,5036,5239,203
13151,GA,Henry,,2007,4.7,92215,96781,4566
13151,GA,Henry,,2008,6.6,92461,99010,6549
13151,GA,Henry,,2009,10.2,87496,97451,9955
13151,GA,Henry,,2010,10.5,90799,101410,10611
13151,GA,Henry,,2011,10.2,91988,102488,10500
13151,GA,Henry,,2012,9.3,93325,102845,9520
13151,GA,Henry,,2013,8.4,94630,103297,8667
13151,GA,Henry,,2014,7.3,95844,103372,7528
13151,GA,Henry,,2015,6.3,97333,103843,6510
13151,GA,Henry,,2016,5.6,102845,108917,6072
13151,GA,Henry,,2017,4.9,107957,113509,5552
13151,GA,Henry,,2018,4.2,110310,115136,4826
13151,GA,Henry,,2019,3.7,112605,116961,4356
13151,GA,Henry,,2020,7.3,107965,116410,8445
13151,GA,Henry,,2021,4.2,113693,118685,4992
13153,GA,Houston,,2007,4.2,65336,68198,2862
13153,GA,Houston,,2008,5.6,65760,69693,3933
13153,GA,Houston,,2009,7.6,65411,70754,5343
13153,GA,Houston,,2010,8.6,61498,67259,5761
13153,GA,Houston,,2011,8.5,62446,68223,5777
13153,GA,Houston,,2012,7.9,63085,68515,5430
13153,GA,Houston,,2013,7.5,62345,67381,5036
13153,GA,Houston,,2014,6.8,61332,65831,4499
13153,GA,Houston,,2015,5.9,61086,64936,3850
13153,GA,Houston,,2016,5.4,64005,67671,3666
13153,GA,Houston,,2017,4.8,66524,69853,3329
13153,GA,Houston,,2018,4.1,67520,70389,2869
13153,GA,Houston,,2019,3.5,68789,71274,2485
13153,GA,Houston,,2020,5.2,66812,70486,3674
13153,GA,Houston,,2021,3.6,69142,71710,2568
13155,GA,Irwin,,2007,6.5,4026,4307,281
13155,GA,Irwin,,2008,10.7,3782,4236,454
13155,GA,Irwin,,2009,15.8,3440,4085,645
13155,GA,Irwin,,2010,14.9,3139,3687,548
13155,GA,Irwin,,2011,13.6,3051,3532,481
13155,GA,Irwin,,2012,11.6,3121,3529,408
13155,GA,Irwin,,2013,10.5,3011,3366,355
13155,GA,Irwin,,2014,9.6,2838,3138,300
13155,GA,Irwin,,2015,8.5,2836,3100,264
13155,GA,Irwin,,2016,7.9,2964,3219,255
13155,GA,Irwin,,2017,7.1,3080,3314,234
13155,GA,Irwin,,2018,5.7,3141,3331,190
13155,GA,Irwin,,2019,4.8,3244,3407,163
13155,GA,Irwin,,2020,5.6,3289,3484,195
13155,GA,Irwin,,2021,4.5,3407,3568,161
13157,GA,Jackson,,2007,4.5,25713,26924,1211
13157,GA,Jackson,,2008,6.7,25747,27603,1856
13157,GA,Jackson,,2009,11.6,23947,27098,3151
13157,GA,Jackson,,2010,10.6,25692,28732,3040
13157,GA,Jackson,,2011,9.5,26108,28848,2740
13157,GA,Jackson,,2012,8.1,26941,29313,2372
13157,GA,Jackson,,2013,6.9,27538,29565,2027
13157,GA,Jackson,,2014,5.9,28017,29767,1750
13157,GA,Jackson,,2015,4.9,28890,30386,1496
13157,GA,Jackson,,2016,4.3,31852,33289,1437
13157,GA,Jackson,,2017,3.7,34315,35635,1320
13157,GA,Jackson,,2018,3.1,35325,36462,1137
13157,GA,Jackson,,2019,2.8,36743,37798,1055
13157,GA,Jackson,,2020,4.3,38323,40061,1738
13157,GA,Jackson,,2021,2.4,41787,42806,1019
13159,GA,Jasper,,2007,5.2,6096,6431,335
13159,GA,Jasper,,2008,8.9,6017,6607,590
13159,GA,Jasper,,2009,13.1,5626,6476,850
13159,GA,Jasper,,2010,11.8,6077,6893,816
13159,GA,Jasper,,2011,10.9,6041,6781,740
13159,GA,Jasper,,2012,9.6,6001,6641,640
13159,GA,Jasper,,2013,8.2,5971,6506,535
13159,GA,Jasper,,2014,6.7,5918,6341,423
13159,GA,Jasper,,2015,5.6,6010,6367,357
13159,GA,Jasper,,2016,4.8,6262,6581,319
13159,GA,Jasper,,2017,4.3,6621,6922,301
13159,GA,Jasper,,2018,3.6,6666,6912,246
13159,GA,Jasper,,2019,3.3,6759,6987,228
13159,GA,Jasper,,2020,4.9,6487,6818,331
13159,GA,Jasper,,2021,3.2,6838,7065,227
13161,GA,Jeff Davis,,2007,7.3,4884,5271,387
13161,GA,Jeff Davis,,2008,10.5,4752,5312,560
13161,GA,Jeff Davis,,2009,14.4,4599,5374,775
13161,GA,Jeff Davis,,2010,12.9,5564,6390,826
13161,GA,Jeff Davis,,2011,12.5,5686,6496,810
13161,GA,Jeff Davis,,2012,11.4,5634,6357,723
13161,GA,Jeff Davis,,2013,9.9,5745,6374,629
13161,GA,Jeff Davis,,2014,8.2,5863,6387,524
13161,GA,Jeff Davis,,2015,6.8,5847,6272,425
13161,GA,Jeff Davis,,2016,6.4,5825,6226,401
13161,GA,Jeff Davis,,2017,6.1,5813,6190,377
13161,GA,Jeff Davis,,2018,4.9,5796,6095,299
13161,GA,Jeff Davis,,2019,4.7,5902,6195,293
13161,GA,Jeff Davis,,2020,5.1,5820,6133,313
13161,GA,Jeff Davis,,2021,4,5858,6100,242
13163,GA,Jefferson,,2007,7.7,6560,7107,547
13163,GA,Jefferson,,2008,10.6,6419,7179,760
13163,GA,Jefferson,,2009,15.1,6052,7131,1079
13163,GA,Jefferson,,2010,14.2,6159,7181,1022
13163,GA,Jefferson,,2011,13.1,6171,7104,933
13163,GA,Jefferson,,2012,13,6136,7055,919
13163,GA,Jefferson,,2013,13.9,5881,6830,949
13163,GA,Jefferson,,2014,11.3,5893,6644,751
13163,GA,Jefferson,,2015,9.2,5719,6298,579
13163,GA,Jefferson,,2016,7.5,6106,6599,493
13163,GA,Jefferson,,2017,6.2,6389,6813,424
13163,GA,Jefferson,,2018,5.4,6368,6730,362
13163,GA,Jefferson,,2019,4.9,6316,6644,328
13163,GA,Jefferson,,2020,6.7,6227,6674,447
13163,GA,Jefferson,,2021,4.7,6652,6979,327
13165,GA,Jenkins,,2007,9.6,3019,3338,319
13165,GA,Jenkins,,2008,16.9,2393,2878,485
13165,GA,Jenkins,,2009,20.4,2182,2740,558
13165,GA,Jenkins,,2010,15.4,2741,3239,498
13165,GA,Jenkins,,2011,14.2,2743,3198,455
13165,GA,Jenkins,,2012,13.6,2896,3350,454
13165,GA,Jenkins,,2013,12.3,2911,3318,407
13165,GA,Jenkins,,2014,10,2930,3256,326
13165,GA,Jenkins,,2015,8.5,2811,3071,260
13165,GA,Jenkins,,2016,7.7,2921,3163,242
13165,GA,Jenkins,,2017,6.8,2979,3196,217
13165,GA,Jenkins,,2018,5.4,3017,3190,173
13165,GA,Jenkins,,2019,5.3,3044,3213,169
13165,GA,Jenkins,,2020,6.3,2988,3189,201
13165,GA,Jenkins,,2021,4.7,3066,3217,151
13167,GA,Johnson,,2007,6.4,3493,3730,237
13167,GA,Johnson,,2008,8.6,3389,3709,320
13167,GA,Johnson,,2009,13.1,3086,3551,465
13167,GA,Johnson,,2010,10.9,3786,4251,465
13167,GA,Johnson,,2011,10.9,3699,4153,454
13167,GA,Johnson,,2012,9.8,3652,4050,398
13167,GA,Johnson,,2013,9.8,3604,3994,390
13167,GA,Johnson,,2014,8.6,3591,3930,339
13167,GA,Johnson,,2015,7.1,3556,3829,273
13167,GA,Johnson,,2016,6.2,3683,3925,242
13167,GA,Johnson,,2017,5.1,3929,4140,211
13167,GA,Johnson,,2018,4,3944,4107,163
13167,GA,Johnson,,2019,3.8,3925,4080,155
13167,GA,Johnson,,2020,4.9,3805,4001,196
13167,GA,Johnson,,2021,3.5,4003,4150,147
13169,GA,Jones,,2007,4.6,13389,14034,645
13169,GA,Jones,,2008,6.2,13613,14518,905
13169,GA,Jones,,2009,9,13037,14324,1287
13169,GA,Jones,,2010,9.8,12381,13732,1351
13169,GA,Jones,,2011,9.1,12530,13787,1257
13169,GA,Jones,,2012,8.4,12674,13830,1156
13169,GA,Jones,,2013,7.2,12610,13592,982
13169,GA,Jones,,2014,6.3,12804,13671,867
13169,GA,Jones,,2015,5.6,12574,13322,748
13169,GA,Jones,,2016,4.9,13121,13792,671
13169,GA,Jones,,2017,4.4,13457,14071,614
13169,GA,Jones,,2018,3.7,13430,13946,516
13169,GA,Jones,,2019,3.3,13311,13768,457
13169,GA,Jones,,2020,4.5,12761,13365,604
13169,GA,Jones,,2021,3.1,13224,13642,418
13171,GA,Lamar,,2007,5.5,7487,7919,432
13171,GA,Lamar,,2008,8,7310,7945,635
13171,GA,Lamar,,2009,14.2,7000,8157,1157
13171,GA,Lamar,,2010,14.4,7006,8185,1179
13171,GA,Lamar,,2011,13.6,6995,8097,1102
13171,GA,Lamar,,2012,11.9,6991,7936,945
13171,GA,Lamar,,2013,11.2,6934,7810,876
13171,GA,Lamar,,2014,9.6,7032,7778,746
13171,GA,Lamar,,2015,7.8,7003,7597,594
13171,GA,Lamar,,2016,6.6,7375,7900,525
13171,GA,Lamar,,2017,5.6,7668,8127,459
13171,GA,Lamar,,2018,4.7,7848,8234,386
13171,GA,Lamar,,2019,4.1,7883,8216,333
13171,GA,Lamar,,2020,6.3,7483,7984,501
13171,GA,Lamar,,2021,4.2,7904,8249,345
13173,GA,Lanier,,2007,4,3881,4044,163
13173,GA,Lanier,,2008,6.3,3947,4211,264
13173,GA,Lanier,,2009,9.5,3748,4142,394
13173,GA,Lanier,,2010,10.7,3468,3885,417
13173,GA,Lanier,,2011,10.4,3533,3944,411
13173,GA,Lanier,,2012,9.2,3537,3896,359
13173,GA,Lanier,,2013,8.5,3511,3837,326
13173,GA,Lanier,,2014,8.1,3480,3787,307
13173,GA,Lanier,,2015,6.8,3486,3740,254
13173,GA,Lanier,,2016,5.9,3604,3828,224
13173,GA,Lanier,,2017,5.1,3684,3884,200
13173,GA,Lanier,,2018,4.5,3630,3802,172
13173,GA,Lanier,,2019,4.1,3628,3785,157
13173,GA,Lanier,,2020,5.2,3602,3801,199
13173,GA,Lanier,,2021,3.8,3703,3850,147
13175,GA,Laurens,,2007,5.5,21191,22413,1222
13175,GA,Laurens,,2008,7.7,20665,22384,1719
13175,GA,Laurens,,2009,11.7,19504,22096,2592
13175,GA,Laurens,,2010,13.4,17901,20664,2763
13175,GA,Laurens,,2011,13.7,17475,20258,2783
13175,GA,Laurens,,2012,12.1,17338,19721,2383
13175,GA,Laurens,,2013,10.7,17319,19395,2076
13175,GA,Laurens,,2014,9.3,17244,19004,1760
13175,GA,Laurens,,2015,7.7,17018,18434,1416
13175,GA,Laurens,,2016,6.7,17781,19066,1285
13175,GA,Laurens,,2017,5.9,18315,19469,1154
13175,GA,Laurens,,2018,4.9,18552,19501,949
13175,GA,Laurens,,2019,4.7,18664,19590,926
13175,GA,Laurens,,2020,6.6,18000,19280,1280
13175,GA,Laurens,,2021,4.3,18974,19818,844
13177,GA,Lee,,2007,3.9,16952,17649,697
13177,GA,Lee,,2008,4.9,17108,17986,878
13177,GA,Lee,,2009,7.6,16791,18171,1380
13177,GA,Lee,,2010,9.2,13063,14382,1319
13177,GA,Lee,,2011,8.4,13105,14302,1197
13177,GA,Lee,,2012,7.5,13201,14277,1076
13177,GA,Lee,,2013,6.8,13304,14279,975
13177,GA,Lee,,2014,6.3,13237,14121,884
13177,GA,Lee,,2015,5.4,13211,13967,756
13177,GA,Lee,,2016,4.8,13865,14557,692
13177,GA,Lee,,2017,4.2,14555,15193,638
13177,GA,Lee,,2018,3.6,14304,14842,538
13177,GA,Lee,,2019,3.1,14677,15153,476
13177,GA,Lee,,2020,4.5,14343,15026,683
13177,GA,Lee,,2021,3.1,14707,15173,466
13179,GA,Liberty,,2007,5.7,22885,24257,1372
13179,GA,Liberty,,2008,6.5,23751,25389,1638
13179,GA,Liberty,,2009,8.9,23691,26006,2315
13179,GA,Liberty,,2010,9.2,24523,26999,2476
13179,GA,Liberty,,2011,9.2,24989,27536,2547
13179,GA,Liberty,,2012,8.8,24686,27061,2375
13179,GA,Liberty,,2013,8.4,23961,26166,2205
13179,GA,Liberty,,2014,7.7,23631,25594,1963
13179,GA,Liberty,,2015,6.4,23103,24690,1587
13179,GA,Liberty,,2016,5.9,23562,25047,1485
13179,GA,Liberty,,2017,5.2,24412,25749,1337
13179,GA,Liberty,,2018,4.3,24802,25924,1122
13179,GA,Liberty,,2019,3.9,24972,25996,1024
13179,GA,Liberty,,2020,6.2,24110,25708,1598
13179,GA,Liberty,,2021,4,25304,26349,1045
13181,GA,Lincoln,,2007,6.3,3598,3838,240
13181,GA,Lincoln,,2008,7.7,3601,3900,299
13181,GA,Lincoln,,2009,11.4,3461,3907,446
13181,GA,Lincoln,,2010,11.7,3261,3693,432
13181,GA,Lincoln,,2011,11.5,3212,3629,417
13181,GA,Lincoln,,2012,10.6,3150,3525,375
13181,GA,Lincoln,,2013,10,3103,3446,343
13181,GA,Lincoln,,2014,8.3,3054,3332,278
13181,GA,Lincoln,,2015,6.9,3099,3327,228
13181,GA,Lincoln,,2016,6,3271,3479,208
13181,GA,Lincoln,,2017,5.3,3414,3604,190
13181,GA,Lincoln,,2018,5,3429,3610,181
13181,GA,Lincoln,,2019,4,3413,3555,142
13181,GA,Lincoln,,2020,5.4,3320,3508,188
13181,GA,Lincoln,,2021,4,3415,3558,143
13183,GA,Long,,2007,4,5680,5917,237
13183,GA,Long,,2008,4.8,6178,6490,312
13183,GA,Long,,2009,6.9,6193,6649,456
13183,GA,Long,,2010,8.5,5713,6246,533
13183,GA,Long,,2011,8.8,5803,6364,561
13183,GA,Long,,2012,8.4,6067,6625,558
13183,GA,Long,,2013,8.1,6148,6688,540
13183,GA,Long,,2014,7.4,6192,6690,498
13183,GA,Long,,2015,6,6587,7005,418
13183,GA,Long,,2016,5.5,7018,7424,406
13183,GA,Long,,2017,4.9,7660,8053,393
13183,GA,Long,,2018,4,7746,8070,324
13183,GA,Long,,2019,3.8,8035,8353,318
13183,GA,Long,,2020,4.3,7828,8184,356
13183,GA,Long,,2021,3,8210,8467,257
13185,GA,Lowndes,,2007,4.2,51361,53602,2241
13185,GA,Lowndes,,2008,5.9,51528,54754,3226
13185,GA,Lowndes,,2009,8.9,49118,53914,4796
13185,GA,Lowndes,,2010,9.7,46177,51165,4988
13185,GA,Lowndes,,2011,9.8,46228,51276,5048
13185,GA,Lowndes,,2012,9,47580,52282,4702
13185,GA,Lowndes,,2013,8,46965,51035,4070
13185,GA,Lowndes,,2014,7.3,46786,50467,3681
13185,GA,Lowndes,,2015,6,46796,49790,2994
13185,GA,Lowndes,,2016,5.3,48569,51312,2743
13185,GA,Lowndes,,2017,4.7,49748,52197,2449
13185,GA,Lowndes,,2018,4.1,49772,51914,2142
13185,GA,Lowndes,,2019,3.7,49834,51738,1904
13185,GA,Lowndes,,2020,6,48386,51492,3106
13185,GA,Lowndes,,2021,4.1,49616,51719,2103
13187,GA,Lumpkin,,2007,4.5,12545,13134,589
13187,GA,Lumpkin,,2008,7.6,12410,13425,1015
13187,GA,Lumpkin,,2009,12.3,11691,13331,1640
13187,GA,Lumpkin,,2010,10.5,13200,14748,1548
13187,GA,Lumpkin,,2011,9.7,13415,14850,1435
13187,GA,Lumpkin,,2012,8.2,13882,15126,1244
13187,GA,Lumpkin,,2013,7.3,14015,15122,1107
13187,GA,Lumpkin,,2014,6.4,14260,15232,972
13187,GA,Lumpkin,,2015,5.5,14312,15145,833
13187,GA,Lumpkin,,2016,4.9,15199,15975,776
13187,GA,Lumpkin,,2017,4.2,16191,16898,707
13187,GA,Lumpkin,,2018,3.6,16154,16759,605
13187,GA,Lumpkin,,2019,3.3,16398,16960,562
13187,GA,Lumpkin,,2020,4.8,15770,16557,787
13187,GA,Lumpkin,,2021,2.8,16923,17402,479
13189,GA,McDuffie,,2007,6.8,9874,10600,726
13189,GA,McDuffie,,2008,8.5,9862,10774,912
13189,GA,McDuffie,,2009,12,9519,10811,1292
13189,GA,McDuffie,,2010,13.3,8214,9477,1263
13189,GA,McDuffie,,2011,13.2,8142,9384,1242
13189,GA,McDuffie,,2012,12.4,8137,9293,1156
13189,GA,McDuffie,,2013,11.2,8047,9065,1018
13189,GA,McDuffie,,2014,10,7906,8787,881
13189,GA,McDuffie,,2015,8.5,7954,8690,736
13189,GA,McDuffie,,2016,7.4,8150,8802,652
13189,GA,McDuffie,,2017,6.3,8417,8982,565
13189,GA,McDuffie,,2018,5.6,8441,8946,505
13189,GA,McDuffie,,2019,5.4,8295,8766,471
13189,GA,McDuffie,,2020,7.9,7877,8550,673
13189,GA,McDuffie,,2021,5.2,8107,8554,447
13191,GA,McIntosh,,2007,4.4,5151,5390,239
13191,GA,McIntosh,,2008,6.4,5100,5449,349
13191,GA,McIntosh,,2009,10.6,4720,5281,561
13191,GA,McIntosh,,2010,10.7,5632,6305,673
13191,GA,McIntosh,,2011,10.5,5525,6175,650
13191,GA,McIntosh,,2012,9.6,5433,6010,577
13191,GA,McIntosh,,2013,8.9,5395,5923,528
13191,GA,McIntosh,,2014,7.9,5395,5858,463
13191,GA,McIntosh,,2015,6.6,5373,5753,380
13191,GA,McIntosh,,2016,5.9,5649,6004,355
13191,GA,McIntosh,,2017,5.1,5881,6197,316
13191,GA,McIntosh,,2018,4,6017,6270,253
13191,GA,McIntosh,,2019,3.8,5878,6108,230
13191,GA,McIntosh,,2020,5.6,5611,5946,335
13191,GA,McIntosh,,2021,3.7,5904,6129,225
13193,GA,Macon,,2007,7.9,4694,5096,402
13193,GA,Macon,,2008,9.1,4678,5147,469
13193,GA,Macon,,2009,13,4531,5207,676
13193,GA,Macon,,2010,13.4,4677,5399,722
13193,GA,Macon,,2011,13.7,4545,5267,722
13193,GA,Macon,,2012,13.1,4476,5151,675
13193,GA,Macon,,2013,12.7,4327,4955,628
13193,GA,Macon,,2014,11.8,4173,4733,560
13193,GA,Macon,,2015,9.3,4140,4567,427
13193,GA,Macon,,2016,8.4,4289,4681,392
13193,GA,Macon,,2017,7,4431,4765,334
13193,GA,Macon,,2018,6.3,4416,4712,296
13193,GA,Macon,,2019,4.8,4504,4729,225
13193,GA,Macon,,2020,7.6,4300,4653,353
13193,GA,Macon,,2021,6.3,4389,4684,295
13195,GA,Madison,,2007,4,15166,15805,639
13195,GA,Madison,,2008,5.6,15341,16256,915
13195,GA,Madison,,2009,9.1,14346,15790,1444
13195,GA,Madison,,2010,10.6,11999,13415,1416
13195,GA,Madison,,2011,10.1,11873,13206,1333
13195,GA,Madison,,2012,8.8,11931,13084,1153
13195,GA,Madison,,2013,7.5,11922,12893,971
13195,GA,Madison,,2014,6.7,11835,12686,851
13195,GA,Madison,,2015,5.6,11776,12481,705
13195,GA,Madison,,2016,5,12428,13084,656
13195,GA,Madison,,2017,4.3,13102,13692,590
13195,GA,Madison,,2018,3.6,13226,13717,491
13195,GA,Madison,,2019,3.2,13000,13430,430
13195,GA,Madison,,2020,5,12553,13217,664
13195,GA,Madison,,2021,3.1,13184,13599,415
13197,GA,Marion,,2007,5.1,3149,3318,169
13197,GA,Marion,,2008,6.7,3105,3328,223
13197,GA,Marion,,2009,10.4,2974,3320,346
13197,GA,Marion,,2010,10.8,3330,3733,403
13197,GA,Marion,,2011,10.3,3294,3674,380
13197,GA,Marion,,2012,9.9,3244,3599,355
13197,GA,Marion,,2013,8.8,3146,3449,303
13197,GA,Marion,,2014,7.7,3185,3451,266
13197,GA,Marion,,2015,8.6,3115,3407,292
13197,GA,Marion,,2016,7.4,3130,3381,251
13197,GA,Marion,,2017,6.1,3249,3459,210
13197,GA,Marion,,2018,5.2,3203,3380,177
13197,GA,Marion,,2019,4.4,3152,3298,146
13197,GA,Marion,,2020,5,3075,3238,163
13197,GA,Marion,,2021,3.6,3139,3257,118
13199,GA,Meriwether,,2007,6.4,8964,9572,608
13199,GA,Meriwether,,2008,9.1,8767,9649,882
13199,GA,Meriwether,,2009,14.4,8112,9477,1365
13199,GA,Meriwether,,2010,13.9,8065,9367,1302
13199,GA,Meriwether,,2011,13.2,8001,9221,1220
13199,GA,Meriwether,,2012,11.8,7930,8995,1065
13199,GA,Meriwether,,2013,10.7,7861,8802,941
13199,GA,Meriwether,,2014,9.8,7878,8734,856
13199,GA,Meriwether,,2015,8.2,7877,8576,699
13199,GA,Meriwether,,2016,7,8150,8759,609
13199,GA,Meriwether,,2017,6,8418,8951,533
13199,GA,Meriwether,,2018,5.1,8437,8888,451
13199,GA,Meriwether,,2019,4.7,8484,8907,423
13199,GA,Meriwether,,2020,8.6,7991,8741,750
13199,GA,Meriwether,,2021,5.3,8429,8897,468
13201,GA,Miller,,2007,4.8,3404,3575,171
13201,GA,Miller,,2008,5.4,3392,3585,193
13201,GA,Miller,,2009,9.1,3286,3615,329
13201,GA,Miller,,2010,10.5,2515,2811,296
13201,GA,Miller,,2011,9.2,2484,2735,251
13201,GA,Miller,,2012,8.1,2474,2691,217
13201,GA,Miller,,2013,7.2,2460,2651,191
13201,GA,Miller,,2014,6.3,2500,2669,169
13201,GA,Miller,,2015,5.5,2494,2639,145
13201,GA,Miller,,2016,5.5,2602,2753,151
13201,GA,Miller,,2017,4.5,2721,2849,128
13201,GA,Miller,,2018,3.7,2674,2777,103
13201,GA,Miller,,2019,3.4,2712,2807,95
13201,GA,Miller,,2020,4,2660,2770,110
13201,GA,Miller,,2021,3,2698,2782,84
13205,GA,Mitchell,,2007,5.6,9834,10413,579
13205,GA,Mitchell,,2008,7.4,9765,10543,778
13205,GA,Mitchell,,2009,10.5,9313,10405,1092
13205,GA,Mitchell,,2010,11,8613,9673,1060
13205,GA,Mitchell,,2011,9.9,8559,9502,943
13205,GA,Mitchell,,2012,8.7,8743,9581,838
13205,GA,Mitchell,,2013,8.5,8236,9005,769
13205,GA,Mitchell,,2014,7.9,8061,8751,690
13205,GA,Mitchell,,2015,6.8,8029,8619,590
13205,GA,Mitchell,,2016,6.7,7999,8569,570
13205,GA,Mitchell,,2017,6.3,8040,8581,541
13205,GA,Mitchell,,2018,5.5,7934,8393,459
13205,GA,Mitchell,,2019,4.7,8100,8500,400
13205,GA,Mitchell,,2020,6.5,7746,8287,541
13205,GA,Mitchell,,2021,5,7813,8228,415
13207,GA,Monroe,,2007,4.4,12926,13526,600
13207,GA,Monroe,,2008,6.1,13048,13899,851
13207,GA,Monroe,,2009,9.5,12491,13805,1314
13207,GA,Monroe,,2010,10.3,11287,12587,1300
13207,GA,Monroe,,2011,9.7,11490,12718,1228
13207,GA,Monroe,,2012,8.5,11689,12779,1090
13207,GA,Monroe,,2013,8,11733,12751,1018
13207,GA,Monroe,,2014,6.7,11855,12710,855
13207,GA,Monroe,,2015,5.9,11784,12526,742
13207,GA,Monroe,,2016,5.2,12336,13018,682
13207,GA,Monroe,,2017,4.5,12638,13234,596
13207,GA,Monroe,,2018,3.7,12736,13225,489
13207,GA,Monroe,,2019,3.4,12596,13039,443
13207,GA,Monroe,,2020,5,12254,12899,645
13207,GA,Monroe,,2021,3.1,12714,13124,410
13209,GA,Montgomery,,2007,5,4362,4592,230
13209,GA,Montgomery,,2008,7.9,4189,4549,360
13209,GA,Montgomery,,2009,9.4,4064,4486,422
13209,GA,Montgomery,,2010,12.2,3415,3889,474
13209,GA,Montgomery,,2011,13.1,3393,3905,512
13209,GA,Montgomery,,2012,11.5,3440,3886,446
13209,GA,Montgomery,,2013,11.4,3584,4043,459
13209,GA,Montgomery,,2014,10.4,3454,3853,399
13209,GA,Montgomery,,2015,8.8,3347,3671,324
13209,GA,Montgomery,,2016,7.5,3444,3725,281
13209,GA,Montgomery,,2017,6.6,3549,3801,252
13209,GA,Montgomery,,2018,5.8,3644,3869,225
13209,GA,Montgomery,,2019,5.3,3722,3931,209
13209,GA,Montgomery,,2020,5.4,3625,3831,206
13209,GA,Montgomery,,2021,4.1,3699,3858,159
13211,GA,Morgan,,2007,4.7,9038,9485,447
13211,GA,Morgan,,2008,6.5,8972,9593,621
13211,GA,Morgan,,2009,10.4,8378,9355,977
13211,GA,Morgan,,2010,10.6,7739,8654,915
13211,GA,Morgan,,2011,10,7763,8622,859
13211,GA,Morgan,,2012,8.9,7754,8511,757
13211,GA,Morgan,,2013,8,7669,8336,667
13211,GA,Morgan,,2014,6.6,7796,8344,548
13211,GA,Morgan,,2015,5.6,7860,8324,464
13211,GA,Morgan,,2016,5.1,8254,8698,444
13211,GA,Morgan,,2017,4.5,8665,9076,411
13211,GA,Morgan,,2018,3.6,8880,9213,333
13211,GA,Morgan,,2019,3.3,9085,9392,307
13211,GA,Morgan,,2020,5.3,8732,9222,490
13211,GA,Morgan,,2021,3.2,9212,9521,309
13213,GA,Murray,,2007,4.9,20009,21048,1039
13213,GA,Murray,,2008,8,18749,20375,1626
13213,GA,Murray,,2009,13.6,17087,19773,2686
13213,GA,Murray,,2010,13.9,14831,17234,2403
13213,GA,Murray,,2011,13.8,14676,17017,2341
13213,GA,Murray,,2012,12.6,14277,16338,2061
13213,GA,Murray,,2013,11.2,14092,15864,1772
13213,GA,Murray,,2014,9.4,14358,15847,1489
13213,GA,Murray,,2015,7.5,14700,15891,1191
13213,GA,Murray,,2016,7.2,14521,15645,1124
13213,GA,Murray,,2017,6.2,15021,16016,995
13213,GA,Murray,,2018,5.4,15174,16034,860
13213,GA,Murray,,2019,5.3,14815,15643,828
13213,GA,Murray,,2020,7.5,14230,15378,1148
13213,GA,Murray,,2021,4.3,14812,15477,665
13215,GA,Muscogee,,2007,5.7,80720,85562,4842
13215,GA,Muscogee,,2008,6.7,80248,86000,5752
13215,GA,Muscogee,,2009,9.5,77931,86139,8208
13215,GA,Muscogee,,2010,10.3,73575,81995,8420
13215,GA,Muscogee,,2011,10,74480,82742,8262
13215,GA,Muscogee,,2012,9.7,75280,83331,8051
13215,GA,Muscogee,,2013,9.3,75322,83025,7703
13215,GA,Muscogee,,2014,8.5,73885,80711,6826
13215,GA,Muscogee,,2015,7.6,72100,78024,5924
13215,GA,Muscogee,,2016,6.9,73041,78438,5397
13215,GA,Muscogee,,2017,6,75013,79786,4773
13215,GA,Muscogee,,2018,5.2,74911,78991,4080
13215,GA,Muscogee,,2019,4.8,74199,77914,3715
13215,GA,Muscogee,,2020,7.8,71219,77213,5994
13215,GA,Muscogee,,2021,5.3,72553,76629,4076
13217,GA,Newton,,2007,5.7,43758,46396,2638
13217,GA,Newton,,2008,8.1,43743,47612,3869
13217,GA,Newton,,2009,12.8,41151,47203,6052
13217,GA,Newton,,2010,12.9,41951,48138,6187
13217,GA,Newton,,2011,12.3,42380,48301,5921
13217,GA,Newton,,2012,10.9,42907,48130,5223
13217,GA,Newton,,2013,9.6,43372,48002,4630
13217,GA,Newton,,2014,8.2,43929,47871,3942
13217,GA,Newton,,2015,6.9,44597,47891,3294
13217,GA,Newton,,2016,6.1,46972,50006,3034
13217,GA,Newton,,2017,5.4,48957,51731,2774
13217,GA,Newton,,2018,4.5,49719,52082,2363
13217,GA,Newton,,2019,4,50793,52934,2141
13217,GA,Newton,,2020,7.1,48448,52123,3675
13217,GA,Newton,,2021,4.4,51064,53410,2346
13219,GA,Oconee,,2007,3.2,17403,17984,581
13219,GA,Oconee,,2008,4.4,17963,18788,825
13219,GA,Oconee,,2009,6.5,17351,18564,1213
13219,GA,Oconee,,2010,7.2,15655,16875,1220
13219,GA,Oconee,,2011,6.9,15710,16879,1169
13219,GA,Oconee,,2012,6.2,15960,17016,1056
13219,GA,Oconee,,2013,5.6,16125,17076,951
13219,GA,Oconee,,2014,5.1,16355,17232,877
13219,GA,Oconee,,2015,4.5,16602,17385,783
13219,GA,Oconee,,2016,4.1,17706,18472,766
13219,GA,Oconee,,2017,3.6,18955,19655,700
13219,GA,Oconee,,2018,3,19529,20133,604
13219,GA,Oconee,,2019,2.7,19536,20069,533
13219,GA,Oconee,,2020,3.7,18893,19609,716
13219,GA,Oconee,,2021,2.2,19842,20285,443
13221,GA,Oglethorpe,,2007,4.2,7394,7717,323
13221,GA,Oglethorpe,,2008,5.6,7506,7953,447
13221,GA,Oglethorpe,,2009,8.9,7121,7817,696
13221,GA,Oglethorpe,,2010,9.8,6404,7099,695
13221,GA,Oglethorpe,,2011,9.7,6313,6990,677
13221,GA,Oglethorpe,,2012,8.4,6292,6871,579
13221,GA,Oglethorpe,,2013,7.5,6225,6731,506
13221,GA,Oglethorpe,,2014,6.6,6207,6649,442
13221,GA,Oglethorpe,,2015,5.6,6275,6650,375
13221,GA,Oglethorpe,,2016,4.9,6578,6919,341
13221,GA,Oglethorpe,,2017,4.4,6813,7123,310
13221,GA,Oglethorpe,,2018,3.7,6875,7142,267
13221,GA,Oglethorpe,,2019,3.3,6809,7045,236
13221,GA,Oglethorpe,,2020,4.7,6522,6845,323
13221,GA,Oglethorpe,,2021,2.9,6826,7027,201
13223,GA,Paulding,,2007,4.4,62981,65890,2909
13223,GA,Paulding,,2008,6.4,63854,68244,4390
13223,GA,Paulding,,2009,10.6,60796,68007,7211
13223,GA,Paulding,,2010,10.1,66434,73923,7489
13223,GA,Paulding,,2011,9.4,67149,74145,6996
13223,GA,Paulding,,2012,8.2,68145,74215,6070
13223,GA,Paulding,,2013,7.2,69117,74440,5323
13223,GA,Paulding,,2014,6.2,70102,74715,4613
13223,GA,Paulding,,2015,5.3,71460,75454,3994
13223,GA,Paulding,,2016,4.7,75914,79648,3734
13223,GA,Paulding,,2017,4.2,80127,83612,3485
13223,GA,Paulding,,2018,3.5,82609,85596,2987
13223,GA,Paulding,,2019,3.1,85070,87765,2695
13223,GA,Paulding,,2020,5.3,82242,86807,4565
13223,GA,Paulding,,2021,3,86668,89362,2694
13225,GA,Peach,,2007,5.9,10851,11533,682
13225,GA,Peach,,2008,7.6,11213,12141,928
13225,GA,Peach,,2009,10.8,11014,12353,1339
13225,GA,Peach,,2010,12.2,11373,12958,1585
13225,GA,Peach,,2011,11.7,11178,12663,1485
13225,GA,Peach,,2012,11,11127,12499,1372
13225,GA,Peach,,2013,10.6,10615,11873,1258
13225,GA,Peach,,2014,9.5,10379,11470,1091
13225,GA,Peach,,2015,8.1,10263,11163,900
13225,GA,Peach,,2016,7.1,10630,11441,811
13225,GA,Peach,,2017,5.9,11174,11875,701
13225,GA,Peach,,2018,5.2,11266,11890,624
13225,GA,Peach,,2019,4.3,11405,11913,508
13225,GA,Peach,,2020,6.2,11102,11835,733
13225,GA,Peach,,2021,4.7,11498,12060,562
13227,GA,Pickens,,2007,4.1,14505,15121,616
13227,GA,Pickens,,2008,6.4,14447,15443,996
13227,GA,Pickens,,2009,11.1,13438,15117,1679
13227,GA,Pickens,,2010,11.1,12521,14086,1565
13227,GA,Pickens,,2011,10.5,12569,14039,1470
13227,GA,Pickens,,2012,9,12611,13851,1240
13227,GA,Pickens,,2013,7.9,12701,13793,1092
13227,GA,Pickens,,2014,6.7,12878,13803,925
13227,GA,Pickens,,2015,5.4,12972,13716,744
13227,GA,Pickens,,2016,4.9,13692,14404,712
13227,GA,Pickens,,2017,4.3,14471,15123,652
13227,GA,Pickens,,2018,3.6,14681,15228,547
13227,GA,Pickens,,2019,3.2,14981,15469,488
13227,GA,Pickens,,2020,4.7,14319,15031,712
13227,GA,Pickens,,2021,2.8,15099,15533,434
13229,GA,Pierce,,2007,4.3,8192,8558,366
13229,GA,Pierce,,2008,5.8,8170,8675,505
13229,GA,Pierce,,2009,9.8,7829,8684,855
13229,GA,Pierce,,2010,10.6,7396,8270,874
13229,GA,Pierce,,2011,10.6,7228,8083,855
13229,GA,Pierce,,2012,9.3,7534,8307,773
13229,GA,Pierce,,2013,8.5,7458,8149,691
13229,GA,Pierce,,2014,7.5,7471,8077,606
13229,GA,Pierce,,2015,6.3,7449,7954,505
13229,GA,Pierce,,2016,5.4,8097,8556,459
13229,GA,Pierce,,2017,4.6,8471,8877,406
13229,GA,Pierce,,2018,3.8,8409,8744,335
13229,GA,Pierce,,2019,3.6,8392,8701,309
13229,GA,Pierce,,2020,4.5,8129,8513,384
13229,GA,Pierce,,2021,3.1,8354,8623,269
13231,GA,Pike,,2007,4.6,7693,8064,371
13231,GA,Pike,,2008,7.1,7653,8239,586
13231,GA,Pike,,2009,11.5,7160,8088,928
13231,GA,Pike,,2010,10.8,7608,8528,920
13231,GA,Pike,,2011,10.1,7569,8420,851
13231,GA,Pike,,2012,9.1,7628,8392,764
13231,GA,Pike,,2013,8.4,7594,8292,698
13231,GA,Pike,,2014,7,7605,8181,576
13231,GA,Pike,,2015,5.8,7660,8134,474
13231,GA,Pike,,2016,5.2,7961,8402,441
13231,GA,Pike,,2017,4.5,8352,8746,394
13231,GA,Pike,,2018,3.6,8557,8881,324
13231,GA,Pike,,2019,3.2,8714,8999,285
13231,GA,Pike,,2020,4.9,8271,8697,426
13231,GA,Pike,,2021,2.8,8728,8981,253
13233,GA,Polk,,2007,4.8,19929,20942,1013
13233,GA,Polk,,2008,6.8,19963,21431,1468
13233,GA,Polk,,2009,11.3,18822,21218,2396
13233,GA,Polk,,2010,12.2,16464,18755,2291
13233,GA,Polk,,2011,11.5,16514,18655,2141
13233,GA,Polk,,2012,9.9,16883,18730,1847
13233,GA,Polk,,2013,8.8,16848,18483,1635
13233,GA,Polk,,2014,7.8,16881,18313,1432
13233,GA,Polk,,2015,6.7,16736,17945,1209
13233,GA,Polk,,2016,6.2,16948,18072,1124
13233,GA,Polk,,2017,5.3,17679,18663,984
13233,GA,Polk,,2018,4.3,17800,18591,791
13233,GA,Polk,,2019,3.8,17889,18593,704
13233,GA,Polk,,2020,5.9,17199,18280,1081
13233,GA,Polk,,2021,3.6,17823,18480,657
13235,GA,Pulaski,,2007,4.3,4442,4642,200
13235,GA,Pulaski,,2008,5.8,4324,4589,265
13235,GA,Pulaski,,2009,8.2,4000,4357,357
13235,GA,Pulaski,,2010,9.3,4117,4541,424
13235,GA,Pulaski,,2011,9.6,4051,4480,429
13235,GA,Pulaski,,2012,8.9,3979,4367,388
13235,GA,Pulaski,,2013,8.8,3823,4193,370
13235,GA,Pulaski,,2014,7.8,3738,4056,318
13235,GA,Pulaski,,2015,6.7,3702,3968,266
13235,GA,Pulaski,,2016,5.9,3799,4039,240
13235,GA,Pulaski,,2017,5.3,3914,4133,219
13235,GA,Pulaski,,2018,4.4,3870,4049,179
13235,GA,Pulaski,,2019,4,3906,4070,164
13235,GA,Pulaski,,2020,4.7,3767,3953,186
13235,GA,Pulaski,,2021,3.6,3902,4048,146
13237,GA,Putnam,,2007,4.7,9907,10400,493
13237,GA,Putnam,,2008,7.6,9671,10470,799
13237,GA,Putnam,,2009,11.5,9194,10387,1193
13237,GA,Putnam,,2010,13.1,7893,9082,1189
13237,GA,Putnam,,2011,12.9,7533,8650,1117
13237,GA,Putnam,,2012,11.4,7321,8259,938
13237,GA,Putnam,,2013,10.3,7298,8132,834
13237,GA,Putnam,,2014,9.1,7345,8079,734
13237,GA,Putnam,,2015,8.2,7082,7716,634
13237,GA,Putnam,,2016,7.1,7388,7955,567
13237,GA,Putnam,,2017,5.8,7772,8253,481
13237,GA,Putnam,,2018,5,7861,8278,417
13237,GA,Putnam,,2019,4.5,7958,8334,376
13237,GA,Putnam,,2020,6.4,7756,8289,533
13237,GA,Putnam,,2021,4,8314,8661,347
13239,GA,Quitman,,2007,5.9,997,1059,62
13239,GA,Quitman,,2008,9.3,934,1030,96
13239,GA,Quitman,,2009,12.5,849,970,121
13239,GA,Quitman,,2010,10.2,906,1009,103
13239,GA,Quitman,,2011,10.1,878,977,99
13239,GA,Quitman,,2012,9.4,852,940,88
13239,GA,Quitman,,2013,8.1,828,901,73
13239,GA,Quitman,,2014,8.4,815,890,75
13239,GA,Quitman,,2015,6.9,751,807,56
13239,GA,Quitman,,2016,7.4,755,815,60
13239,GA,Quitman,,2017,5.9,791,841,50
13239,GA,Quitman,,2018,5.7,781,828,47
13239,GA,Quitman,,2019,5.3,770,813,43
13239,GA,Quitman,,2020,6.3,745,795,50
13239,GA,Quitman,,2021,4.9,730,768,38
13241,GA,Rabun,,2007,6.4,6816,7279,463
13241,GA,Rabun,,2008,6.9,6473,6951,478
13241,GA,Rabun,,2009,10.9,6217,6976,759
13241,GA,Rabun,,2010,12,6306,7162,856
13241,GA,Rabun,,2011,12.3,6156,7018,862
13241,GA,Rabun,,2012,11.3,6131,6912,781
13241,GA,Rabun,,2013,9.8,6142,6813,671
13241,GA,Rabun,,2014,8.2,6003,6540,537
13241,GA,Rabun,,2015,6.8,5991,6430,439
13241,GA,Rabun,,2016,6,6299,6700,401
13241,GA,Rabun,,2017,5,6627,6973,346
13241,GA,Rabun,,2018,4,6847,7136,289
13241,GA,Rabun,,2019,3.7,7058,7326,268
13241,GA,Rabun,,2020,5.3,6854,7235,381
13241,GA,Rabun,,2021,3.1,7292,7528,236
13243,GA,Randolph,,2007,7,2555,2747,192
13243,GA,Randolph,,2008,9.1,2533,2787,254
13243,GA,Randolph,,2009,12.7,2407,2758,351
13243,GA,Randolph,,2010,12.3,2620,2988,368
13243,GA,Randolph,,2011,12.6,2566,2937,371
13243,GA,Randolph,,2012,12.3,2476,2824,348
13243,GA,Randolph,,2013,10.3,2501,2787,286
13243,GA,Randolph,,2014,9.7,2451,2715,264
13243,GA,Randolph,,2015,9.3,2177,2399,222
13243,GA,Randolph,,2016,8.6,2263,2475,212
13243,GA,Randolph,,2017,6.5,2374,2540,166
13243,GA,Randolph,,2018,5.6,2348,2488,140
13243,GA,Randolph,,2019,5,2431,2558,127
13243,GA,Randolph,,2020,5.9,2320,2466,146
13243,GA,Randolph,,2021,5.2,2250,2373,123
13245,GA,Richmond,,2007,6.6,84911,90932,6021
13245,GA,Richmond,,2008,7.7,84905,92026,7121
13245,GA,Richmond,,2009,10.6,81671,91347,9676
13245,GA,Richmond,,2010,11.1,78306,88125,9819
13245,GA,Richmond,,2011,11.1,78477,88308,9831
13245,GA,Richmond,,2012,10.5,78891,88115,9224
13245,GA,Richmond,,2013,9.8,78136,86594,8458
13245,GA,Richmond,,2014,8.7,77147,84527,7380
13245,GA,Richmond,,2015,7.5,77071,83351,6280
13245,GA,Richmond,,2016,6.8,79035,84842,5807
13245,GA,Richmond,,2017,6,81598,86817,5219
13245,GA,Richmond,,2018,5.3,81613,86144,4531
13245,GA,Richmond,,2019,4.7,81412,85470,4058
13245,GA,Richmond,,2020,7.6,77658,84055,6397
13245,GA,Richmond,,2021,5.3,79901,84416,4515
13247,GA,Rockdale,,2007,5.4,38146,40335,2189
13247,GA,Rockdale,,2008,7.5,37686,40731,3045
13247,GA,Rockdale,,2009,11.7,35522,40213,4691
13247,GA,Rockdale,,2010,11.4,37256,42071,4815
13247,GA,Rockdale,,2011,11.1,37477,42157,4680
13247,GA,Rockdale,,2012,10,37768,41985,4217
13247,GA,Rockdale,,2013,9.1,38294,42123,3829
13247,GA,Rockdale,,2014,7.9,38661,41972,3311
13247,GA,Rockdale,,2015,6.6,39019,41793,2774
13247,GA,Rockdale,,2016,5.9,40714,43254,2540
13247,GA,Rockdale,,2017,5.3,42450,44841,2391
13247,GA,Rockdale,,2018,4.5,42670,44669,1999
13247,GA,Rockdale,,2019,4,42863,44649,1786
13247,GA,Rockdale,,2020,7.6,40322,43615,3293
13247,GA,Rockdale,,2021,4.6,42529,44591,2062
13249,GA,Schley,,2007,6.4,1705,1822,117
13249,GA,Schley,,2008,7.2,1740,1874,134
13249,GA,Schley,,2009,13.3,1654,1908,254
13249,GA,Schley,,2010,12.2,1905,2170,265
13249,GA,Schley,,2011,11.4,1912,2157,245
13249,GA,Schley,,2012,10.3,1945,2168,223
13249,GA,Schley,,2013,9.2,1933,2129,196
13249,GA,Schley,,2014,7.6,2006,2172,166
13249,GA,Schley,,2015,6.8,1945,2086,141
13249,GA,Schley,,2016,6.4,1982,2117,135
13249,GA,Schley,,2017,5.5,2110,2233,123
13249,GA,Schley,,2018,4.7,2098,2201,103
13249,GA,Schley,,2019,4,2170,2260,90
13249,GA,Schley,,2020,4.3,2054,2146,92
13249,GA,Schley,,2021,3.7,2055,2134,79
13251,GA,Screven,,2007,5.3,6852,7233,381
13251,GA,Screven,,2008,8.5,6745,7369,624
13251,GA,Screven,,2009,14.8,6241,7327,1086
13251,GA,Screven,,2010,17.2,4824,5826,1002
13251,GA,Screven,,2011,15.6,4852,5752,900
13251,GA,Screven,,2012,13.6,4898,5670,772
13251,GA,Screven,,2013,12.5,4860,5555,695
13251,GA,Screven,,2014,10,4817,5355,538
13251,GA,Screven,,2015,8.5,4564,4986,422
13251,GA,Screven,,2016,7.6,4840,5240,400
13251,GA,Screven,,2017,6.3,4985,5321,336
13251,GA,Screven,,2018,5.5,5008,5298,290
13251,GA,Screven,,2019,5.6,4875,5166,291
13251,GA,Screven,,2020,8.1,4638,5047,409
13251,GA,Screven,,2021,5.6,4834,5122,288
13253,GA,Seminole,,2007,5.9,3753,3989,236
13253,GA,Seminole,,2008,7.9,3771,4095,324
13253,GA,Seminole,,2009,11.3,3633,4096,463
13253,GA,Seminole,,2010,12.7,2963,3395,432
13253,GA,Seminole,,2011,12.6,2857,3268,411
13253,GA,Seminole,,2012,10.8,2893,3242,349
13253,GA,Seminole,,2013,10.2,2816,3135,319
13253,GA,Seminole,,2014,9.5,2820,3115,295
13253,GA,Seminole,,2015,8.2,2805,3057,252
13253,GA,Seminole,,2016,8,2846,3093,247
13253,GA,Seminole,,2017,6.5,2915,3117,202
13253,GA,Seminole,,2018,5.4,2886,3050,164
13253,GA,Seminole,,2019,4.4,2972,3110,138
13253,GA,Seminole,,2020,5,2942,3096,154
13253,GA,Seminole,,2021,3.7,2945,3059,114
13255,GA,Spalding,,2007,6.1,26531,28265,1734
13255,GA,Spalding,,2008,9.1,26289,28936,2647
13255,GA,Spalding,,2009,14.8,24689,28987,4298
13255,GA,Spalding,,2010,15,24439,28762,4323
13255,GA,Spalding,,2011,13.9,24543,28500,3957
13255,GA,Spalding,,2012,12.4,24608,28080,3472
13255,GA,Spalding,,2013,11.4,24570,27737,3167
13255,GA,Spalding,,2014,9.5,24651,27238,2587
13255,GA,Spalding,,2015,8.2,24620,26814,2194
13255,GA,Spalding,,2016,7,25863,27798,1935
13255,GA,Spalding,,2017,5.9,26926,28604,1678
13255,GA,Spalding,,2018,4.8,27277,28646,1369
13255,GA,Spalding,,2019,4.2,27562,28770,1208
13255,GA,Spalding,,2020,7.5,26205,28339,2134
13255,GA,Spalding,,2021,4.7,27627,28984,1357
13257,GA,Stephens,,2007,5.3,12865,13580,715
13257,GA,Stephens,,2008,6.7,12840,13763,923
13257,GA,Stephens,,2009,11.1,12365,13912,1547
13257,GA,Stephens,,2010,12.5,10442,11928,1486
13257,GA,Stephens,,2011,11.9,10329,11722,1393
13257,GA,Stephens,,2012,10.4,10507,11721,1214
13257,GA,Stephens,,2013,9.1,10450,11497,1047
13257,GA,Stephens,,2014,7.7,10334,11194,860
13257,GA,Stephens,,2015,6.6,10025,10739,714
13257,GA,Stephens,,2016,6,10376,11033,657
13257,GA,Stephens,,2017,5.3,10553,11139,586
13257,GA,Stephens,,2018,4.6,10471,10980,509
13257,GA,Stephens,,2019,3.9,10422,10849,427
13257,GA,Stephens,,2020,6.3,9767,10428,661
13257,GA,Stephens,,2021,4.3,10059,10512,453
13259,GA,Stewart,,2007,6.8,2118,2273,155
13259,GA,Stewart,,2008,8.5,2122,2318,196
13259,GA,Stewart,,2009,11.1,2061,2319,258
13259,GA,Stewart,,2010,10.4,2157,2408,251
13259,GA,Stewart,,2011,9.6,2106,2329,223
13259,GA,Stewart,,2012,9,2101,2309,208
13259,GA,Stewart,,2013,8.6,2086,2283,197
13259,GA,Stewart,,2014,7.5,2020,2184,164
13259,GA,Stewart,,2015,7,1944,2091,147
13259,GA,Stewart,,2016,6.5,2000,2138,138
13259,GA,Stewart,,2017,6,2165,2303,138
13259,GA,Stewart,,2018,4.8,2257,2372,115
13259,GA,Stewart,,2019,4.4,2389,2499,110
13259,GA,Stewart,,2020,5.6,2373,2513,140
13259,GA,Stewart,,2021,3.8,2464,2562,98
13261,GA,Sumter,,2007,7.7,13675,14815,1140
13261,GA,Sumter,,2008,8.3,13492,14711,1219
13261,GA,Sumter,,2009,13.6,12464,14423,1959
13261,GA,Sumter,,2010,13.4,12385,14306,1921
13261,GA,Sumter,,2011,12.4,12170,13899,1729
13261,GA,Sumter,,2012,11.7,12276,13905,1629
13261,GA,Sumter,,2013,11.2,11897,13397,1500
13261,GA,Sumter,,2014,9.5,12140,13418,1278
13261,GA,Sumter,,2015,8.5,11618,12692,1074
13261,GA,Sumter,,2016,7.7,11864,12849,985
13261,GA,Sumter,,2017,6.8,12138,13030,892
13261,GA,Sumter,,2018,6,11967,12734,767
13261,GA,Sumter,,2019,4.9,12255,12891,636
13261,GA,Sumter,,2020,7.4,11651,12586,935
13261,GA,Sumter,,2021,5.7,11627,12334,707
13263,GA,Talbot,,2007,7,2943,3163,220
13263,GA,Talbot,,2008,7.1,2956,3183,227
13263,GA,Talbot,,2009,9.9,2817,3127,310
13263,GA,Talbot,,2010,10.2,2588,2883,295
13263,GA,Talbot,,2011,10.5,2609,2915,306
13263,GA,Talbot,,2012,9.9,2623,2911,288
13263,GA,Talbot,,2013,9.2,2594,2857,263
13263,GA,Talbot,,2014,7.9,2580,2801,221
13263,GA,Talbot,,2015,7.9,2457,2667,210
13263,GA,Talbot,,2016,6.8,2559,2745,186
13263,GA,Talbot,,2017,6.2,2647,2821,174
13263,GA,Talbot,,2018,5.1,2696,2841,145
13263,GA,Talbot,,2019,4.6,2700,2830,130
13263,GA,Talbot,,2020,6.7,2570,2756,186
13263,GA,Talbot,,2021,4.5,2649,2775,126
13265,GA,Taliaferro,,2007,8.6,777,850,73
13265,GA,Taliaferro,,2008,8.9,772,847,75
13265,GA,Taliaferro,,2009,15.2,708,835,127
13265,GA,Taliaferro,,2010,18.2,521,637,116
13265,GA,Taliaferro,,2011,15.6,521,617,96
13265,GA,Taliaferro,,2012,14.1,519,604,85
13265,GA,Taliaferro,,2013,11.9,519,589,70
13265,GA,Taliaferro,,2014,11,527,592,65
13265,GA,Taliaferro,,2015,8,540,587,47
13265,GA,Taliaferro,,2016,6.9,510,548,38
13265,GA,Taliaferro,,2017,6.7,542,581,39
13265,GA,Taliaferro,,2018,5.4,539,570,31
13265,GA,Taliaferro,,2019,5.3,518,547,29
13265,GA,Taliaferro,,2020,7.1,495,533,38
13265,GA,Taliaferro,,2021,5,508,535,27
13267,GA,Tattnall,,2007,5.2,8662,9136,474
13267,GA,Tattnall,,2008,7.2,8589,9252,663
13267,GA,Tattnall,,2009,9.4,8475,9359,884
13267,GA,Tattnall,,2010,9.2,8813,9702,889
13267,GA,Tattnall,,2011,8.7,8996,9853,857
13267,GA,Tattnall,,2012,8.2,8979,9780,801
13267,GA,Tattnall,,2013,7.9,8795,9550,755
13267,GA,Tattnall,,2014,7,8844,9508,664
13267,GA,Tattnall,,2015,6.3,8596,9171,575
13267,GA,Tattnall,,2016,5.4,8825,9330,505
13267,GA,Tattnall,,2017,5,9205,9687,482
13267,GA,Tattnall,,2018,4.3,9293,9706,413
13267,GA,Tattnall,,2019,3.9,9387,9771,384
13267,GA,Tattnall,,2020,4.3,9258,9670,412
13267,GA,Tattnall,,2021,3.2,9313,9621,308
13269,GA,Taylor,,2007,6.4,3120,3333,213
13269,GA,Taylor,,2008,8.1,3162,3439,277
13269,GA,Taylor,,2009,12.5,3114,3557,443
13269,GA,Taylor,,2010,14.6,2788,3266,478
13269,GA,Taylor,,2011,14.3,2718,3171,453
13269,GA,Taylor,,2012,13.2,2694,3103,409
13269,GA,Taylor,,2013,11.6,2801,3169,368
13269,GA,Taylor,,2014,10.3,2551,2843,292
13269,GA,Taylor,,2015,9.3,2487,2743,256
13269,GA,Taylor,,2016,7.6,3071,3323,252
13269,GA,Taylor,,2017,8.8,2598,2848,250
13269,GA,Taylor,,2018,6.6,2607,2790,183
13269,GA,Taylor,,2019,4.3,2909,3039,130
13269,GA,Taylor,,2020,7.2,2569,2768,199
13269,GA,Taylor,,2021,5.7,2782,2950,168
13271,GA,Telfair,,2007,8.3,4588,5006,418
13271,GA,Telfair,,2008,11.6,4170,4716,546
13271,GA,Telfair,,2009,14.6,3956,4630,674
13271,GA,Telfair,,2010,14.9,4468,5250,782
13271,GA,Telfair,,2011,13.1,4579,5268,689
13271,GA,Telfair,,2012,11.6,4706,5324,618
13271,GA,Telfair,,2013,11.3,4688,5288,600
13271,GA,Telfair,,2014,9.8,4729,5242,513
13271,GA,Telfair,,2015,8.8,4350,4772,422
13271,GA,Telfair,,2016,8.5,4403,4811,408
13271,GA,Telfair,,2017,7.9,4451,4832,381
13271,GA,Telfair,,2018,6.8,4073,4370,297
13271,GA,Telfair,,2019,9.6,3894,4307,413
13271,GA,Telfair,,2020,9.8,3426,3799,373
13271,GA,Telfair,,2021,7.2,3467,3735,268
13273,GA,Terrell,,2007,6.5,4144,4430,286
13273,GA,Terrell,,2008,7.1,4107,4423,316
13273,GA,Terrell,,2009,10.9,3965,4448,483
13273,GA,Terrell,,2010,12.4,3444,3931,487
13273,GA,Terrell,,2011,11.9,3385,3842,457
13273,GA,Terrell,,2012,10.7,3339,3741,402
13273,GA,Terrell,,2013,9.7,3304,3659,355
13273,GA,Terrell,,2014,8.1,3322,3613,291
13273,GA,Terrell,,2015,7.6,3318,3590,272
13273,GA,Terrell,,2016,6.6,3417,3657,240
13273,GA,Terrell,,2017,6,3479,3703,224
13273,GA,Terrell,,2018,6.8,3340,3582,242
13273,GA,Terrell,,2019,5.2,3369,3553,184
13273,GA,Terrell,,2020,7.5,3264,3527,263
13273,GA,Terrell,,2021,6.2,3347,3568,221
13275,GA,Thomas,,2007,4.5,21931,22953,1022
13275,GA,Thomas,,2008,6.3,20753,22139,1386
13275,GA,Thomas,,2009,9.6,19357,21424,2067
13275,GA,Thomas,,2010,11.4,15894,17948,2054
13275,GA,Thomas,,2011,10.3,16420,18314,1894
13275,GA,Thomas,,2012,9.6,16662,18422,1760
13275,GA,Thomas,,2013,9,16187,17780,1593
13275,GA,Thomas,,2014,8.8,15619,17123,1504
13275,GA,Thomas,,2015,7.4,15403,16626,1223
13275,GA,Thomas,,2016,6.3,16425,17533,1108
13275,GA,Thomas,,2017,5.8,16366,17382,1016
13275,GA,Thomas,,2018,4.7,16116,16919,803
13275,GA,Thomas,,2019,4.1,16339,17033,694
13275,GA,Thomas,,2020,6.2,15944,16997,1053
13275,GA,Thomas,,2021,4.2,16841,17576,735
13277,GA,Tift,,2007,5.7,18026,19120,1094
13277,GA,Tift,,2008,7.7,17564,19028,1464
13277,GA,Tift,,2009,11.5,16734,18905,2171
13277,GA,Tift,,2010,12.1,16557,18838,2281
13277,GA,Tift,,2011,12,16635,18901,2266
13277,GA,Tift,,2012,9.9,17191,19088,1897
13277,GA,Tift,,2013,8.4,17094,18669,1575
13277,GA,Tift,,2014,7.3,16890,18223,1333
13277,GA,Tift,,2015,6.2,17009,18137,1128
13277,GA,Tift,,2016,5.5,17541,18553,1012
13277,GA,Tift,,2017,4.7,18407,19316,909
13277,GA,Tift,,2018,4,18610,19395,785
13277,GA,Tift,,2019,3.4,19643,20340,697
13277,GA,Tift,,2020,5.1,19496,20533,1037
13277,GA,Tift,,2021,3.4,20501,21225,724
13279,GA,Toombs,,2007,5.1,13139,13850,711
13279,GA,Toombs,,2008,7.7,12928,14014,1086
13279,GA,Toombs,,2009,10.4,12479,13923,1444
13279,GA,Toombs,,2010,12.4,10805,12340,1535
13279,GA,Toombs,,2011,13.3,10755,12407,1652
13279,GA,Toombs,,2012,11.6,11023,12469,1446
13279,GA,Toombs,,2013,10.9,11375,12771,1396
13279,GA,Toombs,,2014,9.9,11009,12220,1211
13279,GA,Toombs,,2015,8.9,10693,11735,1042
13279,GA,Toombs,,2016,7.9,10856,11789,933
13279,GA,Toombs,,2017,6.6,11148,11934,786
13279,GA,Toombs,,2018,5.9,11196,11896,700
13279,GA,Toombs,,2019,5,11422,12027,605
13279,GA,Toombs,,2020,6.5,11372,12159,787
13279,GA,Toombs,,2021,4.5,11627,12171,544
13281,GA,Towns,,2007,4,5772,6013,241
13281,GA,Towns,,2008,6.4,5437,5810,373
13281,GA,Towns,,2009,9.1,5217,5741,524
13281,GA,Towns,,2010,13,3788,4355,567
13281,GA,Towns,,2011,12.5,3807,4349,542
13281,GA,Towns,,2012,11.2,3931,4425,494
13281,GA,Towns,,2013,10.5,3717,4155,438
13281,GA,Towns,,2014,9.2,3751,4133,382
13281,GA,Towns,,2015,8,3562,3873,311
13281,GA,Towns,,2016,6.9,3825,4108,283
13281,GA,Towns,,2017,6.6,3550,3802,252
13281,GA,Towns,,2018,5.7,3699,3922,223
13281,GA,Towns,,2019,5,3781,3980,199
13281,GA,Towns,,2020,6.6,3617,3871,254
13281,GA,Towns,,2021,3.9,3895,4055,160
13283,GA,Treutlen,,2007,6.3,2544,2714,170
13283,GA,Treutlen,,2008,9.2,2622,2888,266
13283,GA,Treutlen,,2009,12,2580,2932,352
13283,GA,Treutlen,,2010,12.2,2593,2954,361
13283,GA,Treutlen,,2011,13.1,2589,2981,392
13283,GA,Treutlen,,2012,13.3,2509,2893,384
13283,GA,Treutlen,,2013,12.2,2478,2823,345
13283,GA,Treutlen,,2014,10.6,2493,2790,297
13283,GA,Treutlen,,2015,8.6,2440,2671,231
13283,GA,Treutlen,,2016,7.8,2529,2743,214
13283,GA,Treutlen,,2017,6.8,2575,2762,187
13283,GA,Treutlen,,2018,5.9,2555,2714,159
13283,GA,Treutlen,,2019,5.3,2586,2732,146
13283,GA,Treutlen,,2020,6.1,2497,2658,161
13283,GA,Treutlen,,2021,4.3,2518,2630,112
13285,GA,Troup,,2007,6.2,28569,30446,1877
13285,GA,Troup,,2008,8.8,27855,30545,2690
13285,GA,Troup,,2009,13.5,26804,30989,4185
13285,GA,Troup,,2010,11.7,28823,32636,3813
13285,GA,Troup,,2011,10.9,30672,34427,3755
13285,GA,Troup,,2012,9.7,32046,35480,3434
13285,GA,Troup,,2013,8.6,33025,36113,3088
13285,GA,Troup,,2014,7.4,33389,36041,2652
13285,GA,Troup,,2015,6.2,33016,35191,2175
13285,GA,Troup,,2016,5.2,34934,36835,1901
13285,GA,Troup,,2017,4.4,36055,37728,1673
13285,GA,Troup,,2018,3.7,35381,36758,1377
13285,GA,Troup,,2019,3.3,36806,38059,1253
13285,GA,Troup,,2020,7.2,34897,37586,2689
13285,GA,Troup,,2021,4.4,36030,37678,1648
13287,GA,Turner,,2007,7.2,4591,4948,357
13287,GA,Turner,,2008,8.8,4373,4793,420
13287,GA,Turner,,2009,14.7,3958,4641,683
13287,GA,Turner,,2010,16.8,2947,3542,595
13287,GA,Turner,,2011,14.2,3081,3589,508
13287,GA,Turner,,2012,11.5,3049,3446,397
13287,GA,Turner,,2013,9.9,3001,3331,330
13287,GA,Turner,,2014,8,2993,3253,260
13287,GA,Turner,,2015,6.9,2939,3157,218
13287,GA,Turner,,2016,6.6,3024,3236,212
13287,GA,Turner,,2017,5.7,3121,3308,187
13287,GA,Turner,,2018,5.1,3020,3183,163
13287,GA,Turner,,2019,3.9,3100,3226,126
13287,GA,Turner,,2020,7.3,3025,3262,237
13287,GA,Turner,,2021,6.4,3073,3283,210
13289,GA,Twiggs,,2007,6.1,4383,4668,285
13289,GA,Twiggs,,2008,7.5,4397,4754,357
13289,GA,Twiggs,,2009,11.6,4121,4661,540
13289,GA,Twiggs,,2010,15.6,2764,3276,512
13289,GA,Twiggs,,2011,15.3,2748,3246,498
13289,GA,Twiggs,,2012,14.7,2697,3160,463
13289,GA,Twiggs,,2013,13.7,2691,3117,426
13289,GA,Twiggs,,2014,11.2,2659,2993,334
13289,GA,Twiggs,,2015,9.3,2661,2933,272
13289,GA,Twiggs,,2016,8.8,2690,2950,260
13289,GA,Twiggs,,2017,7.6,2770,2998,228
13289,GA,Twiggs,,2018,6,2755,2930,175
13289,GA,Twiggs,,2019,5.8,2698,2863,165
13289,GA,Twiggs,,2020,7.4,2579,2786,207
13289,GA,Twiggs,,2021,5.1,2661,2804,143
13291,GA,Union,,2007,3.9,10971,11420,449
13291,GA,Union,,2008,6.3,10429,11133,704
13291,GA,Union,,2009,9.9,9900,10991,1091
13291,GA,Union,,2010,11.2,8466,9534,1068
13291,GA,Union,,2011,10.1,8508,9467,959
13291,GA,Union,,2012,8.7,8790,9630,840
13291,GA,Union,,2013,7.8,8587,9317,730
13291,GA,Union,,2014,6.6,8872,9501,629
13291,GA,Union,,2015,5.4,9190,9719,529
13291,GA,Union,,2016,4.8,9949,10451,502
13291,GA,Union,,2017,4.5,9786,10252,466
13291,GA,Union,,2018,3.7,9968,10352,384
13291,GA,Union,,2019,3.3,10174,10516,342
13291,GA,Union,,2020,4.4,10087,10546,459
13291,GA,Union,,2021,2.7,10794,11094,300
13293,GA,Upson,,2007,6.9,11184,12018,834
13293,GA,Upson,,2008,8.9,10940,12014,1074
13293,GA,Upson,,2009,13.5,10325,11942,1617
13293,GA,Upson,,2010,12.4,10484,11967,1483
13293,GA,Upson,,2011,11.5,10610,11986,1376
13293,GA,Upson,,2012,10.5,10692,11949,1257
13293,GA,Upson,,2013,9.8,10745,11907,1162
13293,GA,Upson,,2014,8.9,10281,11290,1009
13293,GA,Upson,,2015,7.4,10195,11006,811
13293,GA,Upson,,2016,6.5,10415,11143,728
13293,GA,Upson,,2017,5.5,10759,11387,628
13293,GA,Upson,,2018,4.4,10891,11398,507
13293,GA,Upson,,2019,3.7,11008,11430,422
13293,GA,Upson,,2020,6.5,10625,11367,742
13293,GA,Upson,,2021,4,11162,11628,466
13295,GA,Walker,,2007,4.8,31450,33041,1591
13295,GA,Walker,,2008,7.1,30958,33337,2379
13295,GA,Walker,,2009,11.4,28556,32248,3692
13295,GA,Walker,,2010,10.4,27822,31068,3246
13295,GA,Walker,,2011,9.7,27996,31016,3020
13295,GA,Walker,,2012,8.9,28089,30820,2731
13295,GA,Walker,,2013,8,27705,30120,2415
13295,GA,Walker,,2014,7.2,27230,29356,2126
13295,GA,Walker,,2015,6.1,27298,29064,1766
13295,GA,Walker,,2016,5.6,28247,29938,1691
13295,GA,Walker,,2017,4.6,29750,31170,1420
13295,GA,Walker,,2018,3.9,30136,31362,1226
13295,GA,Walker,,2019,3.7,30288,31462,1174
13295,GA,Walker,,2020,4.9,29065,30562,1497
13295,GA,Walker,,2021,3.1,30327,31304,977
13297,GA,Walton,,2007,5,38999,41040,2041
13297,GA,Walton,,2008,6.9,39207,42123,2916
13297,GA,Walton,,2009,10.9,37002,41524,4522
13297,GA,Walton,,2010,10.8,36712,41152,4440
13297,GA,Walton,,2011,10.3,36890,41135,4245
13297,GA,Walton,,2012,9,37325,40998,3673
13297,GA,Walton,,2013,7.7,37833,40999,3166
13297,GA,Walton,,2014,6.5,38673,41346,2673
13297,GA,Walton,,2015,5.5,38928,41195,2267
13297,GA,Walton,,2016,5,41222,43382,2160
13297,GA,Walton,,2017,4.4,43196,45166,1970
13297,GA,Walton,,2018,3.6,44183,45841,1658
13297,GA,Walton,,2019,3.2,44765,46257,1492
13297,GA,Walton,,2020,5.3,43123,45552,2429
13297,GA,Walton,,2021,3.2,45448,46945,1497
13299,GA,Ware,,2007,5.3,14335,15136,801
13299,GA,Ware,,2008,7.1,14123,15209,1086
13299,GA,Ware,,2009,11.4,13217,14915,1698
13299,GA,Ware,,2010,11.1,13865,15604,1739
13299,GA,Ware,,2011,11.2,13542,15244,1702
13299,GA,Ware,,2012,10,13887,15426,1539
13299,GA,Ware,,2013,9.3,13675,15078,1403
13299,GA,Ware,,2014,7.9,13567,14737,1170
13299,GA,Ware,,2015,6.6,13375,14324,949
13299,GA,Ware,,2016,5.5,14637,15484,847
13299,GA,Ware,,2017,4.6,15248,15979,731
13299,GA,Ware,,2018,4,14991,15612,621
13299,GA,Ware,,2019,3.8,14927,15524,597
13299,GA,Ware,,2020,5.5,14456,15302,846
13299,GA,Ware,,2021,3.7,14837,15404,567
13301,GA,Warren,,2007,8.1,2259,2459,200
13301,GA,Warren,,2008,11,2215,2490,275
13301,GA,Warren,,2009,18.9,2139,2637,498
13301,GA,Warren,,2010,17.4,2203,2666,463
13301,GA,Warren,,2011,16.4,2206,2640,434
13301,GA,Warren,,2012,14.7,2252,2641,389
13301,GA,Warren,,2013,11.9,2398,2723,325
13301,GA,Warren,,2014,9.7,2447,2711,264
13301,GA,Warren,,2015,7.9,2403,2610,207
13301,GA,Warren,,2016,7,2510,2700,190
13301,GA,Warren,,2017,5.9,2588,2750,162
13301,GA,Warren,,2018,5,2622,2760,138
13301,GA,Warren,,2019,4.9,2630,2766,136
13301,GA,Warren,,2020,6.7,2461,2639,178
13301,GA,Warren,,2021,4.7,2558,2684,126
13303,GA,Washington,,2007,6.1,7821,8331,510
13303,GA,Washington,,2008,8.5,7510,8208,698
13303,GA,Washington,,2009,14.3,6801,7939,1138
13303,GA,Washington,,2010,14.7,6951,8150,1199
13303,GA,Washington,,2011,12.6,7075,8097,1022
13303,GA,Washington,,2012,10.2,7233,8054,821
13303,GA,Washington,,2013,9.6,6942,7677,735
13303,GA,Washington,,2014,8.1,6929,7542,613
13303,GA,Washington,,2015,7.1,6611,7117,506
13303,GA,Washington,,2016,6.4,6723,7184,461
13303,GA,Washington,,2017,5.9,6998,7440,442
13303,GA,Washington,,2018,5.1,6801,7164,363
13303,GA,Washington,,2019,4.3,6765,7070,305
13303,GA,Washington,,2020,6.4,6483,6924,441
13303,GA,Washington,,2021,5,6532,6875,343
13305,GA,Wayne,,2007,5.9,11360,12068,708
13305,GA,Wayne,,2008,8.3,11210,12227,1017
13305,GA,Wayne,,2009,12.3,10586,12073,1487
13305,GA,Wayne,,2010,12.2,10900,12412,1512
13305,GA,Wayne,,2011,12,10973,12470,1497
13305,GA,Wayne,,2012,10.5,11239,12561,1322
13305,GA,Wayne,,2013,9.7,11083,12273,1190
13305,GA,Wayne,,2014,8.8,10777,11814,1037
13305,GA,Wayne,,2015,7.4,10596,11439,843
13305,GA,Wayne,,2016,6.9,10512,11296,784
13305,GA,Wayne,,2017,5.7,10808,11467,659
13305,GA,Wayne,,2018,4.7,10886,11425,539
13305,GA,Wayne,,2019,4.2,11054,11535,481
13305,GA,Wayne,,2020,5.5,10916,11557,641
13305,GA,Wayne,,2021,3.7,11473,11919,446
13307,GA,Webster,,2007,4.9,1184,1245,61
13307,GA,Webster,,2008,5.6,1229,1302,73
13307,GA,Webster,,2009,10.5,1069,1194,125
13307,GA,Webster,,2010,13.1,910,1047,137
13307,GA,Webster,,2011,11.4,944,1066,122
13307,GA,Webster,,2012,9.8,954,1058,104
13307,GA,Webster,,2013,9.2,939,1034,95
13307,GA,Webster,,2014,8.6,926,1013,87
13307,GA,Webster,,2015,9.5,866,957,91
13307,GA,Webster,,2016,8.7,883,967,84
13307,GA,Webster,,2017,7.6,928,1004,76
13307,GA,Webster,,2018,6.3,938,1001,63
13307,GA,Webster,,2019,5.1,977,1029,52
13307,GA,Webster,,2020,5.6,958,1015,57
13307,GA,Webster,,2021,4.4,948,992,44
13309,GA,Wheeler,,2007,5.6,2799,2964,165
13309,GA,Wheeler,,2008,7.6,2701,2924,223
13309,GA,Wheeler,,2009,10.1,2637,2933,296
13309,GA,Wheeler,,2010,15.3,1646,1944,298
13309,GA,Wheeler,,2011,14.7,1688,1978,290
13309,GA,Wheeler,,2012,13.2,1694,1951,257
13309,GA,Wheeler,,2013,12.6,1655,1893,238
13309,GA,Wheeler,,2014,12.4,1633,1864,231
13309,GA,Wheeler,,2015,11,1491,1676,185
13309,GA,Wheeler,,2016,9.1,1576,1734,158
13309,GA,Wheeler,,2017,9,1598,1756,158
13309,GA,Wheeler,,2018,7.4,1547,1671,124
13309,GA,Wheeler,,2019,7.5,1552,1678,126
13309,GA,Wheeler,,2020,7.2,1495,1611,116
13309,GA,Wheeler,,2021,5.5,1547,1637,90
13311,GA,White,,2007,3.9,12382,12884,502
13311,GA,White,,2008,5.9,11872,12622,750
13311,GA,White,,2009,10.2,11127,12397,1270
13311,GA,White,,2010,10.3,11603,12941,1338
13311,GA,White,,2011,9.8,11848,13142,1294
13311,GA,White,,2012,8.5,12371,13524,1153
13311,GA,White,,2013,7.3,12766,13777,1011
13311,GA,White,,2014,6.2,12950,13812,862
13311,GA,White,,2015,5.3,12906,13625,719
13311,GA,White,,2016,4.7,13801,14481,680
13311,GA,White,,2017,3.9,15237,15854,617
13311,GA,White,,2018,3.1,15699,16198,499
13311,GA,White,,2019,2.8,16118,16583,465
13311,GA,White,,2020,4.3,15545,16247,702
13311,GA,White,,2021,2.5,16194,16616,422
13313,GA,Whitfield,,2007,4.9,44663,46987,2324
13313,GA,Whitfield,,2008,8.2,42432,46218,3786
13313,GA,Whitfield,,2009,13.4,38312,44219,5907
13313,GA,Whitfield,,2010,12,42030,47771,5741
13313,GA,Whitfield,,2011,11.7,41802,47341,5539
13313,GA,Whitfield,,2012,10.5,40804,45579,4775
13313,GA,Whitfield,,2013,9.5,40363,44598,4235
13313,GA,Whitfield,,2014,7.9,41146,44662,3516
13313,GA,Whitfield,,2015,6.5,42154,45084,2930
13313,GA,Whitfield,,2016,6.2,41968,44742,2774
13313,GA,Whitfield,,2017,5.5,42883,45374,2491
13313,GA,Whitfield,,2018,4.8,42939,45116,2177
13313,GA,Whitfield,,2019,4.6,41941,43978,2037
13313,GA,Whitfield,,2020,7.2,40013,43110,3097
13313,GA,Whitfield,,2021,3.9,41664,43361,1697
13315,GA,Wilcox,,2007,6.4,3093,3303,210
13315,GA,Wilcox,,2008,8.9,2983,3274,291
13315,GA,Wilcox,,2009,12.6,2849,3259,410
13315,GA,Wilcox,,2010,12.6,2573,2943,370
13315,GA,Wilcox,,2011,12.7,2555,2926,371
13315,GA,Wilcox,,2012,11.5,2528,2856,328
13315,GA,Wilcox,,2013,11,2504,2815,311
13315,GA,Wilcox,,2014,9.2,2577,2837,260
13315,GA,Wilcox,,2015,8,2496,2713,217
13315,GA,Wilcox,,2016,7.3,2521,2720,199
13315,GA,Wilcox,,2017,5.8,2629,2792,163
13315,GA,Wilcox,,2018,5.3,2545,2687,142
13315,GA,Wilcox,,2019,4.6,2594,2718,124
13315,GA,Wilcox,,2020,6,2588,2754,166
13315,GA,Wilcox,,2021,4.6,2649,2778,129
13317,GA,Wilkes,,2007,7.2,4246,4576,330
13317,GA,Wilkes,,2008,9,4265,4685,420
13317,GA,Wilkes,,2009,12.5,3942,4504,562
13317,GA,Wilkes,,2010,13.4,3491,4030,539
13317,GA,Wilkes,,2011,13.8,3381,3922,541
13317,GA,Wilkes,,2012,12,3366,3826,460
13317,GA,Wilkes,,2013,11.1,3317,3732,415
13317,GA,Wilkes,,2014,9.3,3382,3730,348
13317,GA,Wilkes,,2015,7.4,3564,3847,283
13317,GA,Wilkes,,2016,6.7,3459,3708,249
13317,GA,Wilkes,,2017,5.7,3633,3852,219
13317,GA,Wilkes,,2018,4.7,3652,3833,181
13317,GA,Wilkes,,2019,4.8,3634,3816,182
13317,GA,Wilkes,,2020,6.7,3397,3642,245
13317,GA,Wilkes,,2021,4.7,3486,3657,171
13319,GA,Wilkinson,,2007,5.8,4314,4582,268
13319,GA,Wilkinson,,2008,7.4,4397,4750,353
13319,GA,Wilkinson,,2009,11.6,4095,4634,539
13319,GA,Wilkinson,,2010,14.2,3307,3856,549
13319,GA,Wilkinson,,2011,12.8,3285,3768,483
13319,GA,Wilkinson,,2012,11.3,3302,3724,422
13319,GA,Wilkinson,,2013,10.3,3331,3712,381
13319,GA,Wilkinson,,2014,8.7,3388,3712,324
13319,GA,Wilkinson,,2015,7.4,3298,3563,265
13319,GA,Wilkinson,,2016,6.4,3416,3650,234
13319,GA,Wilkinson,,2017,5.7,3628,3847,219
13319,GA,Wilkinson,,2018,4.5,3680,3853,173
13319,GA,Wilkinson,,2019,3.9,3899,4057,158
13319,GA,Wilkinson,,2020,5.3,3600,3801,201
13319,GA,Wilkinson,,2021,4.2,3505,3657,152
13321,GA,Worth,,2007,5.8,9589,10181,592
13321,GA,Worth,,2008,7.2,9483,10224,741
13321,GA,Worth,,2009,10.6,9092,10166,1074
13321,GA,Worth,,2010,12.3,8607,9810,1203
13321,GA,Worth,,2011,11.4,8660,9777,1117
13321,GA,Worth,,2012,10,8625,9586,961
13321,GA,Worth,,2013,9.2,8387,9232,845
13321,GA,Worth,,2014,7.9,8223,8929,706
13321,GA,Worth,,2015,6.6,8168,8744,576
13321,GA,Worth,,2016,5.9,8586,9125,539
13321,GA,Worth,,2017,4.9,8899,9357,458
13321,GA,Worth,,2018,4.5,8565,8969,404
13321,GA,Worth,,2019,4,8700,9062,362
13321,GA,Worth,,2020,5.4,8335,8813,478
13321,GA,Worth,,2021,4,8536,8888,352
15000,HI,Hawaii,,2007,2.7,619224,636710,17486
15000,HI,Hawaii,,2008,4,615767,641526,25759
15000,HI,Hawaii,,2009,6.7,589798,631970,42172
15000,HI,Hawaii,,2010,6.8,604210,648549,44339
15000,HI,Hawaii,,2011,6.8,615470,660634,45164
15000,HI,Hawaii,,2012,5.9,611985,650415,38430
15000,HI,Hawaii,,2013,4.8,620005,650978,30973
15000,HI,Hawaii,,2014,4.2,635913,664014,28101
15000,HI,Hawaii,,2015,3.4,647616,670594,22978
15000,HI,Hawaii,,2016,2.9,659557,679121,19564
15000,HI,Hawaii,,2017,2.2,679865,695303,15438
15000,HI,Hawaii,,2018,2.4,675681,691982,16301
15000,HI,Hawaii,,2019,2.5,667914,684690,16776
15000,HI,Hawaii,,2020,12,582979,662491,79512
15000,HI,Hawaii,,2021,5.7,630187,668413,38226
15001,HI,Hawaii,,2007,3.5,81598,84547,2949
15001,HI,Hawaii,,2008,5.6,80269,85022,4753
15001,HI,Hawaii,,2009,9.5,75769,83751,7982
15001,HI,Hawaii,,2010,9.6,79996,88539,8543
15001,HI,Hawaii,,2011,9.8,80752,89478,8726
15001,HI,Hawaii,,2012,8.1,80231,87293,7062
15001,HI,Hawaii,,2013,6.4,81283,86854,5571
15001,HI,Hawaii,,2014,5.3,83722,88402,4680
15001,HI,Hawaii,,2015,4.2,85690,89418,3728
15001,HI,Hawaii,,2016,3.5,89228,92474,3246
15001,HI,Hawaii,,2017,2.6,92655,95104,2449
15001,HI,Hawaii,,2018,2.8,92033,94721,2688
15001,HI,Hawaii,,2019,3.1,90674,93600,2926
15001,HI,Hawaii,,2020,11.7,80942,91636,10694
15001,HI,Hawaii,,2021,5.5,88679,93848,5169
15003,HI,Honolulu,,2007,2.6,429940,441359,11419
15003,HI,Honolulu,,2008,3.6,429383,445353,15970
15003,HI,Honolulu,,2009,5.6,415520,440309,24789
15003,HI,Honolulu,,2010,5.9,418973,445120,26147
15003,HI,Honolulu,,2011,5.9,427287,454249,26962
15003,HI,Honolulu,,2012,5.3,424107,447994,23887
15003,HI,Honolulu,,2013,4.3,429206,448716,19510
15003,HI,Honolulu,,2014,4,438886,457070,18184
15003,HI,Honolulu,,2015,3.2,445679,460605,14926
15003,HI,Honolulu,,2016,2.7,450745,463370,12625
15003,HI,Honolulu,,2017,2.1,462531,472592,10061
15003,HI,Honolulu,,2018,2.3,458834,469477,10643
15003,HI,Honolulu,,2019,2.3,453077,463895,10818
15003,HI,Honolulu,,2020,10.5,402127,449402,47275
15003,HI,Honolulu,,2021,5.3,427780,451661,23881
15007,HI,Kauai,,2007,2.7,31716,32580,864
15007,HI,Kauai,,2008,4.5,31261,32737,1476
15007,HI,Kauai,,2009,9.1,29026,31942,2916
15007,HI,Kauai,,2010,8.5,31983,34970,2987
15007,HI,Kauai,,2011,8.6,32535,35588,3053
15007,HI,Kauai,,2012,7.1,32275,34727,2452
15007,HI,Kauai,,2013,5.4,32813,34675,1862
15007,HI,Kauai,,2014,4.6,33718,35343,1625
15007,HI,Kauai,,2015,3.8,34485,35836,1351
15007,HI,Kauai,,2016,3.1,35468,36587,1119
15007,HI,Kauai,,2017,2.2,37008,37831,823
15007,HI,Kauai,,2018,2.4,36616,37508,892
15007,HI,Kauai,,2019,2.4,36770,37682,912
15007,HI,Kauai,,2020,16.6,30307,36330,6023
15007,HI,Kauai,,2021,7.8,33153,35949,2796
15009,HI,Maui,,2007,2.9,75971,78225,2254
15009,HI,Maui,,2008,4.5,74853,78413,3560
15009,HI,Maui,,2009,8.5,69483,75969,6486
15009,HI,Maui,,2010,8.3,73258,79920,6662
15009,HI,Maui,,2011,7.9,74896,81320,6424
15009,HI,Maui,,2012,6.3,75371,80401,5030
15009,HI,Maui,,2013,5,76704,80734,4030
15009,HI,Maui,,2014,4.3,79587,83200,3613
15009,HI,Maui,,2015,3.5,81762,84736,2974
15009,HI,Maui,,2016,3,84117,86690,2573
15009,HI,Maui,,2017,2.3,87671,89776,2105
15009,HI,Maui,,2018,2.3,88198,90276,2078
15009,HI,Maui,,2019,2.4,87393,89513,2120
15009,HI,Maui,,2020,18.2,69603,85122,15519
15009,HI,Maui,,2021,7.3,80575,86954,6379
16000,ID,Idaho,,2007,3.1,732155,755287,23132
16000,ID,Idaho,,2008,5,721828,759676,37848
16000,ID,Idaho,,2009,8.7,696832,763633,66801
16000,ID,Idaho,,2010,8.8,695265,762147,66882
16000,ID,Idaho,,2011,8.2,701660,764205,62545
16000,ID,Idaho,,2012,7.4,714969,772112,57143
16000,ID,Idaho,,2013,6.8,724545,777606,53061
16000,ID,Idaho,,2014,4.4,742805,776937,34132
16000,ID,Idaho,,2015,3.9,764121,795014,30893
16000,ID,Idaho,,2016,3.7,783180,812921,29741
16000,ID,Idaho,,2017,3.2,812875,839776,26901
16000,ID,Idaho,,2018,2.9,837514,862513,24999
16000,ID,Idaho,,2019,3,862864,889194,26330
16000,ID,Idaho,,2020,5.5,848741,897739,48998
16000,ID,Idaho,,2021,3.6,884328,917056,32728
16001,ID,Ada,,2007,2.7,191741,196976,5235
16001,ID,Ada,,2008,4.8,188197,197620,9423
16001,ID,Ada,,2009,8.9,180477,198030,17553
16001,ID,Ada,,2010,8.1,181222,197285,16063
16001,ID,Ada,,2011,7.2,185656,200106,14450
16001,ID,Ada,,2012,6.3,192057,205064,13007
16001,ID,Ada,,2013,5.8,196090,208167,12077
16001,ID,Ada,,2014,3.8,203035,210952,7917
16001,ID,Ada,,2015,3.4,210124,217455,7331
16001,ID,Ada,,2016,3.2,217925,225135,7210
16001,ID,Ada,,2017,2.8,229402,236081,6679
16001,ID,Ada,,2018,2.5,240076,246302,6226
16001,ID,Ada,,2019,2.6,249853,256429,6576
16001,ID,Ada,,2020,5.5,245265,259488,14223
16001,ID,Ada,,2021,3.3,258240,266936,8696
16003,ID,Adams,,2007,5.7,1886,2001,115
16003,ID,Adams,,2008,10.4,1722,1921,199
16003,ID,Adams,,2009,16.4,1792,2143,351
16003,ID,Adams,,2010,18,1521,1856,335
16003,ID,Adams,,2011,17.5,1433,1737,304
16003,ID,Adams,,2012,15.2,1485,1752,267
16003,ID,Adams,,2013,15,1478,1738,260
16003,ID,Adams,,2014,9.2,1510,1663,153
16003,ID,Adams,,2015,7.1,1591,1712,121
16003,ID,Adams,,2016,6.7,1624,1740,116
16003,ID,Adams,,2017,5.7,1659,1760,101
16003,ID,Adams,,2018,5.5,1634,1730,96
16003,ID,Adams,,2019,6.9,1615,1734,119
16003,ID,Adams,,2020,9.6,1606,1776,170
16003,ID,Adams,,2021,6.6,1685,1804,119
16005,ID,Bannock,,2007,3,40114,41338,1224
16005,ID,Bannock,,2008,4.6,37990,39831,1841
16005,ID,Bannock,,2009,7.8,36584,39682,3098
16005,ID,Bannock,,2010,7.8,37947,41151,3204
16005,ID,Bannock,,2011,7.4,37992,41010,3018
16005,ID,Bannock,,2012,7.1,38418,41349,2931
16005,ID,Bannock,,2013,6.5,39047,41765,2718
16005,ID,Bannock,,2014,4.1,39661,41367,1706
16005,ID,Bannock,,2015,3.7,40372,41928,1556
16005,ID,Bannock,,2016,3.5,39648,41066,1418
16005,ID,Bannock,,2017,3.1,40502,41785,1283
16005,ID,Bannock,,2018,2.8,40820,41994,1174
16005,ID,Bannock,,2019,2.9,41720,42950,1230
16005,ID,Bannock,,2020,5,40211,42314,2103
16005,ID,Bannock,,2021,3.6,41215,42735,1520
16007,ID,Bear Lake,,2007,2.3,3089,3162,73
16007,ID,Bear Lake,,2008,3.3,3215,3324,109
16007,ID,Bear Lake,,2009,5.9,3193,3394,201
16007,ID,Bear Lake,,2010,7.2,2679,2887,208
16007,ID,Bear Lake,,2011,6,2745,2919,174
16007,ID,Bear Lake,,2012,5.7,2726,2891,165
16007,ID,Bear Lake,,2013,5.7,2739,2905,166
16007,ID,Bear Lake,,2014,4.1,2733,2850,117
16007,ID,Bear Lake,,2015,4.2,2714,2832,118
16007,ID,Bear Lake,,2016,4.4,2684,2808,124
16007,ID,Bear Lake,,2017,3.2,2758,2849,91
16007,ID,Bear Lake,,2018,2.9,2790,2873,83
16007,ID,Bear Lake,,2019,3,2910,2999,89
16007,ID,Bear Lake,,2020,4.3,2956,3088,132
16007,ID,Bear Lake,,2021,3,3027,3121,94
16009,ID,Benewah,,2007,6.1,3816,4065,249
16009,ID,Benewah,,2008,9.8,3694,4097,403
16009,ID,Benewah,,2009,15,3581,4214,633
16009,ID,Benewah,,2010,13.3,3649,4208,559
16009,ID,Benewah,,2011,13,3601,4140,539
16009,ID,Benewah,,2012,12.4,3660,4180,520
16009,ID,Benewah,,2013,11.1,3593,4043,450
16009,ID,Benewah,,2014,7.4,3649,3940,291
16009,ID,Benewah,,2015,6.1,3786,4031,245
16009,ID,Benewah,,2016,5.7,3778,4007,229
16009,ID,Benewah,,2017,5.6,3808,4033,225
16009,ID,Benewah,,2018,4.6,3855,4041,186
16009,ID,Benewah,,2019,5.3,3902,4121,219
16009,ID,Benewah,,2020,7.7,3843,4164,321
16009,ID,Benewah,,2021,5.6,3864,4092,228
16011,ID,Bingham,,2007,2.6,21679,22266,587
16011,ID,Bingham,,2008,3.9,21637,22523,886
16011,ID,Bingham,,2009,6.6,20573,22016,1443
16011,ID,Bingham,,2010,7,21276,22875,1599
16011,ID,Bingham,,2011,7,21226,22816,1590
16011,ID,Bingham,,2012,6.5,21357,22849,1492
16011,ID,Bingham,,2013,6.5,21020,22488,1468
16011,ID,Bingham,,2014,4.1,21079,21977,898
16011,ID,Bingham,,2015,3.8,21234,22072,838
16011,ID,Bingham,,2016,3.4,22007,22783,776
16011,ID,Bingham,,2017,3,22496,23189,693
16011,ID,Bingham,,2018,2.8,22798,23447,649
16011,ID,Bingham,,2019,2.7,23330,23979,649
16011,ID,Bingham,,2020,3.9,22984,23923,939
16011,ID,Bingham,,2021,3.2,23503,24278,775
16013,ID,Blaine,,2007,2.3,13373,13693,320
16013,ID,Blaine,,2008,3.8,13280,13810,530
16013,ID,Blaine,,2009,8.3,12340,13462,1122
16013,ID,Blaine,,2010,9.4,10846,11972,1126
16013,ID,Blaine,,2011,8.6,10850,11870,1020
16013,ID,Blaine,,2012,7.2,10922,11770,848
16013,ID,Blaine,,2013,6.4,10940,11684,744
16013,ID,Blaine,,2014,4.1,10954,11418,464
16013,ID,Blaine,,2015,3.3,11449,11839,390
16013,ID,Blaine,,2016,3,11482,11843,361
16013,ID,Blaine,,2017,2.6,11992,12310,318
16013,ID,Blaine,,2018,2.4,12111,12411,300
16013,ID,Blaine,,2019,2.7,12116,12447,331
16013,ID,Blaine,,2020,7.9,11790,12800,1010
16013,ID,Blaine,,2021,3.6,12416,12885,469
16015,ID,Boise,,2007,3.4,3457,3579,122
16015,ID,Boise,,2008,5.9,3297,3502,205
16015,ID,Boise,,2009,9,3107,3414,307
16015,ID,Boise,,2010,10.4,2736,3054,318
16015,ID,Boise,,2011,10.1,2749,3059,310
16015,ID,Boise,,2012,9.7,2690,2980,290
16015,ID,Boise,,2013,9,2687,2954,267
16015,ID,Boise,,2014,6,2730,2903,173
16015,ID,Boise,,2015,5.9,2870,3049,179
16015,ID,Boise,,2016,5.1,2935,3092,157
16015,ID,Boise,,2017,4.8,3072,3227,155
16015,ID,Boise,,2018,4.3,3264,3409,145
16015,ID,Boise,,2019,4.4,3395,3550,155
16015,ID,Boise,,2020,8.1,3353,3647,294
16015,ID,Boise,,2021,5.4,3532,3734,202
16017,ID,Bonner,,2007,3.9,19870,20666,796
16017,ID,Bonner,,2008,6.5,19200,20529,1329
16017,ID,Bonner,,2009,11.1,18795,21143,2348
16017,ID,Bonner,,2010,12.7,17040,19521,2481
16017,ID,Bonner,,2011,12.2,16700,19012,2312
16017,ID,Bonner,,2012,10.7,16691,18696,2005
16017,ID,Bonner,,2013,9.7,16695,18497,1802
16017,ID,Bonner,,2014,6.5,16937,18116,1179
16017,ID,Bonner,,2015,5.5,17493,18517,1024
16017,ID,Bonner,,2016,5.3,17879,18871,992
16017,ID,Bonner,,2017,4.5,18510,19387,877
16017,ID,Bonner,,2018,4.2,18969,19792,823
16017,ID,Bonner,,2019,4.3,19390,20253,863
16017,ID,Bonner,,2020,7.7,19536,21174,1638
16017,ID,Bonner,,2021,4.8,20519,21552,1033
16019,ID,Bonneville,,2007,2.2,49228,50341,1113
16019,ID,Bonneville,,2008,3.5,48695,50465,1770
16019,ID,Bonneville,,2009,6.3,47286,50490,3204
16019,ID,Bonneville,,2010,6.7,45843,49159,3316
16019,ID,Bonneville,,2011,6.8,45938,49274,3336
16019,ID,Bonneville,,2012,6.5,46104,49290,3186
16019,ID,Bonneville,,2013,6.1,46351,49346,2995
16019,ID,Bonneville,,2014,3.8,47550,49418,1868
16019,ID,Bonneville,,2015,3.2,49414,51063,1649
16019,ID,Bonneville,,2016,3.1,50762,52377,1615
16019,ID,Bonneville,,2017,2.7,52459,53921,1462
16019,ID,Bonneville,,2018,2.5,54180,55541,1361
16019,ID,Bonneville,,2019,2.4,56173,57575,1402
16019,ID,Bonneville,,2020,4.1,56095,58505,2410
16019,ID,Bonneville,,2021,2.9,58722,60471,1749
16021,ID,Boundary,,2007,6.2,4296,4580,284
16021,ID,Boundary,,2008,8.6,4216,4612,396
16021,ID,Boundary,,2009,13.6,3846,4450,604
16021,ID,Boundary,,2010,13.2,4664,5372,708
16021,ID,Boundary,,2011,11.4,4764,5375,611
16021,ID,Boundary,,2012,9.7,4737,5243,506
16021,ID,Boundary,,2013,8.8,4522,4960,438
16021,ID,Boundary,,2014,5.5,4616,4885,269
16021,ID,Boundary,,2015,5.1,4829,5089,260
16021,ID,Boundary,,2016,5,4841,5098,257
16021,ID,Boundary,,2017,4.8,4938,5186,248
16021,ID,Boundary,,2018,4.5,5060,5296,236
16021,ID,Boundary,,2019,4.6,5162,5409,247
16021,ID,Boundary,,2020,6.4,5186,5538,352
16021,ID,Boundary,,2021,4.4,5353,5597,244
16023,ID,Butte,,2007,2.5,1337,1371,34
16023,ID,Butte,,2008,4.2,1320,1378,58
16023,ID,Butte,,2009,5.7,1399,1484,85
16023,ID,Butte,,2010,7,1259,1354,95
16023,ID,Butte,,2011,7.9,1217,1322,105
16023,ID,Butte,,2012,8.4,1229,1341,112
16023,ID,Butte,,2013,7.6,1209,1309,100
16023,ID,Butte,,2014,4.9,1233,1297,64
16023,ID,Butte,,2015,4.2,1224,1278,54
16023,ID,Butte,,2016,4,1241,1293,52
16023,ID,Butte,,2017,3,1301,1341,40
16023,ID,Butte,,2018,3.3,1326,1371,45
16023,ID,Butte,,2019,2.7,1349,1386,37
16023,ID,Butte,,2020,3.7,1343,1394,51
16023,ID,Butte,,2021,3.8,1392,1447,55
16025,ID,Camas,,2007,2.6,603,619,16
16025,ID,Camas,,2008,4.4,607,635,28
16025,ID,Camas,,2009,10.4,540,603,63
16025,ID,Camas,,2010,12.6,563,644,81
16025,ID,Camas,,2011,12.2,560,638,78
16025,ID,Camas,,2012,9.5,609,673,64
16025,ID,Camas,,2013,7.2,594,640,46
16025,ID,Camas,,2014,4.9,598,629,31
16025,ID,Camas,,2015,3.2,628,649,21
16025,ID,Camas,,2016,3.5,635,658,23
16025,ID,Camas,,2017,2.8,668,687,19
16025,ID,Camas,,2018,2.3,676,692,16
16025,ID,Camas,,2019,2.9,668,688,20
16025,ID,Camas,,2020,4.9,657,691,34
16025,ID,Camas,,2021,3.4,680,704,24
16027,ID,Canyon,,2007,3.7,80281,83360,3079
16027,ID,Canyon,,2008,6.4,79206,84581,5375
16027,ID,Canyon,,2009,11.2,76313,85964,9651
16027,ID,Canyon,,2010,11.1,75463,84900,9437
16027,ID,Canyon,,2011,10.5,76517,85454,8937
16027,ID,Canyon,,2012,9.4,79199,87374,8175
16027,ID,Canyon,,2013,8.4,81246,88688,7442
16027,ID,Canyon,,2014,5.4,83805,88575,4770
16027,ID,Canyon,,2015,4.6,86781,91002,4221
16027,ID,Canyon,,2016,4.2,89622,93555,3933
16027,ID,Canyon,,2017,3.6,93690,97206,3516
16027,ID,Canyon,,2018,3.2,98059,101255,3196
16027,ID,Canyon,,2019,3.3,102201,105652,3451
16027,ID,Canyon,,2020,6,100806,107190,6384
16027,ID,Canyon,,2021,4,105885,110244,4359
16029,ID,Caribou,,2007,2.9,3756,3867,111
16029,ID,Caribou,,2008,3.6,3782,3924,142
16029,ID,Caribou,,2009,6.6,3262,3494,232
16029,ID,Caribou,,2010,7.6,3553,3845,292
16029,ID,Caribou,,2011,7.3,3596,3879,283
16029,ID,Caribou,,2012,6.2,3738,3986,248
16029,ID,Caribou,,2013,5.9,3697,3928,231
16029,ID,Caribou,,2014,3.8,3691,3838,147
16029,ID,Caribou,,2015,3.8,3624,3768,144
16029,ID,Caribou,,2016,3.5,3661,3792,131
16029,ID,Caribou,,2017,3.1,3768,3890,122
16029,ID,Caribou,,2018,2.8,3785,3895,110
16029,ID,Caribou,,2019,2.7,4032,4145,113
16029,ID,Caribou,,2020,3.7,3972,4123,151
16029,ID,Caribou,,2021,3.1,4000,4128,128
16031,ID,Cassia,,2007,3.2,10466,10807,341
16031,ID,Cassia,,2008,3.8,10630,11054,424
16031,ID,Cassia,,2009,5.9,9666,10277,611
16031,ID,Cassia,,2010,6.9,10363,11127,764
16031,ID,Cassia,,2011,6.4,10462,11182,720
16031,ID,Cassia,,2012,5.9,10491,11151,660
16031,ID,Cassia,,2013,5.8,10551,11203,652
16031,ID,Cassia,,2014,3.8,10768,11199,431
16031,ID,Cassia,,2015,3.1,11120,11476,356
16031,ID,Cassia,,2016,2.9,11254,11589,335
16031,ID,Cassia,,2017,2.5,11505,11801,296
16031,ID,Cassia,,2018,2.3,11588,11856,268
16031,ID,Cassia,,2019,2.5,11950,12252,302
16031,ID,Cassia,,2020,3.7,11982,12447,465
16031,ID,Cassia,,2021,2.9,12248,12613,365
16033,ID,Clark,,2007,2.3,541,554,13
16033,ID,Clark,,2008,3.5,579,600,21
16033,ID,Clark,,2009,6,521,554,33
16033,ID,Clark,,2010,9.1,488,537,49
16033,ID,Clark,,2011,8.7,470,515,45
16033,ID,Clark,,2012,7.7,393,426,33
16033,ID,Clark,,2013,7,398,428,30
16033,ID,Clark,,2014,4.3,422,441,19
16033,ID,Clark,,2015,3.5,382,396,14
16033,ID,Clark,,2016,3.1,381,393,12
16033,ID,Clark,,2017,3,389,401,12
16033,ID,Clark,,2018,3.1,372,384,12
16033,ID,Clark,,2019,3.9,365,380,15
16033,ID,Clark,,2020,4,363,378,15
16033,ID,Clark,,2021,3.2,365,377,12
16035,ID,Clearwater,,2007,7.5,2971,3211,240
16035,ID,Clearwater,,2008,10.7,2885,3230,345
16035,ID,Clearwater,,2009,14.8,3028,3556,528
16035,ID,Clearwater,,2010,14.3,2932,3420,488
16035,ID,Clearwater,,2011,13.4,2897,3344,447
16035,ID,Clearwater,,2012,12.8,2865,3287,422
16035,ID,Clearwater,,2013,12.5,2832,3235,403
16035,ID,Clearwater,,2014,8.5,2842,3105,263
16035,ID,Clearwater,,2015,7.5,2848,3078,230
16035,ID,Clearwater,,2016,7.1,2830,3045,215
16035,ID,Clearwater,,2017,7,2815,3026,211
16035,ID,Clearwater,,2018,6.9,2732,2934,202
16035,ID,Clearwater,,2019,6.8,2724,2924,200
16035,ID,Clearwater,,2020,8.4,2787,3044,257
16035,ID,Clearwater,,2021,6.5,2837,3033,196
16037,ID,Custer,,2007,3.4,2252,2332,80
16037,ID,Custer,,2008,4.5,2343,2453,110
16037,ID,Custer,,2009,6.1,2536,2701,165
16037,ID,Custer,,2010,8,2114,2297,183
16037,ID,Custer,,2011,7.7,2119,2297,178
16037,ID,Custer,,2012,8.3,2150,2345,195
16037,ID,Custer,,2013,9.3,2027,2234,207
16037,ID,Custer,,2014,6.3,1991,2125,134
16037,ID,Custer,,2015,6.2,1996,2127,131
16037,ID,Custer,,2016,4.9,2033,2138,105
16037,ID,Custer,,2017,4.3,2081,2174,93
16037,ID,Custer,,2018,4.1,2107,2196,89
16037,ID,Custer,,2019,4.2,2145,2240,95
16037,ID,Custer,,2020,5.1,2125,2239,114
16037,ID,Custer,,2021,4.7,2173,2279,106
16039,ID,Elmore,,2007,3.9,10822,11261,439
16039,ID,Elmore,,2008,5.6,10812,11448,636
16039,ID,Elmore,,2009,8.5,10528,11506,978
16039,ID,Elmore,,2010,8.5,10447,11413,966
16039,ID,Elmore,,2011,8.2,10095,10994,899
16039,ID,Elmore,,2012,7.7,9891,10720,829
16039,ID,Elmore,,2013,7.5,10072,10885,813
16039,ID,Elmore,,2014,4.7,10438,10958,520
16039,ID,Elmore,,2015,4.4,10274,10745,471
16039,ID,Elmore,,2016,4,10511,10948,437
16039,ID,Elmore,,2017,3.7,10850,11263,413
16039,ID,Elmore,,2018,3.3,11091,11472,381
16039,ID,Elmore,,2019,3.3,11275,11662,387
16039,ID,Elmore,,2020,4.9,11323,11910,587
16039,ID,Elmore,,2021,3.7,11566,12015,449
16041,ID,Franklin,,2007,2.2,5633,5757,124
16041,ID,Franklin,,2008,3.3,5539,5727,188
16041,ID,Franklin,,2009,5.5,5521,5844,323
16041,ID,Franklin,,2010,5.1,5888,6205,317
16041,ID,Franklin,,2011,5.3,5914,6244,330
16041,ID,Franklin,,2012,4.7,6031,6330,299
16041,ID,Franklin,,2013,4.6,6013,6305,292
16041,ID,Franklin,,2014,3,6192,6386,194
16041,ID,Franklin,,2015,2.9,6274,6461,187
16041,ID,Franklin,,2016,3,6442,6639,197
16041,ID,Franklin,,2017,2.3,6641,6798,157
16041,ID,Franklin,,2018,2.2,6763,6915,152
16041,ID,Franklin,,2019,2.4,6966,7135,169
16041,ID,Franklin,,2020,3.6,6922,7182,260
16041,ID,Franklin,,2021,2.5,7187,7369,182
16043,ID,Fremont,,2007,3.3,5593,5783,190
16043,ID,Fremont,,2008,4.8,5517,5798,281
16043,ID,Fremont,,2009,8.9,5103,5601,498
16043,ID,Fremont,,2010,8.5,6184,6759,575
16043,ID,Fremont,,2011,7.6,6190,6700,510
16043,ID,Fremont,,2012,6.3,6511,6952,441
16043,ID,Fremont,,2013,5.9,6560,6968,408
16043,ID,Fremont,,2014,3.7,6698,6955,257
16043,ID,Fremont,,2015,3.4,6943,7185,242
16043,ID,Fremont,,2016,3.3,7127,7367,240
16043,ID,Fremont,,2017,2.7,7463,7667,204
16043,ID,Fremont,,2018,2.5,7632,7824,192
16043,ID,Fremont,,2019,2.4,7633,7818,185
16043,ID,Fremont,,2020,3.7,7625,7922,297
16043,ID,Fremont,,2021,2.9,7955,8191,236
16045,ID,Gem,,2007,3.8,6834,7105,271
16045,ID,Gem,,2008,7,6582,7076,494
16045,ID,Gem,,2009,11.7,6223,7047,824
16045,ID,Gem,,2010,11.3,6827,7696,869
16045,ID,Gem,,2011,10.7,6877,7699,822
16045,ID,Gem,,2012,9.7,6910,7650,740
16045,ID,Gem,,2013,8.7,6921,7581,660
16045,ID,Gem,,2014,5.4,7074,7475,401
16045,ID,Gem,,2015,4.9,7164,7532,368
16045,ID,Gem,,2016,4.5,7373,7723,350
16045,ID,Gem,,2017,4,7605,7922,317
16045,ID,Gem,,2018,3.5,7818,8103,285
16045,ID,Gem,,2019,3.4,8115,8397,282
16045,ID,Gem,,2020,6,8010,8519,509
16045,ID,Gem,,2021,4.1,8380,8739,359
16047,ID,Gooding,,2007,2.2,8623,8815,192
16047,ID,Gooding,,2008,3.4,8494,8790,296
16047,ID,Gooding,,2009,6.2,7927,8453,526
16047,ID,Gooding,,2010,7.2,7890,8506,616
16047,ID,Gooding,,2011,6.6,7793,8345,552
16047,ID,Gooding,,2012,5.8,7645,8119,474
16047,ID,Gooding,,2013,5.5,7647,8091,444
16047,ID,Gooding,,2014,3.6,7672,7960,288
16047,ID,Gooding,,2015,3.2,7731,7988,257
16047,ID,Gooding,,2016,3,7759,7997,238
16047,ID,Gooding,,2017,2.5,7877,8077,200
16047,ID,Gooding,,2018,2.4,7947,8145,198
16047,ID,Gooding,,2019,2.7,8066,8286,220
16047,ID,Gooding,,2020,3.9,7977,8300,323
16047,ID,Gooding,,2021,3.1,8117,8381,264
16049,ID,Idaho,,2007,5.1,6726,7086,360
16049,ID,Idaho,,2008,7.4,6638,7171,533
16049,ID,Idaho,,2009,11.1,6599,7425,826
16049,ID,Idaho,,2010,12.2,5845,6660,815
16049,ID,Idaho,,2011,12.1,5863,6670,807
16049,ID,Idaho,,2012,11.2,5932,6679,747
16049,ID,Idaho,,2013,11,5938,6670,732
16049,ID,Idaho,,2014,6.9,6004,6447,443
16049,ID,Idaho,,2015,5.8,6023,6392,369
16049,ID,Idaho,,2016,5.5,5986,6334,348
16049,ID,Idaho,,2017,5,6038,6353,315
16049,ID,Idaho,,2018,4.7,6166,6473,307
16049,ID,Idaho,,2019,4.6,6331,6633,302
16049,ID,Idaho,,2020,6.8,6279,6738,459
16049,ID,Idaho,,2021,4.9,6487,6822,335
16051,ID,Jefferson,,2007,2.5,10861,11134,273
16051,ID,Jefferson,,2008,3.7,10925,11350,425
16051,ID,Jefferson,,2009,7,10789,11603,814
16051,ID,Jefferson,,2010,6.8,11762,12625,863
16051,ID,Jefferson,,2011,6.8,11648,12494,846
16051,ID,Jefferson,,2012,6.3,11468,12238,770
16051,ID,Jefferson,,2013,5.7,11536,12233,697
16051,ID,Jefferson,,2014,3.6,11765,12210,445
16051,ID,Jefferson,,2015,3.2,12089,12484,395
16051,ID,Jefferson,,2016,3,12439,12823,384
16051,ID,Jefferson,,2017,2.6,12833,13169,336
16051,ID,Jefferson,,2018,2.3,13380,13695,315
16051,ID,Jefferson,,2019,2.4,13774,14107,333
16051,ID,Jefferson,,2020,3.5,13703,14201,498
16051,ID,Jefferson,,2021,2.7,14274,14673,399
16053,ID,Jerome,,2007,2.8,9558,9838,280
16053,ID,Jerome,,2008,4.2,9610,10028,418
16053,ID,Jerome,,2009,7.1,9791,10539,748
16053,ID,Jerome,,2010,7.8,10155,11016,861
16053,ID,Jerome,,2011,7.4,10200,11012,812
16053,ID,Jerome,,2012,6.6,10191,10914,723
16053,ID,Jerome,,2013,6,10263,10913,650
16053,ID,Jerome,,2014,3.6,10738,11139,401
16053,ID,Jerome,,2015,3.1,10999,11347,348
16053,ID,Jerome,,2016,3.1,10998,11344,346
16053,ID,Jerome,,2017,2.8,11388,11719,331
16053,ID,Jerome,,2018,2.6,11740,12051,311
16053,ID,Jerome,,2019,2.6,12023,12348,325
16053,ID,Jerome,,2020,4.1,11674,12174,500
16053,ID,Jerome,,2021,3.3,11936,12348,412
16055,ID,Kootenai,,2007,3.3,67190,69508,2318
16055,ID,Kootenai,,2008,5.7,67133,71186,4053
16055,ID,Kootenai,,2009,10.1,64368,71593,7225
16055,ID,Kootenai,,2010,10.7,61560,68944,7384
16055,ID,Kootenai,,2011,10,62318,69223,6905
16055,ID,Kootenai,,2012,9,62746,68936,6190
16055,ID,Kootenai,,2013,8.1,64285,69959,5674
16055,ID,Kootenai,,2014,5.3,66441,70152,3711
16055,ID,Kootenai,,2015,4.7,68225,71601,3376
16055,ID,Kootenai,,2016,4.5,70446,73762,3316
16055,ID,Kootenai,,2017,3.9,73269,76222,2953
16055,ID,Kootenai,,2018,3.5,75468,78234,2766
16055,ID,Kootenai,,2019,3.6,77878,80800,2922
16055,ID,Kootenai,,2020,7.1,76149,81939,5790
16055,ID,Kootenai,,2021,4.3,79179,82719,3540
16057,ID,Latah,,2007,2.7,16556,17023,467
16057,ID,Latah,,2008,4.1,16574,17287,713
16057,ID,Latah,,2009,6.8,16729,17947,1218
16057,ID,Latah,,2010,6.4,18066,19308,1242
16057,ID,Latah,,2011,6.1,18050,19231,1181
16057,ID,Latah,,2012,6,18522,19696,1174
16057,ID,Latah,,2013,5.5,18492,19564,1072
16057,ID,Latah,,2014,3.7,18526,19229,703
16057,ID,Latah,,2015,3.2,18875,19499,624
16057,ID,Latah,,2016,3.1,19281,19892,611
16057,ID,Latah,,2017,2.7,19649,20187,538
16057,ID,Latah,,2018,2.5,19799,20312,513
16057,ID,Latah,,2019,2.7,20082,20640,558
16057,ID,Latah,,2020,4.9,18787,19745,958
16057,ID,Latah,,2021,3.3,19197,19857,660
16059,ID,Lemhi,,2007,4.6,3577,3749,172
16059,ID,Lemhi,,2008,6.7,3438,3686,248
16059,ID,Lemhi,,2009,9,3649,4012,363
16059,ID,Lemhi,,2010,10,3402,3780,378
16059,ID,Lemhi,,2011,10.1,3292,3661,369
16059,ID,Lemhi,,2012,10.1,3223,3584,361
16059,ID,Lemhi,,2013,10.4,3119,3480,361
16059,ID,Lemhi,,2014,7.2,3100,3339,239
16059,ID,Lemhi,,2015,6.5,3153,3373,220
16059,ID,Lemhi,,2016,5.9,3202,3403,201
16059,ID,Lemhi,,2017,5.2,3318,3500,182
16059,ID,Lemhi,,2018,4.5,3370,3529,159
16059,ID,Lemhi,,2019,4.8,3414,3586,172
16059,ID,Lemhi,,2020,6.8,3405,3654,249
16059,ID,Lemhi,,2021,5.3,3515,3713,198
16061,ID,Lewis,,2007,2.6,1660,1705,45
16061,ID,Lewis,,2008,3.8,1633,1698,65
16061,ID,Lewis,,2009,6.1,1686,1795,109
16061,ID,Lewis,,2010,6.5,1471,1573,102
16061,ID,Lewis,,2011,6.1,1458,1553,95
16061,ID,Lewis,,2012,5.6,1513,1602,89
16061,ID,Lewis,,2013,5.6,1533,1624,91
16061,ID,Lewis,,2014,4.1,1523,1588,65
16061,ID,Lewis,,2015,5.3,1506,1590,84
16061,ID,Lewis,,2016,6.2,1524,1624,100
16061,ID,Lewis,,2017,5.8,1530,1625,95
16061,ID,Lewis,,2018,5.6,1538,1629,91
16061,ID,Lewis,,2019,5.6,1556,1648,92
16061,ID,Lewis,,2020,7.9,1527,1658,131
16061,ID,Lewis,,2021,5.7,1567,1661,94
16063,ID,Lincoln,,2007,3.5,2479,2568,89
16063,ID,Lincoln,,2008,5.6,2443,2587,144
16063,ID,Lincoln,,2009,12,2295,2607,312
16063,ID,Lincoln,,2010,13,2363,2715,352
16063,ID,Lincoln,,2011,11.8,2362,2678,316
16063,ID,Lincoln,,2012,9.5,2456,2713,257
16063,ID,Lincoln,,2013,8.4,2449,2675,226
16063,ID,Lincoln,,2014,5.3,2455,2593,138
16063,ID,Lincoln,,2015,4.2,2531,2642,111
16063,ID,Lincoln,,2016,4.3,2525,2639,114
16063,ID,Lincoln,,2017,3.2,2633,2721,88
16063,ID,Lincoln,,2018,3.5,2628,2722,94
16063,ID,Lincoln,,2019,3.6,2600,2698,98
16063,ID,Lincoln,,2020,6.1,2496,2657,161
16063,ID,Lincoln,,2021,4.4,2578,2698,120
16065,ID,Madison,,2007,2.2,16105,16460,355
16065,ID,Madison,,2008,3.5,16193,16778,585
16065,ID,Madison,,2009,6.1,15204,16185,981
16065,ID,Madison,,2010,5.2,16604,17513,909
16065,ID,Madison,,2011,5.2,16965,17887,922
16065,ID,Madison,,2012,4.7,17624,18488,864
16065,ID,Madison,,2013,4.6,17717,18563,846
16065,ID,Madison,,2014,2.9,18423,18969,546
16065,ID,Madison,,2015,2.5,19315,19808,493
16065,ID,Madison,,2016,2.3,20083,20565,482
16065,ID,Madison,,2017,1.9,20918,21323,405
16065,ID,Madison,,2018,1.7,21397,21778,381
16065,ID,Madison,,2019,1.9,21774,22187,413
16065,ID,Madison,,2020,2.8,21780,22398,618
16065,ID,Madison,,2021,2.2,22810,23322,512
16067,ID,Minidoka,,2007,3.9,9671,10062,391
16067,ID,Minidoka,,2008,4.5,9685,10139,454
16067,ID,Minidoka,,2009,6.7,8935,9576,641
16067,ID,Minidoka,,2010,7.2,9725,10478,753
16067,ID,Minidoka,,2011,6.8,9834,10549,715
16067,ID,Minidoka,,2012,6.2,9769,10416,647
16067,ID,Minidoka,,2013,6.2,9821,10466,645
16067,ID,Minidoka,,2014,4.1,9938,10367,429
16067,ID,Minidoka,,2015,3.4,10333,10698,365
16067,ID,Minidoka,,2016,3.1,10535,10871,336
16067,ID,Minidoka,,2017,2.7,10769,11067,298
16067,ID,Minidoka,,2018,2.5,10819,11101,282
16067,ID,Minidoka,,2019,2.6,11205,11499,294
16067,ID,Minidoka,,2020,3.9,11226,11686,460
16067,ID,Minidoka,,2021,3.1,11480,11852,372
16069,ID,Nez Perce,,2007,3,18460,19032,572
16069,ID,Nez Perce,,2008,4.5,17834,18673,839
16069,ID,Nez Perce,,2009,6.8,17589,18866,1277
16069,ID,Nez Perce,,2010,6.5,18811,20116,1305
16069,ID,Nez Perce,,2011,6.2,18822,20069,1247
16069,ID,Nez Perce,,2012,5.9,18770,19945,1175
16069,ID,Nez Perce,,2013,5.5,19242,20372,1130
16069,ID,Nez Perce,,2014,3.7,19531,20275,744
16069,ID,Nez Perce,,2015,3.4,19932,20641,709
16069,ID,Nez Perce,,2016,3.2,20198,20861,663
16069,ID,Nez Perce,,2017,2.9,20698,21308,610
16069,ID,Nez Perce,,2018,2.8,20501,21091,590
16069,ID,Nez Perce,,2019,2.9,20549,21153,604
16069,ID,Nez Perce,,2020,5,19861,20899,1038
16069,ID,Nez Perce,,2021,3.3,20235,20918,683
16071,ID,Oneida,,2007,1.8,2342,2384,42
16071,ID,Oneida,,2008,3.4,2239,2319,80
16071,ID,Oneida,,2009,6.3,2101,2242,141
16071,ID,Oneida,,2010,5.8,1892,2009,117
16071,ID,Oneida,,2011,5.7,1901,2015,114
16071,ID,Oneida,,2012,5.1,1993,2099,106
16071,ID,Oneida,,2013,4.8,2008,2109,101
16071,ID,Oneida,,2014,3.5,2037,2110,73
16071,ID,Oneida,,2015,3.3,2059,2129,70
16071,ID,Oneida,,2016,3.5,2123,2200,77
16071,ID,Oneida,,2017,2.9,2205,2271,66
16071,ID,Oneida,,2018,2.2,2293,2345,52
16071,ID,Oneida,,2019,2.3,2285,2339,54
16071,ID,Oneida,,2020,4.3,2248,2348,100
16071,ID,Oneida,,2021,2.5,2514,2578,64
16073,ID,Owyhee,,2007,1.9,4407,4493,86
16073,ID,Owyhee,,2008,3.1,4257,4391,134
16073,ID,Owyhee,,2009,4.4,4171,4365,194
16073,ID,Owyhee,,2010,4.1,4856,5062,206
16073,ID,Owyhee,,2011,4.2,4676,4883,207
16073,ID,Owyhee,,2012,4.2,4901,5118,217
16073,ID,Owyhee,,2013,4.3,4930,5152,222
16073,ID,Owyhee,,2014,3.3,4838,5002,164
16073,ID,Owyhee,,2015,4.4,4983,5215,232
16073,ID,Owyhee,,2016,4.4,5042,5276,234
16073,ID,Owyhee,,2017,4,5129,5341,212
16073,ID,Owyhee,,2018,3.7,5244,5444,200
16073,ID,Owyhee,,2019,3.5,5280,5469,189
16073,ID,Owyhee,,2020,6,5221,5556,335
16073,ID,Owyhee,,2021,4.3,5361,5604,243
16075,ID,Payette,,2007,4.2,10089,10532,443
16075,ID,Payette,,2008,5.8,9894,10508,614
16075,ID,Payette,,2009,9.9,10003,11103,1100
16075,ID,Payette,,2010,9.5,10102,11166,1064
16075,ID,Payette,,2011,8.9,10165,11156,991
16075,ID,Payette,,2012,8.1,10009,10886,877
16075,ID,Payette,,2013,7.2,10128,10917,789
16075,ID,Payette,,2014,5.1,10345,10905,560
16075,ID,Payette,,2015,4.6,10589,11101,512
16075,ID,Payette,,2016,4.5,10742,11247,505
16075,ID,Payette,,2017,4,11104,11563,459
16075,ID,Payette,,2018,3.6,11200,11623,423
16075,ID,Payette,,2019,3.6,11381,11808,427
16075,ID,Payette,,2020,5.4,11362,12012,650
16075,ID,Payette,,2021,4,11598,12081,483
16077,ID,Power,,2007,4,3606,3756,150
16077,ID,Power,,2008,5.2,3378,3564,186
16077,ID,Power,,2009,8.1,3206,3489,283
16077,ID,Power,,2010,9,3528,3876,348
16077,ID,Power,,2011,8.6,3585,3923,338
16077,ID,Power,,2012,8,3778,4106,328
16077,ID,Power,,2013,7.3,3723,4016,293
16077,ID,Power,,2014,4.4,3786,3960,174
16077,ID,Power,,2015,4.3,3710,3877,167
16077,ID,Power,,2016,3.9,3772,3927,155
16077,ID,Power,,2017,3.4,3847,3982,135
16077,ID,Power,,2018,2.9,3984,4105,121
16077,ID,Power,,2019,3.1,3986,4115,129
16077,ID,Power,,2020,4.1,3968,4139,171
16077,ID,Power,,2021,3.8,3999,4159,160
16079,ID,Shoshone,,2007,5.3,5559,5869,310
16079,ID,Shoshone,,2008,8.2,5712,6225,513
16079,ID,Shoshone,,2009,14.1,5462,6362,900
16079,ID,Shoshone,,2010,15.5,4632,5482,850
16079,ID,Shoshone,,2011,14.2,4716,5496,780
16079,ID,Shoshone,,2012,13.4,4881,5637,756
16079,ID,Shoshone,,2013,13.4,4834,5582,748
16079,ID,Shoshone,,2014,9.1,4689,5160,471
16079,ID,Shoshone,,2015,7.2,4746,5115,369
16079,ID,Shoshone,,2016,6.9,4757,5108,351
16079,ID,Shoshone,,2017,6.3,4749,5069,320
16079,ID,Shoshone,,2018,5.8,4806,5104,298
16079,ID,Shoshone,,2019,6,4891,5201,310
16079,ID,Shoshone,,2020,9.3,4963,5473,510
16079,ID,Shoshone,,2021,6.6,5135,5499,364
16081,ID,Teton,,2007,1.7,4989,5075,86
16081,ID,Teton,,2008,2.8,5186,5338,152
16081,ID,Teton,,2009,6.9,4963,5333,370
16081,ID,Teton,,2010,7.6,5036,5452,416
16081,ID,Teton,,2011,6.6,4970,5322,352
16081,ID,Teton,,2012,6.1,5010,5333,323
16081,ID,Teton,,2013,5.6,5189,5495,306
16081,ID,Teton,,2014,3.6,5398,5601,203
16081,ID,Teton,,2015,3.2,5644,5830,186
16081,ID,Teton,,2016,3.1,5793,5980,187
16081,ID,Teton,,2017,2.6,6015,6173,158
16081,ID,Teton,,2018,2.3,6302,6450,148
16081,ID,Teton,,2019,2.3,6522,6674,152
16081,ID,Teton,,2020,5.7,6316,6701,385
16081,ID,Teton,,2021,2.9,6898,7105,207
16083,ID,Twin Falls,,2007,2.8,36745,37788,1043
16083,ID,Twin Falls,,2008,4,36828,38347,1519
16083,ID,Twin Falls,,2009,7,36613,39357,2744
16083,ID,Twin Falls,,2010,8.3,33836,36893,3057
16083,ID,Twin Falls,,2011,7.8,34201,37082,2881
16083,ID,Twin Falls,,2012,7.1,35126,37806,2680
16083,ID,Twin Falls,,2013,6.4,35908,38360,2452
16083,ID,Twin Falls,,2014,3.9,36895,38380,1485
16083,ID,Twin Falls,,2015,3.4,37719,39060,1341
16083,ID,Twin Falls,,2016,3.3,38249,39555,1306
16083,ID,Twin Falls,,2017,3,39174,40399,1225
16083,ID,Twin Falls,,2018,2.7,39791,40915,1124
16083,ID,Twin Falls,,2019,2.8,40449,41632,1183
16083,ID,Twin Falls,,2020,5.3,39322,41544,2222
16083,ID,Twin Falls,,2021,3.6,40600,42103,1503
16085,ID,Valley,,2007,4.1,4817,5025,208
16085,ID,Valley,,2008,8.8,4381,4802,421
16085,ID,Valley,,2009,14.4,4067,4753,686
16085,ID,Valley,,2010,15.5,3970,4696,726
16085,ID,Valley,,2011,13.9,3999,4644,645
16085,ID,Valley,,2012,11.5,4156,4694,538
16085,ID,Valley,,2013,11.3,4084,4603,519
16085,ID,Valley,,2014,6.9,4216,4530,314
16085,ID,Valley,,2015,5.7,4514,4787,273
16085,ID,Valley,,2016,5.2,4701,4959,258
16085,ID,Valley,,2017,4.4,4946,5174,228
16085,ID,Valley,,2018,3.8,5175,5380,205
16085,ID,Valley,,2019,4,5379,5601,222
16085,ID,Valley,,2020,8.1,5231,5691,460
16085,ID,Valley,,2021,5.3,5480,5784,304
16087,ID,Washington,,2007,4.2,4495,4692,197
16087,ID,Washington,,2008,5.7,4408,4673,265
16087,ID,Washington,,2009,9.9,4473,4964,491
16087,ID,Washington,,2010,10.2,4253,4735,482
16087,ID,Washington,,2011,9.6,4275,4729,454
16087,ID,Washington,,2012,8.7,4391,4807,416
16087,ID,Washington,,2013,8.2,4419,4813,394
16087,ID,Washington,,2014,6,4281,4556,275
16087,ID,Washington,,2015,5.4,4316,4563,247
16087,ID,Washington,,2016,5.3,4350,4595,245
16087,ID,Washington,,2017,4.7,4416,4633,217
16087,ID,Washington,,2018,4.2,4461,4656,195
16087,ID,Washington,,2019,4.2,4452,4647,195
16087,ID,Washington,,2020,5.5,4505,4769,264
16087,ID,Washington,,2021,4.4,4627,4838,211
17000,IL,Illinois,,2007,5.1,6301409,6639198,337789
17000,IL,Illinois,,2008,6.5,6222179,6652942,430763
17000,IL,Illinois,,2009,10.2,5928539,6601620,673081
17000,IL,Illinois,,2010,10.5,5918202,6612433,694231
17000,IL,Illinois,,2011,9.8,5925787,6567531,641744
17000,IL,Illinois,,2012,9,5989454,6583689,594235
17000,IL,Illinois,,2013,9.1,5961201,6556593,595392
17000,IL,Illinois,,2014,7.2,6049059,6516372,467313
17000,IL,Illinois,,2015,6,6119934,6511797,391863
17000,IL,Illinois,,2016,5.9,6172672,6559038,386366
17000,IL,Illinois,,2017,4.9,6237933,6562291,324358
17000,IL,Illinois,,2018,4.4,6281764,6568208,286444
17000,IL,Illinois,,2019,4,6308535,6568815,260280
17000,IL,Illinois,,2020,9.2,5781084,6366716,585632
17000,IL,Illinois,,2021,6.1,5935974,6318915,382941
17001,IL,Adams,,2007,3.9,37904,39455,1551
17001,IL,Adams,,2008,4.9,36794,38682,1888
17001,IL,Adams,,2009,7.4,35339,38148,2809
17001,IL,Adams,,2010,7.8,32120,34827,2707
17001,IL,Adams,,2011,6.9,32000,34376,2376
17001,IL,Adams,,2012,6.6,31518,33731,2213
17001,IL,Adams,,2013,6.8,30704,32927,2223
17001,IL,Adams,,2014,5.4,30873,32629,1756
17001,IL,Adams,,2015,5,30956,32579,1623
17001,IL,Adams,,2016,4.8,31068,32621,1553
17001,IL,Adams,,2017,3.9,31172,32432,1260
17001,IL,Adams,,2018,3.8,31715,32975,1260
17001,IL,Adams,,2019,3.3,31239,32290,1051
17001,IL,Adams,,2020,6.4,29136,31139,2003
17001,IL,Adams,,2021,3.9,29647,30856,1209
17003,IL,Alexander,,2007,8.3,2996,3268,272
17003,IL,Alexander,,2008,9.7,2805,3106,301
17003,IL,Alexander,,2009,12.4,2623,2993,370
17003,IL,Alexander,,2010,11.9,2615,2967,352
17003,IL,Alexander,,2011,12.9,2516,2889,373
17003,IL,Alexander,,2012,12,2418,2748,330
17003,IL,Alexander,,2013,12.6,2348,2687,339
17003,IL,Alexander,,2014,10.8,2281,2556,275
17003,IL,Alexander,,2015,9.2,2086,2297,211
17003,IL,Alexander,,2016,9.3,2008,2215,207
17003,IL,Alexander,,2017,8.4,1957,2136,179
17003,IL,Alexander,,2018,8.1,1905,2074,169
17003,IL,Alexander,,2019,6.1,1828,1947,119
17003,IL,Alexander,,2020,10.4,1644,1834,190
17003,IL,Alexander,,2021,8.1,1682,1831,149
17005,IL,Bond,,2007,5.2,8279,8736,457
17005,IL,Bond,,2008,6.8,8171,8767,596
17005,IL,Bond,,2009,10,7689,8540,851
17005,IL,Bond,,2010,10.2,7657,8525,868
17005,IL,Bond,,2011,9.4,7694,8488,794
17005,IL,Bond,,2012,9,7499,8242,743
17005,IL,Bond,,2013,8.6,7334,8028,694
17005,IL,Bond,,2014,6.6,7371,7892,521
17005,IL,Bond,,2015,5.3,7381,7795,414
17005,IL,Bond,,2016,5.1,7506,7911,405
17005,IL,Bond,,2017,4.4,7579,7930,351
17005,IL,Bond,,2018,4.3,7480,7818,338
17005,IL,Bond,,2019,3.7,7498,7783,285
17005,IL,Bond,,2020,7,6876,7396,520
17005,IL,Bond,,2021,4.6,7084,7425,341
17007,IL,Boone,,2007,6.7,24893,26667,1774
17007,IL,Boone,,2008,9.5,24196,26732,2536
17007,IL,Boone,,2009,15.6,22006,26063,4057
17007,IL,Boone,,2010,13.9,23540,27346,3806
17007,IL,Boone,,2011,11.8,23924,27128,3204
17007,IL,Boone,,2012,10.5,23921,26721,2800
17007,IL,Boone,,2013,10.1,23689,26351,2662
17007,IL,Boone,,2014,7.9,24210,26281,2071
17007,IL,Boone,,2015,6.5,24621,26343,1722
17007,IL,Boone,,2016,6.4,24753,26437,1684
17007,IL,Boone,,2017,6.7,24445,26202,1757
17007,IL,Boone,,2018,5.7,25147,26663,1516
17007,IL,Boone,,2019,5.4,24983,26397,1414
17007,IL,Boone,,2020,11.4,22421,25318,2897
17007,IL,Boone,,2021,8.5,22849,24982,2133
17009,IL,Brown,,2007,2.8,3367,3463,96
17009,IL,Brown,,2008,3.9,3394,3530,136
17009,IL,Brown,,2009,4.5,3297,3454,157
17009,IL,Brown,,2010,7,2400,2581,181
17009,IL,Brown,,2011,6.2,2428,2589,161
17009,IL,Brown,,2012,6,2460,2617,157
17009,IL,Brown,,2013,6.1,2452,2612,160
17009,IL,Brown,,2014,4.2,2618,2733,115
17009,IL,Brown,,2015,3.6,2683,2782,99
17009,IL,Brown,,2016,3.4,2771,2868,97
17009,IL,Brown,,2017,2.9,2783,2865,82
17009,IL,Brown,,2018,2.6,2814,2889,75
17009,IL,Brown,,2019,2.4,2938,3009,71
17009,IL,Brown,,2020,3.9,2864,2981,117
17009,IL,Brown,,2021,2.5,2937,3012,75
17011,IL,Bureau,,2007,4.9,18461,19415,954
17011,IL,Bureau,,2008,6.2,18071,19264,1193
17011,IL,Bureau,,2009,10.6,17167,19209,2042
17011,IL,Bureau,,2010,10.9,17050,19131,2081
17011,IL,Bureau,,2011,9.9,16880,18740,1860
17011,IL,Bureau,,2012,9.3,16451,18128,1677
17011,IL,Bureau,,2013,9.1,16096,17715,1619
17011,IL,Bureau,,2014,7.4,16187,17476,1289
17011,IL,Bureau,,2015,6.4,16037,17142,1105
17011,IL,Bureau,,2016,6.1,16393,17450,1057
17011,IL,Bureau,,2017,4.9,16558,17412,854
17011,IL,Bureau,,2018,4.9,16673,17536,863
17011,IL,Bureau,,2019,4.5,16457,17225,768
17011,IL,Bureau,,2020,7.7,15110,16377,1267
17011,IL,Bureau,,2021,5,15536,16347,811
17013,IL,Calhoun,,2007,6.7,2470,2646,176
17013,IL,Calhoun,,2008,7.4,2385,2575,190
17013,IL,Calhoun,,2009,10.1,2228,2479,251
17013,IL,Calhoun,,2010,10.1,2241,2494,253
17013,IL,Calhoun,,2011,9.8,2253,2497,244
17013,IL,Calhoun,,2012,10,2191,2435,244
17013,IL,Calhoun,,2013,9.8,2178,2414,236
17013,IL,Calhoun,,2014,8.3,2169,2365,196
17013,IL,Calhoun,,2015,6.7,2187,2345,158
17013,IL,Calhoun,,2016,6.1,2237,2383,146
17013,IL,Calhoun,,2017,5.4,2212,2338,126
17013,IL,Calhoun,,2018,5.1,2211,2331,120
17013,IL,Calhoun,,2019,4.4,2213,2316,103
17013,IL,Calhoun,,2020,7.9,1999,2171,172
17013,IL,Calhoun,,2021,4.8,2061,2164,103
17015,IL,Carroll,,2007,5.1,8290,8733,443
17015,IL,Carroll,,2008,6.7,7930,8495,565
17015,IL,Carroll,,2009,11,7361,8267,906
17015,IL,Carroll,,2010,10.5,7633,8528,895
17015,IL,Carroll,,2011,9,7553,8302,749
17015,IL,Carroll,,2012,8.2,7366,8027,661
17015,IL,Carroll,,2013,7.9,7249,7873,624
17015,IL,Carroll,,2014,6.4,7342,7848,506
17015,IL,Carroll,,2015,5.5,7516,7950,434
17015,IL,Carroll,,2016,5.7,7452,7900,448
17015,IL,Carroll,,2017,4.6,7277,7630,353
17015,IL,Carroll,,2018,4.4,7163,7494,331
17015,IL,Carroll,,2019,3.9,7101,7390,289
17015,IL,Carroll,,2020,7.3,6892,7432,540
17015,IL,Carroll,,2021,4.2,7226,7545,319
17017,IL,Cass,,2007,4.3,7349,7682,333
17017,IL,Cass,,2008,5.4,7187,7595,408
17017,IL,Cass,,2009,7,7124,7660,536
17017,IL,Cass,,2010,8.4,6396,6980,584
17017,IL,Cass,,2011,8.2,6327,6893,566
17017,IL,Cass,,2012,8.5,6014,6574,560
17017,IL,Cass,,2013,9.1,5841,6426,585
17017,IL,Cass,,2014,7,5964,6411,447
17017,IL,Cass,,2015,5.7,6072,6437,365
17017,IL,Cass,,2016,5.6,5890,6239,349
17017,IL,Cass,,2017,4.5,5877,6156,279
17017,IL,Cass,,2018,4.5,5860,6133,273
17017,IL,Cass,,2019,3.9,5846,6086,240
17017,IL,Cass,,2020,6.8,5417,5810,393
17017,IL,Cass,,2021,4.9,5389,5667,278
17019,IL,Champaign,,2007,4.3,100252,104705,4453
17019,IL,Champaign,,2008,5.7,99511,105481,5970
17019,IL,Champaign,,2009,8.4,96130,104941,8811
17019,IL,Champaign,,2010,8.2,99758,108706,8948
17019,IL,Champaign,,2011,7.6,99976,108163,8187
17019,IL,Champaign,,2012,7.1,99565,107160,7595
17019,IL,Champaign,,2013,7.2,98539,106157,7618
17019,IL,Champaign,,2014,5.8,100559,106804,6245
17019,IL,Champaign,,2015,5.1,101976,107403,5427
17019,IL,Champaign,,2016,5,102462,107858,5396
17019,IL,Champaign,,2017,4.3,102504,107070,4566
17019,IL,Champaign,,2018,4.3,103728,108359,4631
17019,IL,Champaign,,2019,3.6,105208,109107,3899
17019,IL,Champaign,,2020,6.6,99733,106836,7103
17019,IL,Champaign,,2021,4.8,103230,108489,5259
17021,IL,Christian,,2007,5.1,17020,17927,907
17021,IL,Christian,,2008,6.7,16726,17918,1192
17021,IL,Christian,,2009,10.1,15891,17674,1783
17021,IL,Christian,,2010,10.2,15382,17132,1750
17021,IL,Christian,,2011,9.6,15223,16845,1622
17021,IL,Christian,,2012,9.4,14887,16434,1547
17021,IL,Christian,,2013,9.7,14421,15971,1550
17021,IL,Christian,,2014,7.7,14519,15728,1209
17021,IL,Christian,,2015,6.6,14406,15428,1022
17021,IL,Christian,,2016,6.4,14373,15355,982
17021,IL,Christian,,2017,5.3,13994,14780,786
17021,IL,Christian,,2018,5.2,14033,14808,775
17021,IL,Christian,,2019,4.6,13849,14519,670
17021,IL,Christian,,2020,8.3,12378,13498,1120
17021,IL,Christian,,2021,5.4,12671,13401,730
17023,IL,Clark,,2007,5.6,8442,8943,501
17023,IL,Clark,,2008,8,7888,8578,690
17023,IL,Clark,,2009,13.2,7028,8094,1066
17023,IL,Clark,,2010,11.8,7328,8305,977
17023,IL,Clark,,2011,10.4,7271,8114,843
17023,IL,Clark,,2012,9.7,7226,7998,772
17023,IL,Clark,,2013,9.3,7198,7933,735
17023,IL,Clark,,2014,7.2,7391,7963,572
17023,IL,Clark,,2015,6.2,7591,8095,504
17023,IL,Clark,,2016,5.8,7720,8197,477
17023,IL,Clark,,2017,5,7504,7903,399
17023,IL,Clark,,2018,5.3,7415,7832,417
17023,IL,Clark,,2019,4.5,7315,7656,341
17023,IL,Clark,,2020,8,6699,7285,586
17023,IL,Clark,,2021,5,6870,7233,363
17025,IL,Clay,,2007,5.6,6586,6976,390
17025,IL,Clay,,2008,7.4,6259,6757,498
17025,IL,Clay,,2009,12.7,5634,6451,817
17025,IL,Clay,,2010,11.4,6038,6813,775
17025,IL,Clay,,2011,10.6,5977,6689,712
17025,IL,Clay,,2012,9.7,5981,6623,642
17025,IL,Clay,,2013,9.9,5689,6313,624
17025,IL,Clay,,2014,8.1,5921,6440,519
17025,IL,Clay,,2015,7.1,6160,6630,470
17025,IL,Clay,,2016,6.8,6274,6734,460
17025,IL,Clay,,2017,5.3,6301,6655,354
17025,IL,Clay,,2018,5.2,6348,6695,347
17025,IL,Clay,,2019,4.3,6197,6478,281
17025,IL,Clay,,2020,9.6,5601,6194,593
17025,IL,Clay,,2021,5.5,5574,5900,326
17027,IL,Clinton,,2007,4.8,18356,19274,918
17027,IL,Clinton,,2008,6.2,18087,19292,1205
17027,IL,Clinton,,2009,8.5,17008,18598,1590
17027,IL,Clinton,,2010,7.3,18999,20503,1504
17027,IL,Clinton,,2011,6.7,19300,20695,1395
17027,IL,Clinton,,2012,6.7,18920,20275,1355
17027,IL,Clinton,,2013,6.8,18583,19929,1346
17027,IL,Clinton,,2014,5.5,18859,19950,1091
17027,IL,Clinton,,2015,4.5,19206,20114,908
17027,IL,Clinton,,2016,4.5,19621,20537,916
17027,IL,Clinton,,2017,3.5,19610,20331,721
17027,IL,Clinton,,2018,3.5,19766,20489,723
17027,IL,Clinton,,2019,3,20022,20634,612
17027,IL,Clinton,,2020,5.9,18485,19653,1168
17027,IL,Clinton,,2021,3.4,19061,19742,681
17029,IL,Coles,,2007,4.4,26627,27858,1231
17029,IL,Coles,,2008,6.2,25969,27696,1727
17029,IL,Coles,,2009,9.2,25068,27597,2529
17029,IL,Coles,,2010,9.9,23089,25634,2545
17029,IL,Coles,,2011,9.4,22449,24787,2338
17029,IL,Coles,,2012,8.8,22555,24739,2184
17029,IL,Coles,,2013,8.8,22260,24398,2138
17029,IL,Coles,,2014,6.8,22621,24280,1659
17029,IL,Coles,,2015,6.1,22667,24131,1464
17029,IL,Coles,,2016,5.9,23173,24628,1455
17029,IL,Coles,,2017,4.7,23344,24489,1145
17029,IL,Coles,,2018,4.7,23125,24257,1132
17029,IL,Coles,,2019,3.8,22966,23883,917
17029,IL,Coles,,2020,7.6,21314,23059,1745
17029,IL,Coles,,2021,5.1,21591,22756,1165
17031,IL,Cook,,2007,5.4,2464876,2605588,140712
17031,IL,Cook,,2008,6.7,2441528,2615934,174406
17031,IL,Cook,,2009,10.5,2326339,2598079,271740
17031,IL,Cook,,2010,11,2350480,2640576,290096
17031,IL,Cook,,2011,10.6,2345151,2622338,277187
17031,IL,Cook,,2012,9.7,2406145,2663370,257225
17031,IL,Cook,,2013,9.7,2418142,2677937,259795
17031,IL,Cook,,2014,7.6,2456426,2657984,201558
17031,IL,Cook,,2015,6.3,2481137,2647903,166766
17031,IL,Cook,,2016,6.2,2500070,2664757,164687
17031,IL,Cook,,2017,5.1,2551081,2689206,138125
17031,IL,Cook,,2018,4.2,2561204,2673365,112161
17031,IL,Cook,,2019,3.9,2578917,2684430,105513
17031,IL,Cook,,2020,10.4,2351173,2624052,272879
17031,IL,Cook,,2021,7,2411555,2594101,182546
17033,IL,Crawford,,2007,5.5,9245,9783,538
17033,IL,Crawford,,2008,6.7,9045,9692,647
17033,IL,Crawford,,2009,10,8723,9695,972
17033,IL,Crawford,,2010,8.6,9475,10371,896
17033,IL,Crawford,,2011,7.3,10027,10816,789
17033,IL,Crawford,,2012,7.7,9591,10396,805
17033,IL,Crawford,,2013,8.3,9130,9954,824
17033,IL,Crawford,,2014,6.5,9107,9743,636
17033,IL,Crawford,,2015,5.9,9077,9649,572
17033,IL,Crawford,,2016,6.3,8498,9065,567
17033,IL,Crawford,,2017,5.2,8415,8880,465
17033,IL,Crawford,,2018,5.4,8278,8746,468
17033,IL,Crawford,,2019,4.1,8327,8686,359
17033,IL,Crawford,,2020,7.1,7789,8385,596
17033,IL,Crawford,,2021,5,8043,8469,426
17035,IL,Cumberland,,2007,5.1,5487,5784,297
17035,IL,Cumberland,,2008,7.3,5234,5645,411
17035,IL,Cumberland,,2009,9.9,5003,5553,550
17035,IL,Cumberland,,2010,9.2,5496,6054,558
17035,IL,Cumberland,,2011,8.6,5425,5938,513
17035,IL,Cumberland,,2012,7.8,5472,5936,464
17035,IL,Cumberland,,2013,7.8,5360,5813,453
17035,IL,Cumberland,,2014,6,5511,5860,349
17035,IL,Cumberland,,2015,5.3,5605,5917,312
17035,IL,Cumberland,,2016,5.2,5694,6009,315
17035,IL,Cumberland,,2017,4,5883,6129,246
17035,IL,Cumberland,,2018,4,5872,6115,243
17035,IL,Cumberland,,2019,3.3,5920,6121,201
17035,IL,Cumberland,,2020,5.8,5582,5926,344
17035,IL,Cumberland,,2021,4.2,5674,5920,246
17037,IL,DeKalb,,2007,4.4,56361,58939,2578
17037,IL,DeKalb,,2008,5.9,56676,60238,3562
17037,IL,DeKalb,,2009,10.1,53939,59996,6057
17037,IL,DeKalb,,2010,10.6,50323,56305,5982
17037,IL,DeKalb,,2011,9.4,50556,55778,5222
17037,IL,DeKalb,,2012,8.5,50748,55461,4713
17037,IL,DeKalb,,2013,8.1,50409,54877,4468
17037,IL,DeKalb,,2014,6.6,51463,55090,3627
17037,IL,DeKalb,,2015,5.6,51776,54841,3065
17037,IL,DeKalb,,2016,5.3,52454,55418,2964
17037,IL,DeKalb,,2017,4.6,52362,54909,2547
17037,IL,DeKalb,,2018,4.4,52946,55365,2419
17037,IL,DeKalb,,2019,3.9,53508,55690,2182
17037,IL,DeKalb,,2020,8.3,48449,52854,4405
17037,IL,DeKalb,,2021,5.6,50012,53006,2994
17039,IL,De Witt,,2007,4.9,8152,8571,419
17039,IL,De Witt,,2008,6,8116,8637,521
17039,IL,De Witt,,2009,8.6,8037,8793,756
17039,IL,De Witt,,2010,8.8,8022,8798,776
17039,IL,De Witt,,2011,8.5,7996,8737,741
17039,IL,De Witt,,2012,8.1,7794,8481,687
17039,IL,De Witt,,2013,8.3,7497,8176,679
17039,IL,De Witt,,2014,6.6,7436,7965,529
17039,IL,De Witt,,2015,5.6,7535,7978,443
17039,IL,De Witt,,2016,5.7,7521,7975,454
17039,IL,De Witt,,2017,4.7,7343,7706,363
17039,IL,De Witt,,2018,5,7206,7587,381
17039,IL,De Witt,,2019,4.2,7152,7462,310
17039,IL,De Witt,,2020,6.7,6523,6993,470
17039,IL,De Witt,,2021,4.9,6748,7094,346
17041,IL,Douglas,,2007,4.3,10065,10518,453
17041,IL,Douglas,,2008,6,9826,10450,624
17041,IL,Douglas,,2009,8.8,9292,10190,898
17041,IL,Douglas,,2010,8.9,9407,10321,914
17041,IL,Douglas,,2011,8.1,9370,10191,821
17041,IL,Douglas,,2012,7.2,9260,9980,720
17041,IL,Douglas,,2013,6.9,9178,9855,677
17041,IL,Douglas,,2014,5.9,9366,9949,583
17041,IL,Douglas,,2015,4.9,9673,10170,497
17041,IL,Douglas,,2016,4.7,9839,10326,487
17041,IL,Douglas,,2017,4.1,9843,10263,420
17041,IL,Douglas,,2018,4,9908,10325,417
17041,IL,Douglas,,2019,3.4,9905,10254,349
17041,IL,Douglas,,2020,5.8,9391,9964,573
17041,IL,Douglas,,2021,3.7,9778,10153,375
17043,IL,DuPage,,2007,4,506801,527740,20939
17043,IL,DuPage,,2008,5.1,501815,529047,27232
17043,IL,DuPage,,2009,8.5,479866,524449,44583
17043,IL,DuPage,,2010,9,457100,502193,45093
17043,IL,DuPage,,2011,8.3,457774,499322,41548
17043,IL,DuPage,,2012,7.5,470119,508341,38222
17043,IL,DuPage,,2013,7.4,473708,511692,37984
17043,IL,DuPage,,2014,5.8,480977,510658,29681
17043,IL,DuPage,,2015,4.8,487131,511797,24666
17043,IL,DuPage,,2016,4.8,491849,516779,24930
17043,IL,DuPage,,2017,4,501579,522426,20847
17043,IL,DuPage,,2018,3.2,505711,522629,16918
17043,IL,DuPage,,2019,3,509120,525102,15982
17043,IL,DuPage,,2020,7.5,465172,503125,37953
17043,IL,DuPage,,2021,4.5,477095,499576,22481
17045,IL,Edgar,,2007,5.2,10023,10572,549
17045,IL,Edgar,,2008,7,9542,10265,723
17045,IL,Edgar,,2009,10.4,9095,10146,1051
17045,IL,Edgar,,2010,11.3,8382,9447,1065
17045,IL,Edgar,,2011,10.5,8348,9329,981
17045,IL,Edgar,,2012,9.7,8202,9086,884
17045,IL,Edgar,,2013,9.4,8174,9024,850
17045,IL,Edgar,,2014,7.2,8473,9133,660
17045,IL,Edgar,,2015,6.3,8856,9448,592
17045,IL,Edgar,,2016,6,9163,9747,584
17045,IL,Edgar,,2017,4.9,9008,9475,467
17045,IL,Edgar,,2018,4.7,8873,9314,441
17045,IL,Edgar,,2019,4.1,8588,8957,369
17045,IL,Edgar,,2020,6.7,8277,8875,598
17045,IL,Edgar,,2021,4,8572,8931,359
17047,IL,Edwards,,2007,4.9,3273,3443,170
17047,IL,Edwards,,2008,6.5,3066,3279,213
17047,IL,Edwards,,2009,9.2,2813,3099,286
17047,IL,Edwards,,2010,8.8,2940,3224,284
17047,IL,Edwards,,2011,8.1,2880,3135,255
17047,IL,Edwards,,2012,7.9,2806,3046,240
17047,IL,Edwards,,2013,8.5,2621,2865,244
17047,IL,Edwards,,2014,6.8,2658,2851,193
17047,IL,Edwards,,2015,6,2774,2950,176
17047,IL,Edwards,,2016,5.8,2811,2984,173
17047,IL,Edwards,,2017,4.7,2721,2855,134
17047,IL,Edwards,,2018,4.6,2662,2791,129
17047,IL,Edwards,,2019,4.1,2606,2718,112
17047,IL,Edwards,,2020,8.5,2426,2651,225
17047,IL,Edwards,,2021,5.1,2420,2550,130
17049,IL,Effingham,,2007,4.1,18022,18791,769
17049,IL,Effingham,,2008,5.6,17474,18510,1036
17049,IL,Effingham,,2009,8.1,16624,18093,1469
17049,IL,Effingham,,2010,7.9,17148,18626,1478
17049,IL,Effingham,,2011,6.9,17361,18646,1285
17049,IL,Effingham,,2012,6.6,17221,18435,1214
17049,IL,Effingham,,2013,6.9,16810,18053,1243
17049,IL,Effingham,,2014,5.5,17352,18357,1005
17049,IL,Effingham,,2015,4.8,17562,18448,886
17049,IL,Effingham,,2016,4.8,17880,18775,895
17049,IL,Effingham,,2017,3.8,18199,18920,721
17049,IL,Effingham,,2018,3.7,18520,19232,712
17049,IL,Effingham,,2019,3.1,18738,19335,597
17049,IL,Effingham,,2020,6.8,17889,19186,1297
17049,IL,Effingham,,2021,3.9,18644,19397,753
17051,IL,Fayette,,2007,6.3,9651,10305,654
17051,IL,Fayette,,2008,8,9406,10222,816
17051,IL,Fayette,,2009,11.1,8972,10094,1122
17051,IL,Fayette,,2010,10.1,10083,11220,1137
17051,IL,Fayette,,2011,9.2,10124,11155,1031
17051,IL,Fayette,,2012,9,9687,10645,958
17051,IL,Fayette,,2013,9.2,9192,10118,926
17051,IL,Fayette,,2014,7.6,9007,9753,746
17051,IL,Fayette,,2015,6.6,9078,9718,640
17051,IL,Fayette,,2016,6.5,9149,9786,637
17051,IL,Fayette,,2017,5.5,9159,9688,529
17051,IL,Fayette,,2018,5.2,9315,9822,507
17051,IL,Fayette,,2019,4.2,9514,9930,416
17051,IL,Fayette,,2020,7.6,8963,9700,737
17051,IL,Fayette,,2021,5.1,9303,9804,501
17053,IL,Ford,,2007,5,6954,7321,367
17053,IL,Ford,,2008,6.2,6725,7170,445
17053,IL,Ford,,2009,10.1,6366,7080,714
17053,IL,Ford,,2010,9.5,6585,7279,694
17053,IL,Ford,,2011,8.6,6519,7129,610
17053,IL,Ford,,2012,7.5,6437,6957,520
17053,IL,Ford,,2013,7.3,6232,6726,494
17053,IL,Ford,,2014,5.9,6246,6640,394
17053,IL,Ford,,2015,5.3,6309,6662,353
17053,IL,Ford,,2016,5.4,6319,6683,364
17053,IL,Ford,,2017,4.8,6151,6462,311
17053,IL,Ford,,2018,4.6,6156,6456,300
17053,IL,Ford,,2019,4.1,6090,6352,262
17053,IL,Ford,,2020,6.7,5746,6156,410
17053,IL,Ford,,2021,4.4,5932,6207,275
17055,IL,Franklin,,2007,7.9,16766,18206,1440
17055,IL,Franklin,,2008,9.4,16231,17913,1682
17055,IL,Franklin,,2009,13.2,15320,17640,2320
17055,IL,Franklin,,2010,12.4,15740,17976,2236
17055,IL,Franklin,,2011,11.2,15637,17609,1972
17055,IL,Franklin,,2012,10.7,15475,17330,1855
17055,IL,Franklin,,2013,11.8,14906,16909,2003
17055,IL,Franklin,,2014,9.3,15092,16642,1550
17055,IL,Franklin,,2015,8.1,15180,16518,1338
17055,IL,Franklin,,2016,8.1,15406,16765,1359
17055,IL,Franklin,,2017,6.5,15533,16609,1076
17055,IL,Franklin,,2018,6.1,15897,16932,1035
17055,IL,Franklin,,2019,5.2,15570,16417,847
17055,IL,Franklin,,2020,10.7,14230,15935,1705
17055,IL,Franklin,,2021,6.6,14618,15656,1038
17057,IL,Fulton,,2007,5.3,16903,17857,954
17057,IL,Fulton,,2008,6.7,16733,17932,1199
17057,IL,Fulton,,2009,11.5,16336,18452,2116
17057,IL,Fulton,,2010,11.8,15489,17564,2075
17057,IL,Fulton,,2011,10.5,15589,17424,1835
17057,IL,Fulton,,2012,10,15196,16881,1685
17057,IL,Fulton,,2013,10.9,14432,16194,1762
17057,IL,Fulton,,2014,8.6,14389,15751,1362
17057,IL,Fulton,,2015,7.6,14606,15813,1207
17057,IL,Fulton,,2016,7.4,14697,15871,1174
17057,IL,Fulton,,2017,6.4,14512,15503,991
17057,IL,Fulton,,2018,6.1,14366,15305,939
17057,IL,Fulton,,2019,5.3,14396,15205,809
17057,IL,Fulton,,2020,8.7,13290,14556,1266
17057,IL,Fulton,,2021,5.7,13601,14421,820
17059,IL,Gallatin,,2007,6.3,2490,2656,166
17059,IL,Gallatin,,2008,8.2,2397,2611,214
17059,IL,Gallatin,,2009,10.1,2356,2620,264
17059,IL,Gallatin,,2010,9.7,2377,2632,255
17059,IL,Gallatin,,2011,8.9,2347,2576,229
17059,IL,Gallatin,,2012,8.5,2302,2515,213
17059,IL,Gallatin,,2013,9.4,2245,2478,233
17059,IL,Gallatin,,2014,7.2,2286,2463,177
17059,IL,Gallatin,,2015,6.7,2305,2470,165
17059,IL,Gallatin,,2016,7.6,2352,2546,194
17059,IL,Gallatin,,2017,5.9,2327,2474,147
17059,IL,Gallatin,,2018,5.9,2309,2454,145
17059,IL,Gallatin,,2019,4.8,2227,2339,112
17059,IL,Gallatin,,2020,9.5,1819,2009,190
17059,IL,Gallatin,,2021,6.1,1835,1954,119
17061,IL,Greene,,2007,5,6793,7153,360
17061,IL,Greene,,2008,6.1,6510,6934,424
17061,IL,Greene,,2009,8.4,6186,6756,570
17061,IL,Greene,,2010,9.4,6167,6804,637
17061,IL,Greene,,2011,8.7,6116,6701,585
17061,IL,Greene,,2012,8.4,5907,6452,545
17061,IL,Greene,,2013,8.6,5769,6313,544
17061,IL,Greene,,2014,6.8,5756,6177,421
17061,IL,Greene,,2015,6.1,5685,6057,372
17061,IL,Greene,,2016,5.8,5740,6095,355
17061,IL,Greene,,2017,5.1,5720,6026,306
17061,IL,Greene,,2018,4.8,5737,6028,291
17061,IL,Greene,,2019,4.1,5812,6060,248
17061,IL,Greene,,2020,6.6,5491,5882,391
17061,IL,Greene,,2021,4.6,5601,5874,273
17063,IL,Grundy,,2007,5.9,24151,25660,1509
17063,IL,Grundy,,2008,7.4,24292,26243,1951
17063,IL,Grundy,,2009,12.1,23403,26629,3226
17063,IL,Grundy,,2010,13.4,22448,25918,3470
17063,IL,Grundy,,2011,12.9,22320,25612,3292
17063,IL,Grundy,,2012,11.5,22876,25851,2975
17063,IL,Grundy,,2013,11.7,22930,25968,3038
17063,IL,Grundy,,2014,8.8,23364,25632,2268
17063,IL,Grundy,,2015,7,23690,25482,1792
17063,IL,Grundy,,2016,6.9,23999,25767,1768
17063,IL,Grundy,,2017,5.8,24528,26041,1513
17063,IL,Grundy,,2018,4.8,24936,26206,1270
17063,IL,Grundy,,2019,4.6,25297,26525,1228
17063,IL,Grundy,,2020,8.5,23211,25379,2168
17063,IL,Grundy,,2021,5.3,23796,25122,1326
17065,IL,Hamilton,,2007,5.7,4052,4295,243
17065,IL,Hamilton,,2008,7,3923,4218,295
17065,IL,Hamilton,,2009,9.5,3674,4059,385
17065,IL,Hamilton,,2010,9.5,3626,4007,381
17065,IL,Hamilton,,2011,8.7,3575,3914,339
17065,IL,Hamilton,,2012,8,3594,3907,313
17065,IL,Hamilton,,2013,7.8,3767,4084,317
17065,IL,Hamilton,,2014,6,4072,4332,260
17065,IL,Hamilton,,2015,5.5,4143,4384,241
17065,IL,Hamilton,,2016,6.2,4007,4273,266
17065,IL,Hamilton,,2017,4.5,4268,4468,200
17065,IL,Hamilton,,2018,4.4,4291,4487,196
17065,IL,Hamilton,,2019,3.7,4265,4429,164
17065,IL,Hamilton,,2020,6.7,3918,4201,283
17065,IL,Hamilton,,2021,4.3,4025,4208,183
17067,IL,Hancock,,2007,5.5,9397,9940,543
17067,IL,Hancock,,2008,6.9,9161,9845,684
17067,IL,Hancock,,2009,11.2,8359,9415,1056
17067,IL,Hancock,,2010,10.6,8882,9939,1057
17067,IL,Hancock,,2011,9.2,8739,9623,884
17067,IL,Hancock,,2012,8.3,8465,9235,770
17067,IL,Hancock,,2013,8.4,8138,8889,751
17067,IL,Hancock,,2014,6.5,8302,8881,579
17067,IL,Hancock,,2015,6.2,8376,8928,552
17067,IL,Hancock,,2016,6.5,8289,8868,579
17067,IL,Hancock,,2017,5.1,8093,8532,439
17067,IL,Hancock,,2018,4.6,8122,8518,396
17067,IL,Hancock,,2019,4.5,8041,8419,378
17067,IL,Hancock,,2020,7,7496,8064,568
17067,IL,Hancock,,2021,4.3,7731,8079,348
17069,IL,Hardin,,2007,8.2,1566,1706,140
17069,IL,Hardin,,2008,9.4,1550,1711,161
17069,IL,Hardin,,2009,11.1,1561,1755,194
17069,IL,Hardin,,2010,10.9,1596,1791,195
17069,IL,Hardin,,2011,10.8,1560,1749,189
17069,IL,Hardin,,2012,10.6,1545,1728,183
17069,IL,Hardin,,2013,11.3,1536,1732,196
17069,IL,Hardin,,2014,8.8,1495,1639,144
17069,IL,Hardin,,2015,8.5,1401,1531,130
17069,IL,Hardin,,2016,9.4,1269,1400,131
17069,IL,Hardin,,2017,7.6,1250,1353,103
17069,IL,Hardin,,2018,7.4,1235,1334,99
17069,IL,Hardin,,2019,6.2,1225,1306,81
17069,IL,Hardin,,2020,9.5,1166,1288,122
17069,IL,Hardin,,2021,6.7,1233,1322,89
17071,IL,Henderson,,2007,5.4,3825,4042,217
17071,IL,Henderson,,2008,7.3,3618,3904,286
17071,IL,Henderson,,2009,9.6,3425,3790,365
17071,IL,Henderson,,2010,9.4,3554,3922,368
17071,IL,Henderson,,2011,8,3546,3854,308
17071,IL,Henderson,,2012,8,3416,3713,297
17071,IL,Henderson,,2013,7.9,3380,3669,289
17071,IL,Henderson,,2014,6.4,3499,3738,239
17071,IL,Henderson,,2015,6,3530,3756,226
17071,IL,Henderson,,2016,6.1,3505,3732,227
17071,IL,Henderson,,2017,5.1,3467,3653,186
17071,IL,Henderson,,2018,4.8,3489,3666,177
17071,IL,Henderson,,2019,4.5,3469,3634,165
17071,IL,Henderson,,2020,7.1,3283,3534,251
17071,IL,Henderson,,2021,4,3401,3543,142
17073,IL,Henry,,2007,4.9,26376,27721,1345
17073,IL,Henry,,2008,6.2,25848,27553,1705
17073,IL,Henry,,2009,9.3,24226,26698,2472
17073,IL,Henry,,2010,9.2,24312,26769,2457
17073,IL,Henry,,2011,7.8,24508,26593,2085
17073,IL,Henry,,2012,7.4,24196,26141,1945
17073,IL,Henry,,2013,7.7,23526,25491,1965
17073,IL,Henry,,2014,6.7,23642,25341,1699
17073,IL,Henry,,2015,6.1,23688,25236,1548
17073,IL,Henry,,2016,6,23793,25322,1529
17073,IL,Henry,,2017,5.1,23750,25028,1278
17073,IL,Henry,,2018,5,23838,25083,1245
17073,IL,Henry,,2019,4.6,23934,25076,1142
17073,IL,Henry,,2020,8,21809,23700,1891
17073,IL,Henry,,2021,4.9,22491,23644,1153
17075,IL,Iroquois,,2007,5,15907,16753,846
17075,IL,Iroquois,,2008,6.8,15595,16729,1134
17075,IL,Iroquois,,2009,9.7,15088,16704,1616
17075,IL,Iroquois,,2010,10.2,14337,15968,1631
17075,IL,Iroquois,,2011,9.3,14192,15644,1452
17075,IL,Iroquois,,2012,8.6,13860,15168,1308
17075,IL,Iroquois,,2013,8.5,13670,14932,1262
17075,IL,Iroquois,,2014,6.5,13962,14927,965
17075,IL,Iroquois,,2015,5.7,13936,14778,842
17075,IL,Iroquois,,2016,5.5,14040,14860,820
17075,IL,Iroquois,,2017,4.6,13949,14621,672
17075,IL,Iroquois,,2018,4.4,13867,14507,640
17075,IL,Iroquois,,2019,4,13789,14367,578
17075,IL,Iroquois,,2020,6.3,12684,13541,857
17075,IL,Iroquois,,2021,4.7,12470,13086,616
17077,IL,Jackson,,2007,4.6,31496,33030,1534
17077,IL,Jackson,,2008,5.7,30554,32416,1862
17077,IL,Jackson,,2009,7.4,29666,32026,2360
17077,IL,Jackson,,2010,8.3,27328,29798,2470
17077,IL,Jackson,,2011,8,27260,29629,2369
17077,IL,Jackson,,2012,7.9,26781,29070,2289
17077,IL,Jackson,,2013,7.9,26251,28507,2256
17077,IL,Jackson,,2014,6.5,26622,28464,1842
17077,IL,Jackson,,2015,5.6,27083,28680,1597
17077,IL,Jackson,,2016,5.4,27249,28802,1553
17077,IL,Jackson,,2017,4.5,26842,28103,1261
17077,IL,Jackson,,2018,4.5,26853,28114,1261
17077,IL,Jackson,,2019,3.6,26985,27997,1012
17077,IL,Jackson,,2020,7.9,25004,27136,2132
17077,IL,Jackson,,2021,5.4,25730,27201,1471
17079,IL,Jasper,,2007,5.2,4917,5186,269
17079,IL,Jasper,,2008,6.6,4849,5193,344
17079,IL,Jasper,,2009,9.3,4472,4929,457
17079,IL,Jasper,,2010,9,4633,5089,456
17079,IL,Jasper,,2011,7.8,4607,4997,390
17079,IL,Jasper,,2012,7.7,4540,4918,378
17079,IL,Jasper,,2013,7.9,4351,4723,372
17079,IL,Jasper,,2014,6.5,4345,4645,300
17079,IL,Jasper,,2015,6.2,4357,4647,290
17079,IL,Jasper,,2016,6.3,4373,4665,292
17079,IL,Jasper,,2017,5,4269,4493,224
17079,IL,Jasper,,2018,5,4394,4623,229
17079,IL,Jasper,,2019,4.1,4467,4656,189
17079,IL,Jasper,,2020,6.2,4290,4572,282
17079,IL,Jasper,,2021,4.3,4522,4723,201
17081,IL,Jefferson,,2007,5,20220,21280,1060
17081,IL,Jefferson,,2008,6.3,19482,20794,1312
17081,IL,Jefferson,,2009,9.6,18559,20541,1982
17081,IL,Jefferson,,2010,10.3,16328,18197,1869
17081,IL,Jefferson,,2011,9.3,16473,18172,1699
17081,IL,Jefferson,,2012,9.3,16167,17816,1649
17081,IL,Jefferson,,2013,9.5,16125,17815,1690
17081,IL,Jefferson,,2014,7.5,16289,17616,1327
17081,IL,Jefferson,,2015,6.8,16040,17203,1163
17081,IL,Jefferson,,2016,6.4,16512,17642,1130
17081,IL,Jefferson,,2017,5.4,16556,17510,954
17081,IL,Jefferson,,2018,5.2,16877,17806,929
17081,IL,Jefferson,,2019,4.4,16663,17429,766
17081,IL,Jefferson,,2020,10.2,15220,16941,1721
17081,IL,Jefferson,,2021,6.2,15476,16498,1022
17083,IL,Jersey,,2007,5.5,11175,11820,645
17083,IL,Jersey,,2008,6.5,11011,11773,762
17083,IL,Jersey,,2009,9.5,10422,11513,1091
17083,IL,Jersey,,2010,9.2,10521,11590,1069
17083,IL,Jersey,,2011,9,10544,11582,1038
17083,IL,Jersey,,2012,9.1,10320,11350,1030
17083,IL,Jersey,,2013,8.9,10147,11142,995
17083,IL,Jersey,,2014,7.2,10276,11076,800
17083,IL,Jersey,,2015,6.3,10392,11096,704
17083,IL,Jersey,,2016,5.8,10455,11102,647
17083,IL,Jersey,,2017,4.8,10436,10965,529
17083,IL,Jersey,,2018,4.8,10482,11009,527
17083,IL,Jersey,,2019,4.2,10601,11065,464
17083,IL,Jersey,,2020,7.7,9770,10580,810
17083,IL,Jersey,,2021,4.4,10083,10545,462
17085,IL,Jo Daviess,,2007,4.1,13173,13733,560
17085,IL,Jo Daviess,,2008,5.7,12638,13399,761
17085,IL,Jo Daviess,,2009,9.1,11865,13047,1182
17085,IL,Jo Daviess,,2010,9,11312,12424,1112
17085,IL,Jo Daviess,,2011,7.9,11166,12130,964
17085,IL,Jo Daviess,,2012,7.6,10930,11831,901
17085,IL,Jo Daviess,,2013,7.6,10703,11584,881
17085,IL,Jo Daviess,,2014,6.2,10843,11560,717
17085,IL,Jo Daviess,,2015,5.5,10842,11471,629
17085,IL,Jo Daviess,,2016,5.4,10810,11425,615
17085,IL,Jo Daviess,,2017,4.5,10580,11074,494
17085,IL,Jo Daviess,,2018,4.3,10594,11070,476
17085,IL,Jo Daviess,,2019,3.9,10407,10827,420
17085,IL,Jo Daviess,,2020,8.4,9559,10435,876
17085,IL,Jo Daviess,,2021,4.4,10087,10552,465
17087,IL,Johnson,,2007,6.4,4930,5266,336
17087,IL,Johnson,,2008,8.2,4699,5116,417
17087,IL,Johnson,,2009,10.6,4542,5081,539
17087,IL,Johnson,,2010,12.6,3887,4447,560
17087,IL,Johnson,,2011,11.7,3877,4393,516
17087,IL,Johnson,,2012,11.6,3788,4287,499
17087,IL,Johnson,,2013,12.1,3762,4282,520
17087,IL,Johnson,,2014,9.6,3761,4160,399
17087,IL,Johnson,,2015,8.5,3788,4142,354
17087,IL,Johnson,,2016,8.7,3858,4227,369
17087,IL,Johnson,,2017,7.5,3813,4122,309
17087,IL,Johnson,,2018,7.5,3817,4127,310
17087,IL,Johnson,,2019,5.8,3902,4142,240
17087,IL,Johnson,,2020,9.1,3712,4083,371
17087,IL,Johnson,,2021,6,3843,4088,245
17089,IL,Kane,,2007,4.6,256114,268353,12239
17089,IL,Kane,,2008,6.2,254554,271348,16794
17089,IL,Kane,,2009,10.5,242013,270542,28529
17089,IL,Kane,,2010,11.2,237132,266908,29776
17089,IL,Kane,,2011,9.8,241479,267705,26226
17089,IL,Kane,,2012,9,243009,266912,23903
17089,IL,Kane,,2013,8.6,242313,265252,22939
17089,IL,Kane,,2014,6.9,247318,265695,18377
17089,IL,Kane,,2015,5.8,253171,268642,15471
17089,IL,Kane,,2016,5.5,256305,271322,15017
17089,IL,Kane,,2017,4.8,256822,269864,13042
17089,IL,Kane,,2018,4.9,261185,274523,13338
17089,IL,Kane,,2019,4.3,261268,272881,11613
17089,IL,Kane,,2020,9.3,236858,261149,24291
17089,IL,Kane,,2021,5.9,244555,259900,15345
17091,IL,Kankakee,,2007,6.4,52139,55681,3542
17091,IL,Kankakee,,2008,8.5,51085,55847,4762
17091,IL,Kankakee,,2009,12.3,49140,56061,6921
17091,IL,Kankakee,,2010,12.7,49205,56343,7138
17091,IL,Kankakee,,2011,11.7,49322,55846,6524
17091,IL,Kankakee,,2012,10.7,49470,55378,5908
17091,IL,Kankakee,,2013,10.5,49328,55118,5790
17091,IL,Kankakee,,2014,8.2,50378,54852,4474
17091,IL,Kankakee,,2015,6.9,50609,54342,3733
17091,IL,Kankakee,,2016,6.5,51381,54935,3554
17091,IL,Kankakee,,2017,5.5,51879,54890,3011
17091,IL,Kankakee,,2018,5.5,52619,55656,3037
17091,IL,Kankakee,,2019,4.8,53259,55937,2678
17091,IL,Kankakee,,2020,9,49036,53863,4827
17091,IL,Kankakee,,2021,6.5,49100,52515,3415
17093,IL,Kendall,,2007,4.4,53021,55484,2463
17093,IL,Kendall,,2008,6,56020,59573,3553
17093,IL,Kendall,,2009,10,54158,60203,6045
17093,IL,Kendall,,2010,10.2,55943,62309,6366
17093,IL,Kendall,,2011,9.4,56414,62274,5860
17093,IL,Kendall,,2012,8.4,58382,63731,5349
17093,IL,Kendall,,2013,8.4,59137,64591,5454
17093,IL,Kendall,,2014,6.5,61014,65270,4256
17093,IL,Kendall,,2015,5.3,62762,66247,3485
17093,IL,Kendall,,2016,5.2,64414,67962,3548
17093,IL,Kendall,,2017,4.4,66478,69516,3038
17093,IL,Kendall,,2018,3.6,68014,70561,2547
17093,IL,Kendall,,2019,3.4,69530,72001,2471
17093,IL,Kendall,,2020,7.9,64661,70224,5563
17093,IL,Kendall,,2021,4.7,66284,69542,3258
17095,IL,Knox,,2007,5.1,24239,25536,1297
17095,IL,Knox,,2008,6.6,23851,25527,1676
17095,IL,Knox,,2009,9.7,23392,25910,2518
17095,IL,Knox,,2010,9.6,22866,25303,2437
17095,IL,Knox,,2011,8.8,22658,24846,2188
17095,IL,Knox,,2012,8.4,22258,24291,2033
17095,IL,Knox,,2013,8.8,21562,23650,2088
17095,IL,Knox,,2014,7,21936,23582,1646
17095,IL,Knox,,2015,6.1,21828,23245,1417
17095,IL,Knox,,2016,6.1,21619,23035,1416
17095,IL,Knox,,2017,5.2,21356,22526,1170
17095,IL,Knox,,2018,5.2,21047,22212,1165
17095,IL,Knox,,2019,4.7,20747,21779,1032
17095,IL,Knox,,2020,8.8,19199,21053,1854
17095,IL,Knox,,2021,6.6,19110,20453,1343
17097,IL,Lake,,2007,4.9,352951,370966,18015
17097,IL,Lake,,2008,6.5,346288,370463,24175
17097,IL,Lake,,2009,9.9,326251,362202,35951
17097,IL,Lake,,2010,10,332048,368953,36905
17097,IL,Lake,,2011,8.9,335081,367799,32718
17097,IL,Lake,,2012,8.2,335653,365531,29878
17097,IL,Lake,,2013,7.9,334752,363470,28718
17097,IL,Lake,,2014,6.5,340872,364629,23757
17097,IL,Lake,,2015,5.4,347425,367278,19853
17097,IL,Lake,,2016,5.2,353803,373373,19570
17097,IL,Lake,,2017,4.5,356138,372970,16832
17097,IL,Lake,,2018,4.5,361329,378279,16950
17097,IL,Lake,,2019,3.9,362682,377561,14879
17097,IL,Lake,,2020,8.2,334143,363910,29767
17097,IL,Lake,,2021,5.3,346560,365816,19256
17099,IL,LaSalle,,2007,6,55438,58999,3561
17099,IL,LaSalle,,2008,7.9,54355,59018,4663
17099,IL,LaSalle,,2009,12.3,52000,59291,7291
17099,IL,LaSalle,,2010,12.1,54282,61782,7500
17099,IL,LaSalle,,2011,10.7,54331,60850,6519
17099,IL,LaSalle,,2012,10.1,53306,59300,5994
17099,IL,LaSalle,,2013,10.3,52085,58068,5983
17099,IL,LaSalle,,2014,8.2,52516,57214,4698
17099,IL,LaSalle,,2015,7,53493,57508,4015
17099,IL,LaSalle,,2016,6.8,53477,57348,3871
17099,IL,LaSalle,,2017,5.6,53036,56177,3141
17099,IL,LaSalle,,2018,5.7,52986,56203,3217
17099,IL,LaSalle,,2019,5.1,51979,54764,2785
17099,IL,LaSalle,,2020,9.6,47627,52669,5042
17099,IL,LaSalle,,2021,6,49536,52681,3145
17101,IL,Lawrence,,2007,4.9,7982,8389,407
17101,IL,Lawrence,,2008,7.5,7659,8280,621
17101,IL,Lawrence,,2009,10.1,7335,8161,826
17101,IL,Lawrence,,2010,10.8,5971,6694,723
17101,IL,Lawrence,,2011,10.7,5871,6575,704
17101,IL,Lawrence,,2012,10.3,5791,6453,662
17101,IL,Lawrence,,2013,10.2,5679,6323,644
17101,IL,Lawrence,,2014,7.8,5850,6347,497
17101,IL,Lawrence,,2015,7.1,5717,6155,438
17101,IL,Lawrence,,2016,7.4,5741,6200,459
17101,IL,Lawrence,,2017,6.4,5705,6095,390
17101,IL,Lawrence,,2018,6.2,5663,6036,373
17101,IL,Lawrence,,2019,5.3,5608,5920,312
17101,IL,Lawrence,,2020,9.1,5226,5747,521
17101,IL,Lawrence,,2021,6.1,5261,5602,341
17103,IL,Lee,,2007,5.1,17602,18551,949
17103,IL,Lee,,2008,7,16925,18195,1270
17103,IL,Lee,,2009,10.6,16331,18260,1929
17103,IL,Lee,,2010,10.1,17263,19198,1935
17103,IL,Lee,,2011,9.1,17118,18826,1708
17103,IL,Lee,,2012,8.3,16640,18149,1509
17103,IL,Lee,,2013,8,16635,18074,1439
17103,IL,Lee,,2014,6.3,16995,18138,1143
17103,IL,Lee,,2015,5.3,16921,17876,955
17103,IL,Lee,,2016,5.1,17168,18097,929
17103,IL,Lee,,2017,4.3,17065,17840,775
17103,IL,Lee,,2018,4.3,17178,17953,775
17103,IL,Lee,,2019,3.8,16972,17642,670
17103,IL,Lee,,2020,7,15894,17085,1191
17103,IL,Lee,,2021,4.5,16144,16913,769
17105,IL,Livingston,,2007,4.5,18717,19599,882
17105,IL,Livingston,,2008,6,18202,19356,1154
17105,IL,Livingston,,2009,10.4,17247,19243,1996
17105,IL,Livingston,,2010,10.1,17342,19285,1943
17105,IL,Livingston,,2011,8.5,17242,18841,1599
17105,IL,Livingston,,2012,7.8,16731,18146,1415
17105,IL,Livingston,,2013,8,16261,17684,1423
17105,IL,Livingston,,2014,6.4,16348,17474,1126
17105,IL,Livingston,,2015,5.4,16355,17287,932
17105,IL,Livingston,,2016,5.4,16174,17097,923
17105,IL,Livingston,,2017,4.5,15941,16684,743
17105,IL,Livingston,,2018,4.3,15976,16695,719
17105,IL,Livingston,,2019,3.9,15959,16603,644
17105,IL,Livingston,,2020,6.9,14784,15874,1090
17105,IL,Livingston,,2021,4.9,14739,15499,760
17107,IL,Logan,,2007,4.9,12828,13482,654
17107,IL,Logan,,2008,6.7,12478,13378,900
17107,IL,Logan,,2009,9.3,12072,13317,1245
17107,IL,Logan,,2010,8.8,12688,13912,1224
17107,IL,Logan,,2011,7.8,12629,13696,1067
17107,IL,Logan,,2012,7.5,12435,13450,1015
17107,IL,Logan,,2013,8.1,12000,13052,1052
17107,IL,Logan,,2014,6.5,12157,12996,839
17107,IL,Logan,,2015,5.4,12301,13007,706
17107,IL,Logan,,2016,5.3,12398,13097,699
17107,IL,Logan,,2017,4.6,12279,12873,594
17107,IL,Logan,,2018,4.6,12328,12929,601
17107,IL,Logan,,2019,4.2,12146,12672,526
17107,IL,Logan,,2020,6.9,11226,12057,831
17107,IL,Logan,,2021,4.8,11253,11820,567
17109,IL,McDonough,,2007,4.3,16483,17221,738
17109,IL,McDonough,,2008,5.6,15924,16863,939
17109,IL,McDonough,,2009,8.7,15440,16904,1464
17109,IL,McDonough,,2010,8.6,14270,15611,1341
17109,IL,McDonough,,2011,7.9,13940,15139,1199
17109,IL,McDonough,,2012,7.7,13797,14948,1151
17109,IL,McDonough,,2013,8.3,13414,14622,1208
17109,IL,McDonough,,2014,6.9,13307,14291,984
17109,IL,McDonough,,2015,6.1,13236,14096,860
17109,IL,McDonough,,2016,6.3,13203,14086,883
17109,IL,McDonough,,2017,5,12862,13541,679
17109,IL,McDonough,,2018,4.9,12742,13402,660
17109,IL,McDonough,,2019,4.4,12852,13448,596
17109,IL,McDonough,,2020,7.3,11844,12774,930
17109,IL,McDonough,,2021,4.9,12069,12693,624
17111,IL,McHenry,,2007,4.5,170185,178142,7957
17111,IL,McHenry,,2008,6,169705,180494,10789
17111,IL,McHenry,,2009,9.7,163110,180692,17582
17111,IL,McHenry,,2010,10.7,150630,168589,17959
17111,IL,McHenry,,2011,10,149281,165889,16608
17111,IL,McHenry,,2012,9,152545,167661,15116
17111,IL,McHenry,,2013,8.7,152728,167315,14587
17111,IL,McHenry,,2014,6.6,154933,165941,11008
17111,IL,McHenry,,2015,5.5,156760,165854,9094
17111,IL,McHenry,,2016,5.4,158890,167872,8982
17111,IL,McHenry,,2017,4.4,163010,170561,7551
17111,IL,McHenry,,2018,3.6,164248,170418,6170
17111,IL,McHenry,,2019,3.4,165911,171810,5899
17111,IL,McHenry,,2020,8,151528,164754,13226
17111,IL,McHenry,,2021,4.7,155389,163096,7707
17113,IL,McLean,,2007,3.8,86758,90176,3418
17113,IL,McLean,,2008,5,85918,90447,4529
17113,IL,McLean,,2009,7.3,84563,91225,6662
17113,IL,McLean,,2010,7.1,89107,95925,6818
17113,IL,McLean,,2011,6.6,89448,95765,6317
17113,IL,McLean,,2012,6.4,88452,94493,6041
17113,IL,McLean,,2013,6.5,86595,92664,6069
17113,IL,McLean,,2014,5.5,86138,91147,5009
17113,IL,McLean,,2015,4.8,87031,91406,4375
17113,IL,McLean,,2016,5.1,86313,90908,4595
17113,IL,McLean,,2017,4.1,85748,89435,3687
17113,IL,McLean,,2018,4.1,85542,89202,3660
17113,IL,McLean,,2019,3.6,85039,88203,3164
17113,IL,McLean,,2020,6.9,78925,84781,5856
17113,IL,McLean,,2021,4.6,81746,85656,3910
17115,IL,Macon,,2007,5.7,51300,54393,3093
17115,IL,Macon,,2008,7,50721,54510,3789
17115,IL,Macon,,2009,11.6,48357,54681,6324
17115,IL,Macon,,2010,11.2,49217,55417,6200
17115,IL,Macon,,2011,10,49724,55219,5495
17115,IL,Macon,,2012,9.9,48944,54340,5396
17115,IL,Macon,,2013,11.2,46762,52688,5926
17115,IL,Macon,,2014,8.6,46727,51102,4375
17115,IL,Macon,,2015,7,47380,50933,3553
17115,IL,Macon,,2016,6.6,47430,50782,3352
17115,IL,Macon,,2017,5.5,46914,49665,2751
17115,IL,Macon,,2018,5.5,47262,50025,2763
17115,IL,Macon,,2019,5,46300,48744,2444
17115,IL,Macon,,2020,10,42338,47056,4718
17115,IL,Macon,,2021,7.7,42989,46552,3563
17117,IL,Macoupin,,2007,6,23248,24737,1489
17117,IL,Macoupin,,2008,7.6,22692,24547,1855
17117,IL,Macoupin,,2009,10.7,21385,23945,2560
17117,IL,Macoupin,,2010,10.4,22168,24739,2571
17117,IL,Macoupin,,2011,9.7,22344,24754,2410
17117,IL,Macoupin,,2012,9.5,21674,23961,2287
17117,IL,Macoupin,,2013,9.4,21241,23450,2209
17117,IL,Macoupin,,2014,7.5,21388,23132,1744
17117,IL,Macoupin,,2015,6.3,21629,23092,1463
17117,IL,Macoupin,,2016,6,22060,23458,1398
17117,IL,Macoupin,,2017,4.9,21885,23010,1125
17117,IL,Macoupin,,2018,4.9,21985,23106,1121
17117,IL,Macoupin,,2019,4.1,22117,23057,940
17117,IL,Macoupin,,2020,7.1,20351,21896,1545
17117,IL,Macoupin,,2021,4.5,20988,21984,996
17119,IL,Madison,,2007,5.4,132839,140460,7621
17119,IL,Madison,,2008,6.6,130274,139466,9192
17119,IL,Madison,,2009,10.3,123884,138151,14267
17119,IL,Madison,,2010,9.9,124794,138482,13688
17119,IL,Madison,,2011,9,125357,137700,12343
17119,IL,Madison,,2012,8.9,123107,135081,11974
17119,IL,Madison,,2013,8.9,121325,133115,11790
17119,IL,Madison,,2014,7.1,122876,132263,9387
17119,IL,Madison,,2015,6,125231,133247,8016
17119,IL,Madison,,2016,5.9,127691,135685,7994
17119,IL,Madison,,2017,4.8,127896,134303,6407
17119,IL,Madison,,2018,4.5,128681,134724,6043
17119,IL,Madison,,2019,3.7,129990,135030,5040
17119,IL,Madison,,2020,7.9,120552,130887,10335
17119,IL,Madison,,2021,4.9,124425,130828,6403
17121,IL,Marion,,2007,6.4,17624,18837,1213
17121,IL,Marion,,2008,8.4,16969,18529,1560
17121,IL,Marion,,2009,12,16092,18293,2201
17121,IL,Marion,,2010,11,17249,19371,2122
17121,IL,Marion,,2011,10,17196,19117,1921
17121,IL,Marion,,2012,9.8,16760,18590,1830
17121,IL,Marion,,2013,10,16282,18096,1814
17121,IL,Marion,,2014,7.7,16658,18044,1386
17121,IL,Marion,,2015,6.8,16898,18125,1227
17121,IL,Marion,,2016,6.4,16947,18104,1157
17121,IL,Marion,,2017,5.2,16778,17707,929
17121,IL,Marion,,2018,4.9,17028,17900,872
17121,IL,Marion,,2019,4.2,16958,17706,748
17121,IL,Marion,,2020,9.4,15441,17044,1603
17121,IL,Marion,,2021,5.8,15835,16810,975
17123,IL,Marshall,,2007,4.4,6993,7315,322
17123,IL,Marshall,,2008,5.5,6823,7223,400
17123,IL,Marshall,,2009,10.6,6347,7098,751
17123,IL,Marshall,,2010,10.3,5750,6413,663
17123,IL,Marshall,,2011,8.9,5774,6339,565
17123,IL,Marshall,,2012,8.4,5675,6194,519
17123,IL,Marshall,,2013,9.1,5362,5899,537
17123,IL,Marshall,,2014,7.1,5344,5753,409
17123,IL,Marshall,,2015,6.6,5336,5716,380
17123,IL,Marshall,,2016,6.6,5280,5656,376
17123,IL,Marshall,,2017,5.4,5169,5464,295
17123,IL,Marshall,,2018,5.2,5162,5447,285
17123,IL,Marshall,,2019,4.6,5101,5346,245
17123,IL,Marshall,,2020,7.5,4680,5060,380
17123,IL,Marshall,,2021,5.6,4806,5092,286
17125,IL,Mason,,2007,6.6,6909,7397,488
17125,IL,Mason,,2008,8,6791,7380,589
17125,IL,Mason,,2009,12.4,6617,7554,937
17125,IL,Mason,,2010,12.3,6505,7419,914
17125,IL,Mason,,2011,10.7,6404,7168,764
17125,IL,Mason,,2012,10.1,6278,6982,704
17125,IL,Mason,,2013,10.9,5994,6728,734
17125,IL,Mason,,2014,8.7,6061,6636,575
17125,IL,Mason,,2015,7.1,6147,6620,473
17125,IL,Mason,,2016,7.1,6005,6466,461
17125,IL,Mason,,2017,6.1,6042,6433,391
17125,IL,Mason,,2018,5.9,5954,6328,374
17125,IL,Mason,,2019,5.1,5976,6296,320
17125,IL,Mason,,2020,8.1,5428,5908,480
17125,IL,Mason,,2021,5.4,5584,5904,320
17127,IL,Massac,,2007,5.7,7205,7638,433
17127,IL,Massac,,2008,7.2,6872,7402,530
17127,IL,Massac,,2009,9.1,6494,7141,647
17127,IL,Massac,,2010,9.6,6384,7059,675
17127,IL,Massac,,2011,8.9,6486,7118,632
17127,IL,Massac,,2012,9.7,5913,6545,632
17127,IL,Massac,,2013,9.8,5776,6401,625
17127,IL,Massac,,2014,8,5810,6318,508
17127,IL,Massac,,2015,7.3,5645,6090,445
17127,IL,Massac,,2016,7.1,5588,6018,430
17127,IL,Massac,,2017,6.5,5476,5855,379
17127,IL,Massac,,2018,6.9,5335,5731,396
17127,IL,Massac,,2019,5.3,5311,5610,299
17127,IL,Massac,,2020,10.1,4866,5413,547
17127,IL,Massac,,2021,5.8,5059,5368,309
17129,IL,Menard,,2007,4.5,6639,6949,310
17129,IL,Menard,,2008,5.6,6527,6915,388
17129,IL,Menard,,2009,7.5,6371,6886,515
17129,IL,Menard,,2010,7.7,6498,7037,539
17129,IL,Menard,,2011,7.3,6524,7039,515
17129,IL,Menard,,2012,7.2,6359,6851,492
17129,IL,Menard,,2013,7.2,6115,6588,473
17129,IL,Menard,,2014,5.8,6239,6624,385
17129,IL,Menard,,2015,4.8,6306,6624,318
17129,IL,Menard,,2016,4.7,6454,6772,318
17129,IL,Menard,,2017,4.2,6240,6516,276
17129,IL,Menard,,2018,4.1,6275,6541,266
17129,IL,Menard,,2019,3.7,6174,6410,236
17129,IL,Menard,,2020,6.6,5647,6043,396
17129,IL,Menard,,2021,4.1,5893,6145,252
17131,IL,Mercer,,2007,5.4,8467,8954,487
17131,IL,Mercer,,2008,6.8,8308,8917,609
17131,IL,Mercer,,2009,10.4,7728,8626,898
17131,IL,Mercer,,2010,10,8071,8970,899
17131,IL,Mercer,,2011,8.4,8125,8868,743
17131,IL,Mercer,,2012,7.8,7961,8632,671
17131,IL,Mercer,,2013,7.8,7763,8420,657
17131,IL,Mercer,,2014,7,7730,8316,586
17131,IL,Mercer,,2015,6.2,7728,8243,515
17131,IL,Mercer,,2016,6.2,7744,8258,514
17131,IL,Mercer,,2017,5.1,7666,8080,414
17131,IL,Mercer,,2018,5.2,7710,8134,424
17131,IL,Mercer,,2019,4.8,7681,8068,387
17131,IL,Mercer,,2020,8.2,6971,7597,626
17131,IL,Mercer,,2021,4.9,7184,7555,371
17133,IL,Monroe,,2007,4.3,17743,18535,792
17133,IL,Monroe,,2008,5.3,17583,18566,983
17133,IL,Monroe,,2009,7.9,16917,18362,1445
17133,IL,Monroe,,2010,7.4,16647,17970,1323
17133,IL,Monroe,,2011,6.7,16892,18111,1219
17133,IL,Monroe,,2012,6.7,16650,17855,1205
17133,IL,Monroe,,2013,6.7,16536,17715,1179
17133,IL,Monroe,,2014,5.4,16906,17873,967
17133,IL,Monroe,,2015,4.4,17333,18128,795
17133,IL,Monroe,,2016,4.1,17810,18565,755
17133,IL,Monroe,,2017,3.4,17877,18506,629
17133,IL,Monroe,,2018,3.4,18168,18809,641
17133,IL,Monroe,,2019,2.9,18619,19180,561
17133,IL,Monroe,,2020,5.6,17334,18371,1037
17133,IL,Monroe,,2021,3.1,17886,18465,579
17135,IL,Montgomery,,2007,6.6,12723,13627,904
17135,IL,Montgomery,,2008,8.7,12257,13430,1173
17135,IL,Montgomery,,2009,12,11706,13300,1594
17135,IL,Montgomery,,2010,12.4,12143,13867,1724
17135,IL,Montgomery,,2011,12,12007,13637,1630
17135,IL,Montgomery,,2012,11.3,11635,13115,1480
17135,IL,Montgomery,,2013,10.9,11194,12563,1369
17135,IL,Montgomery,,2014,8.8,11045,12114,1069
17135,IL,Montgomery,,2015,7.6,11123,12037,914
17135,IL,Montgomery,,2016,7.1,11297,12160,863
17135,IL,Montgomery,,2017,5.7,11261,11942,681
17135,IL,Montgomery,,2018,5.9,11231,11929,698
17135,IL,Montgomery,,2019,5,11184,11769,585
17135,IL,Montgomery,,2020,8.8,10421,11430,1009
17135,IL,Montgomery,,2021,5.4,10668,11279,611
17137,IL,Morgan,,2007,5,17142,18035,893
17137,IL,Morgan,,2008,6.2,16807,17914,1107
17137,IL,Morgan,,2009,8.1,16094,17522,1428
17137,IL,Morgan,,2010,8.5,16777,18336,1559
17137,IL,Morgan,,2011,8.1,16629,18086,1457
17137,IL,Morgan,,2012,7.8,16280,17650,1370
17137,IL,Morgan,,2013,7.8,15971,17328,1357
17137,IL,Morgan,,2014,6,16125,17158,1033
17137,IL,Morgan,,2015,5,16106,16959,853
17137,IL,Morgan,,2016,4.9,16165,17005,840
17137,IL,Morgan,,2017,4.4,15721,16441,720
17137,IL,Morgan,,2018,4.4,15682,16401,719
17137,IL,Morgan,,2019,3.8,15882,16515,633
17137,IL,Morgan,,2020,7,14746,15854,1108
17137,IL,Morgan,,2021,5,14958,15739,781
17139,IL,Moultrie,,2007,3.7,7858,8157,299
17139,IL,Moultrie,,2008,5.2,7586,8000,414
17139,IL,Moultrie,,2009,8.8,7147,7835,688
17139,IL,Moultrie,,2010,8.6,7012,7673,661
17139,IL,Moultrie,,2011,7.6,6894,7461,567
17139,IL,Moultrie,,2012,7.1,6837,7363,526
17139,IL,Moultrie,,2013,7.1,6588,7095,507
17139,IL,Moultrie,,2014,5.5,6667,7052,385
17139,IL,Moultrie,,2015,4.4,7064,7386,322
17139,IL,Moultrie,,2016,4.6,7133,7475,342
17139,IL,Moultrie,,2017,3.9,7055,7339,284
17139,IL,Moultrie,,2018,3.8,7247,7530,283
17139,IL,Moultrie,,2019,3.2,7376,7618,242
17139,IL,Moultrie,,2020,5.2,6870,7244,374
17139,IL,Moultrie,,2021,3.5,7077,7337,260
17141,IL,Ogle,,2007,5.6,26352,27917,1565
17141,IL,Ogle,,2008,7.8,25707,27893,2186
17141,IL,Ogle,,2009,12.6,23995,27441,3446
17141,IL,Ogle,,2010,12.5,24627,28157,3530
17141,IL,Ogle,,2011,11.5,24270,27416,3146
17141,IL,Ogle,,2012,10.2,23831,26528,2697
17141,IL,Ogle,,2013,9.8,23219,25747,2528
17141,IL,Ogle,,2014,7.5,23982,25916,1934
17141,IL,Ogle,,2015,6.2,24345,25947,1602
17141,IL,Ogle,,2016,5.9,24368,25900,1532
17141,IL,Ogle,,2017,5.1,24125,25428,1303
17141,IL,Ogle,,2018,4.9,24256,25519,1263
17141,IL,Ogle,,2019,4.6,23845,25002,1157
17141,IL,Ogle,,2020,8.3,22102,24093,1991
17141,IL,Ogle,,2021,5.8,22277,23645,1368
17143,IL,Peoria,,2007,4.7,92871,97404,4533
17143,IL,Peoria,,2008,5.9,92242,97974,5732
17143,IL,Peoria,,2009,11.1,86594,97422,10828
17143,IL,Peoria,,2010,10.6,85660,95831,10171
17143,IL,Peoria,,2011,9.3,87252,96158,8906
17143,IL,Peoria,,2012,8.4,87671,95751,8080
17143,IL,Peoria,,2013,9.6,84411,93391,8980
17143,IL,Peoria,,2014,7.8,84396,91488,7092
17143,IL,Peoria,,2015,6.9,83891,90083,6192
17143,IL,Peoria,,2016,6.9,82310,88412,6102
17143,IL,Peoria,,2017,5.9,81231,86296,5065
17143,IL,Peoria,,2018,5.5,81849,86643,4794
17143,IL,Peoria,,2019,4.9,81021,85172,4151
17143,IL,Peoria,,2020,10.5,74688,83410,8722
17143,IL,Peoria,,2021,7.2,76764,82725,5961
17145,IL,Perry,,2007,8.4,9165,10000,835
17145,IL,Perry,,2008,9.7,8641,9571,930
17145,IL,Perry,,2009,12.1,8253,9388,1135
17145,IL,Perry,,2010,11.2,8511,9580,1069
17145,IL,Perry,,2011,10.2,8496,9462,966
17145,IL,Perry,,2012,10.7,8211,9191,980
17145,IL,Perry,,2013,11,8023,9014,991
17145,IL,Perry,,2014,8.5,8127,8884,757
17145,IL,Perry,,2015,7.1,8239,8873,634
17145,IL,Perry,,2016,7.1,8121,8743,622
17145,IL,Perry,,2017,6,7909,8415,506
17145,IL,Perry,,2018,5.9,7973,8475,502
17145,IL,Perry,,2019,4.9,7931,8341,410
17145,IL,Perry,,2020,9.5,7298,8068,770
17145,IL,Perry,,2021,5.8,7472,7928,456
17147,IL,Piatt,,2007,3.8,8700,9046,346
17147,IL,Piatt,,2008,5,8492,8940,448
17147,IL,Piatt,,2009,8.1,8140,8855,715
17147,IL,Piatt,,2010,7.9,8434,9157,723
17147,IL,Piatt,,2011,6.9,8392,9014,622
17147,IL,Piatt,,2012,6.7,8212,8806,594
17147,IL,Piatt,,2013,6.9,8019,8616,597
17147,IL,Piatt,,2014,5.5,8107,8581,474
17147,IL,Piatt,,2015,4.9,8135,8556,421
17147,IL,Piatt,,2016,4.9,8305,8729,424
17147,IL,Piatt,,2017,4.1,8209,8557,348
17147,IL,Piatt,,2018,4.2,8230,8591,361
17147,IL,Piatt,,2019,3.5,8320,8619,299
17147,IL,Piatt,,2020,5.6,7887,8351,464
17147,IL,Piatt,,2021,4,8153,8495,342
17149,IL,Pike,,2007,4.6,8360,8762,402
17149,IL,Pike,,2008,5.9,8024,8527,503
17149,IL,Pike,,2009,8.1,7759,8446,687
17149,IL,Pike,,2010,9,7378,8109,731
17149,IL,Pike,,2011,8.1,7276,7914,638
17149,IL,Pike,,2012,7.6,7173,7763,590
17149,IL,Pike,,2013,7.5,7111,7687,576
17149,IL,Pike,,2014,5.8,7298,7748,450
17149,IL,Pike,,2015,5.2,7232,7628,396
17149,IL,Pike,,2016,5.1,7155,7542,387
17149,IL,Pike,,2017,4.5,6971,7302,331
17149,IL,Pike,,2018,4.8,6889,7235,346
17149,IL,Pike,,2019,4.1,6762,7054,292
17149,IL,Pike,,2020,6.1,6323,6731,408
17149,IL,Pike,,2021,4.1,6510,6787,277
17151,IL,Pope,,2007,7,1830,1968,138
17151,IL,Pope,,2008,8.4,1771,1934,163
17151,IL,Pope,,2009,10.4,1698,1896,198
17151,IL,Pope,,2010,9.6,1835,2029,194
17151,IL,Pope,,2011,8.8,1796,1970,174
17151,IL,Pope,,2012,8.6,1721,1883,162
17151,IL,Pope,,2013,9.2,1661,1830,169
17151,IL,Pope,,2014,8.4,1646,1796,150
17151,IL,Pope,,2015,7,1645,1769,124
17151,IL,Pope,,2016,7.2,1647,1774,127
17151,IL,Pope,,2017,6.5,1670,1786,116
17151,IL,Pope,,2018,6,1659,1765,106
17151,IL,Pope,,2019,5.3,1596,1685,89
17151,IL,Pope,,2020,8.1,1506,1638,132
17151,IL,Pope,,2021,5.1,1591,1676,85
17153,IL,Pulaski,,2007,7.2,2725,2936,211
17153,IL,Pulaski,,2008,9.4,2620,2892,272
17153,IL,Pulaski,,2009,11.2,2520,2838,318
17153,IL,Pulaski,,2010,12.6,2166,2477,311
17153,IL,Pulaski,,2011,12,2075,2357,282
17153,IL,Pulaski,,2012,11.4,2096,2367,271
17153,IL,Pulaski,,2013,12.5,1939,2216,277
17153,IL,Pulaski,,2014,10.5,1914,2138,224
17153,IL,Pulaski,,2015,8.9,1907,2093,186
17153,IL,Pulaski,,2016,8.4,2017,2203,186
17153,IL,Pulaski,,2017,7.9,1958,2127,169
17153,IL,Pulaski,,2018,8,1911,2077,166
17153,IL,Pulaski,,2019,6.3,1829,1953,124
17153,IL,Pulaski,,2020,11.8,1549,1757,208
17153,IL,Pulaski,,2021,9.3,1544,1702,158
17155,IL,Putnam,,2007,5.8,3034,3222,188
17155,IL,Putnam,,2008,7.1,2973,3201,228
17155,IL,Putnam,,2009,13.7,2847,3298,451
17155,IL,Putnam,,2010,12.1,2905,3304,399
17155,IL,Putnam,,2011,10.3,2869,3199,330
17155,IL,Putnam,,2012,9.4,2830,3123,293
17155,IL,Putnam,,2013,9.9,2750,3052,302
17155,IL,Putnam,,2014,7.7,2799,3033,234
17155,IL,Putnam,,2015,6.2,2858,3046,188
17155,IL,Putnam,,2016,5.6,2945,3121,176
17155,IL,Putnam,,2017,5,2858,3007,149
17155,IL,Putnam,,2018,5.2,2888,3048,160
17155,IL,Putnam,,2019,4.9,2893,3041,148
17155,IL,Putnam,,2020,8.5,2689,2938,249
17155,IL,Putnam,,2021,5,2808,2956,148
17157,IL,Randolph,,2007,5.3,14841,15665,824
17157,IL,Randolph,,2008,6.7,14280,15304,1024
17157,IL,Randolph,,2009,9.3,13748,15162,1414
17157,IL,Randolph,,2010,8.9,13671,15003,1332
17157,IL,Randolph,,2011,8.3,13572,14799,1227
17157,IL,Randolph,,2012,8.4,13322,14550,1228
17157,IL,Randolph,,2013,8.4,13167,14368,1201
17157,IL,Randolph,,2014,6.7,13215,14161,946
17157,IL,Randolph,,2015,5.4,13550,14329,779
17157,IL,Randolph,,2016,5,13878,14609,731
17157,IL,Randolph,,2017,4.4,13575,14201,626
17157,IL,Randolph,,2018,4.4,13609,14228,619
17157,IL,Randolph,,2019,3.5,13841,14340,499
17157,IL,Randolph,,2020,7.2,12740,13728,988
17157,IL,Randolph,,2021,4.3,13082,13674,592
17159,IL,Richland,,2007,4.7,7435,7804,369
17159,IL,Richland,,2008,6.6,7023,7518,495
17159,IL,Richland,,2009,10.1,6520,7256,736
17159,IL,Richland,,2010,9,7281,7999,718
17159,IL,Richland,,2011,8.2,7160,7802,642
17159,IL,Richland,,2012,8.1,6909,7515,606
17159,IL,Richland,,2013,8.3,6754,7367,613
17159,IL,Richland,,2014,6.5,6761,7231,470
17159,IL,Richland,,2015,5.9,7038,7478,440
17159,IL,Richland,,2016,5.9,7124,7574,450
17159,IL,Richland,,2017,4.8,7198,7560,362
17159,IL,Richland,,2018,4.6,7174,7521,347
17159,IL,Richland,,2019,3.9,6974,7257,283
17159,IL,Richland,,2020,6.9,6843,7350,507
17159,IL,Richland,,2021,4.3,6753,7057,304
17161,IL,Rock Island,,2007,4.6,76394,80045,3651
17161,IL,Rock Island,,2008,5.6,74769,79192,4423
17161,IL,Rock Island,,2009,9.3,70410,77625,7215
17161,IL,Rock Island,,2010,9.6,69113,76412,7299
17161,IL,Rock Island,,2011,8.5,69763,76237,6474
17161,IL,Rock Island,,2012,8,69246,75306,6060
17161,IL,Rock Island,,2013,8.3,67713,73808,6095
17161,IL,Rock Island,,2014,7.1,67727,72905,5178
17161,IL,Rock Island,,2015,6.4,68066,72708,4642
17161,IL,Rock Island,,2016,6.3,67847,72387,4540
17161,IL,Rock Island,,2017,5.1,67677,71323,3646
17161,IL,Rock Island,,2018,5.2,67823,71529,3706
17161,IL,Rock Island,,2019,4.8,67620,70995,3375
17161,IL,Rock Island,,2020,9.6,61912,68489,6577
17161,IL,Rock Island,,2021,5.6,63924,67709,3785
17163,IL,St. Clair,,2007,6.2,117508,125222,7714
17163,IL,St. Clair,,2008,7.6,115353,124905,9552
17163,IL,St. Clair,,2009,11,110095,123698,13603
17163,IL,St. Clair,,2010,10.4,119089,132854,13765
17163,IL,St. Clair,,2011,9.7,119838,132746,12908
17163,IL,St. Clair,,2012,9.6,117358,129815,12457
17163,IL,St. Clair,,2013,9.8,115207,127666,12459
17163,IL,St. Clair,,2014,7.9,116428,126426,9998
17163,IL,St. Clair,,2015,6.6,118065,126401,8336
17163,IL,St. Clair,,2016,6.1,119971,127728,7757
17163,IL,St. Clair,,2017,5.1,120179,126599,6420
17163,IL,St. Clair,,2018,5,120729,127097,6368
17163,IL,St. Clair,,2019,4.2,121998,127373,5375
17163,IL,St. Clair,,2020,9.2,112587,124057,11470
17163,IL,St. Clair,,2021,6.1,116222,123792,7570
17165,IL,Saline,,2007,6.5,11883,12704,821
17165,IL,Saline,,2008,8.2,11485,12511,1026
17165,IL,Saline,,2009,10,11362,12624,1262
17165,IL,Saline,,2010,10.3,10421,11615,1194
17165,IL,Saline,,2011,9.5,10542,11651,1109
17165,IL,Saline,,2012,9.1,10541,11601,1060
17165,IL,Saline,,2013,10.5,10081,11269,1188
17165,IL,Saline,,2014,8.3,9878,10768,890
17165,IL,Saline,,2015,7.8,9563,10367,804
17165,IL,Saline,,2016,8.6,9228,10092,864
17165,IL,Saline,,2017,6.4,9152,9783,631
17165,IL,Saline,,2018,6.4,9246,9881,635
17165,IL,Saline,,2019,5.1,9173,9661,488
17165,IL,Saline,,2020,9.9,8559,9502,943
17165,IL,Saline,,2021,6.6,8661,9274,613
17167,IL,Sangamon,,2007,4.5,102718,107566,4848
17167,IL,Sangamon,,2008,5.7,101413,107531,6118
17167,IL,Sangamon,,2009,7.5,99377,107466,8089
17167,IL,Sangamon,,2010,7.9,98527,106966,8439
17167,IL,Sangamon,,2011,7.5,99273,107363,8090
17167,IL,Sangamon,,2012,7.5,97124,104950,7826
17167,IL,Sangamon,,2013,7.5,94098,101749,7651
17167,IL,Sangamon,,2014,6.1,96182,102401,6219
17167,IL,Sangamon,,2015,5.3,98071,103571,5500
17167,IL,Sangamon,,2016,5,99031,104237,5206
17167,IL,Sangamon,,2017,4.4,97335,101845,4510
17167,IL,Sangamon,,2018,4.4,97167,101647,4480
17167,IL,Sangamon,,2019,3.9,96007,99908,3901
17167,IL,Sangamon,,2020,8.4,88467,96553,8086
17167,IL,Sangamon,,2021,5.5,92423,97844,5421
17169,IL,Schuyler,,2007,4.1,4249,4430,181
17169,IL,Schuyler,,2008,5.2,4114,4339,225
17169,IL,Schuyler,,2009,6.8,3930,4216,286
17169,IL,Schuyler,,2010,8.3,3536,3856,320
17169,IL,Schuyler,,2011,8,3466,3769,303
17169,IL,Schuyler,,2012,7.9,3325,3611,286
17169,IL,Schuyler,,2013,8.3,3184,3472,288
17169,IL,Schuyler,,2014,6.8,3222,3457,235
17169,IL,Schuyler,,2015,5.9,3283,3487,204
17169,IL,Schuyler,,2016,5.6,3183,3372,189
17169,IL,Schuyler,,2017,4.6,3188,3340,152
17169,IL,Schuyler,,2018,4.4,3198,3345,147
17169,IL,Schuyler,,2019,4,3136,3265,129
17169,IL,Schuyler,,2020,6.3,2929,3126,197
17169,IL,Schuyler,,2021,3.9,3026,3150,124
17171,IL,Scott,,2007,5.2,2635,2779,144
17171,IL,Scott,,2008,6,2568,2733,165
17171,IL,Scott,,2009,7.8,2490,2702,212
17171,IL,Scott,,2010,8.8,2622,2874,252
17171,IL,Scott,,2011,8.3,2608,2843,235
17171,IL,Scott,,2012,8.8,2458,2694,236
17171,IL,Scott,,2013,8.9,2367,2598,231
17171,IL,Scott,,2014,7,2376,2554,178
17171,IL,Scott,,2015,5.9,2405,2556,151
17171,IL,Scott,,2016,5.7,2394,2538,144
17171,IL,Scott,,2017,5.2,2329,2458,129
17171,IL,Scott,,2018,5.1,2358,2486,128
17171,IL,Scott,,2019,4.5,2398,2512,114
17171,IL,Scott,,2020,6.7,2189,2347,158
17171,IL,Scott,,2021,5.1,2179,2296,117
17173,IL,Shelby,,2007,4.9,10669,11214,545
17173,IL,Shelby,,2008,6.6,10411,11148,737
17173,IL,Shelby,,2009,9.9,10005,11109,1104
17173,IL,Shelby,,2010,9.8,10103,11199,1096
17173,IL,Shelby,,2011,9.1,10024,11029,1005
17173,IL,Shelby,,2012,8.6,9829,10757,928
17173,IL,Shelby,,2013,8.7,9403,10302,899
17173,IL,Shelby,,2014,6.8,9466,10158,692
17173,IL,Shelby,,2015,5.9,9656,10261,605
17173,IL,Shelby,,2016,5.7,9842,10439,597
17173,IL,Shelby,,2017,4.4,9966,10427,461
17173,IL,Shelby,,2018,4.2,10301,10757,456
17173,IL,Shelby,,2019,3.7,10250,10646,396
17173,IL,Shelby,,2020,6.6,9539,10210,671
17173,IL,Shelby,,2021,4.2,9768,10192,424
17175,IL,Stark,,2007,5.1,2838,2992,154
17175,IL,Stark,,2008,6.5,2783,2975,192
17175,IL,Stark,,2009,10.5,2534,2830,296
17175,IL,Stark,,2010,9.9,2725,3023,298
17175,IL,Stark,,2011,8.8,2711,2973,262
17175,IL,Stark,,2012,8.2,2744,2989,245
17175,IL,Stark,,2013,9.5,2606,2881,275
17175,IL,Stark,,2014,7.6,2589,2802,213
17175,IL,Stark,,2015,6.7,2581,2765,184
17175,IL,Stark,,2016,7.4,2567,2771,204
17175,IL,Stark,,2017,6.3,2408,2571,163
17175,IL,Stark,,2018,6.2,2434,2595,161
17175,IL,Stark,,2019,5.5,2388,2527,139
17175,IL,Stark,,2020,7.4,2178,2352,174
17175,IL,Stark,,2021,5.5,2233,2362,129
17177,IL,Stephenson,,2007,5.1,24130,25440,1310
17177,IL,Stephenson,,2008,6.9,23669,25419,1750
17177,IL,Stephenson,,2009,11.5,22140,25017,2877
17177,IL,Stephenson,,2010,11.2,21889,24640,2751
17177,IL,Stephenson,,2011,9.8,21822,24198,2376
17177,IL,Stephenson,,2012,9.1,21285,23413,2128
17177,IL,Stephenson,,2013,9.4,20587,22717,2130
17177,IL,Stephenson,,2014,7.4,20584,22233,1649
17177,IL,Stephenson,,2015,6.6,20149,21576,1427
17177,IL,Stephenson,,2016,5.9,20237,21497,1260
17177,IL,Stephenson,,2017,4.7,20669,21682,1013
17177,IL,Stephenson,,2018,4.6,21190,22219,1029
17177,IL,Stephenson,,2019,4.2,20911,21819,908
17177,IL,Stephenson,,2020,7.4,19492,21056,1564
17177,IL,Stephenson,,2021,5.5,19705,20851,1146
17179,IL,Tazewell,,2007,4.3,70222,73359,3137
17179,IL,Tazewell,,2008,5.3,69692,73616,3924
17179,IL,Tazewell,,2009,10.6,65134,72885,7751
17179,IL,Tazewell,,2010,10,64357,71500,7143
17179,IL,Tazewell,,2011,8.3,65546,71499,5953
17179,IL,Tazewell,,2012,7.5,65789,71145,5356
17179,IL,Tazewell,,2013,8.6,63046,68998,5952
17179,IL,Tazewell,,2014,6.8,63132,67731,4599
17179,IL,Tazewell,,2015,6.3,62712,66915,4203
17179,IL,Tazewell,,2016,6.4,61804,66050,4246
17179,IL,Tazewell,,2017,5.3,61264,64722,3458
17179,IL,Tazewell,,2018,4.8,61926,65070,3144
17179,IL,Tazewell,,2019,4.2,61545,64246,2701
17179,IL,Tazewell,,2020,8.3,56747,61851,5104
17179,IL,Tazewell,,2021,5,58305,61358,3053
17181,IL,Union,,2007,6.9,7825,8406,581
17181,IL,Union,,2008,8.7,7597,8323,726
17181,IL,Union,,2009,11.3,7178,8092,914
17181,IL,Union,,2010,12.1,6998,7958,960
17181,IL,Union,,2011,11.7,6851,7756,905
17181,IL,Union,,2012,11,6720,7550,830
17181,IL,Union,,2013,11.2,6578,7406,828
17181,IL,Union,,2014,8.9,6647,7295,648
17181,IL,Union,,2015,7.7,6800,7367,567
17181,IL,Union,,2016,7.4,6995,7555,560
17181,IL,Union,,2017,6.4,6896,7371,475
17181,IL,Union,,2018,6.4,6990,7466,476
17181,IL,Union,,2019,5.4,7062,7465,403
17181,IL,Union,,2020,8.2,6585,7175,590
17181,IL,Union,,2021,5.7,6763,7169,406
17183,IL,Vermilion,,2007,6.2,35373,37722,2349
17183,IL,Vermilion,,2008,7.9,34400,37345,2945
17183,IL,Vermilion,,2009,11.6,32735,37046,4311
17183,IL,Vermilion,,2010,11.6,33348,37725,4377
17183,IL,Vermilion,,2011,10,33669,37405,3736
17183,IL,Vermilion,,2012,9.3,33364,36797,3433
17183,IL,Vermilion,,2013,10.6,32046,35837,3791
17183,IL,Vermilion,,2014,8.6,32441,35478,3037
17183,IL,Vermilion,,2015,7.1,32881,35399,2518
17183,IL,Vermilion,,2016,7.3,32499,35043,2544
17183,IL,Vermilion,,2017,6.5,31813,34024,2211
17183,IL,Vermilion,,2018,6.1,31584,33640,2056
17183,IL,Vermilion,,2019,4.9,31518,33145,1627
17183,IL,Vermilion,,2020,9,29399,32302,2903
17183,IL,Vermilion,,2021,6.5,29689,31753,2064
17185,IL,Wabash,,2007,5.5,6058,6412,354
17185,IL,Wabash,,2008,7.4,5669,6119,450
17185,IL,Wabash,,2009,10.5,5399,6031,632
17185,IL,Wabash,,2010,9.8,5275,5851,576
17185,IL,Wabash,,2011,8.9,5292,5809,517
17185,IL,Wabash,,2012,8,5289,5748,459
17185,IL,Wabash,,2013,7.5,5215,5635,420
17185,IL,Wabash,,2014,6,5230,5565,335
17185,IL,Wabash,,2015,5.7,5314,5633,319
17185,IL,Wabash,,2016,6.3,5415,5778,363
17185,IL,Wabash,,2017,5.2,5358,5654,296
17185,IL,Wabash,,2018,4.9,5538,5826,288
17185,IL,Wabash,,2019,4,5619,5854,235
17185,IL,Wabash,,2020,8.5,5193,5673,480
17185,IL,Wabash,,2021,4.5,5165,5409,244
17187,IL,Warren,,2007,4.5,8779,9194,415
17187,IL,Warren,,2008,5.7,8708,9234,526
17187,IL,Warren,,2009,7.5,8512,9205,693
17187,IL,Warren,,2010,7.8,8552,9275,723
17187,IL,Warren,,2011,7.2,8464,9123,659
17187,IL,Warren,,2012,7.1,8258,8892,634
17187,IL,Warren,,2013,7.3,8169,8813,644
17187,IL,Warren,,2014,5.9,8219,8732,513
17187,IL,Warren,,2015,5.2,8132,8580,448
17187,IL,Warren,,2016,5.3,8273,8734,461
17187,IL,Warren,,2017,4.2,8308,8670,362
17187,IL,Warren,,2018,4.1,8367,8729,362
17187,IL,Warren,,2019,3.9,8184,8515,331
17187,IL,Warren,,2020,6.3,7541,8049,508
17187,IL,Warren,,2021,4.6,7425,7782,357
17189,IL,Washington,,2007,4.6,8125,8518,393
17189,IL,Washington,,2008,6.1,7818,8324,506
17189,IL,Washington,,2009,8.2,7390,8048,658
17189,IL,Washington,,2010,7.3,7861,8482,621
17189,IL,Washington,,2011,6.6,8137,8714,577
17189,IL,Washington,,2012,6.4,8528,9109,581
17189,IL,Washington,,2013,6.2,8361,8912,551
17189,IL,Washington,,2014,4.8,8587,9019,432
17189,IL,Washington,,2015,3.8,9016,9371,355
17189,IL,Washington,,2016,3.8,9321,9686,365
17189,IL,Washington,,2017,3,9284,9571,287
17189,IL,Washington,,2018,2.9,9601,9890,289
17189,IL,Washington,,2019,2.4,9778,10023,245
17189,IL,Washington,,2020,5.3,9019,9528,509
17189,IL,Washington,,2021,3,9264,9551,287
17191,IL,Wayne,,2007,4.8,8009,8410,401
17191,IL,Wayne,,2008,6.4,7766,8301,535
17191,IL,Wayne,,2009,10.1,7297,8113,816
17191,IL,Wayne,,2010,9,7629,8381,752
17191,IL,Wayne,,2011,8,7546,8205,659
17191,IL,Wayne,,2012,7.7,7379,7996,617
17191,IL,Wayne,,2013,7.7,7266,7875,609
17191,IL,Wayne,,2014,6.7,7159,7670,511
17191,IL,Wayne,,2015,6.9,6996,7515,519
17191,IL,Wayne,,2016,8.5,6707,7332,625
17191,IL,Wayne,,2017,6.2,6531,6960,429
17191,IL,Wayne,,2018,5.5,6544,6925,381
17191,IL,Wayne,,2019,4.6,6683,7002,319
17191,IL,Wayne,,2020,8.4,6190,6760,570
17191,IL,Wayne,,2021,4.7,6449,6766,317
17193,IL,White,,2007,5.2,7589,8004,415
17193,IL,White,,2008,6.5,7310,7816,506
17193,IL,White,,2009,8.7,7009,7675,666
17193,IL,White,,2010,8.6,6920,7569,649
17193,IL,White,,2011,7.9,6833,7420,587
17193,IL,White,,2012,7.6,6695,7246,551
17193,IL,White,,2013,7.6,6485,7022,537
17193,IL,White,,2014,5.9,6652,7070,418
17193,IL,White,,2015,5.7,6542,6941,399
17193,IL,White,,2016,6.6,6464,6919,455
17193,IL,White,,2017,4.9,6363,6693,330
17193,IL,White,,2018,4.2,6450,6736,286
17193,IL,White,,2019,3.7,6381,6627,246
17193,IL,White,,2020,7.9,5605,6084,479
17193,IL,White,,2021,5,5660,5956,296
17195,IL,Whiteside,,2007,5.4,29134,30784,1650
17195,IL,Whiteside,,2008,6.9,28164,30243,2079
17195,IL,Whiteside,,2009,10.4,27172,30340,3168
17195,IL,Whiteside,,2010,10.4,26748,29842,3094
17195,IL,Whiteside,,2011,9.5,26843,29647,2804
17195,IL,Whiteside,,2012,8.8,26773,29369,2596
17195,IL,Whiteside,,2013,8.7,26809,29360,2551
17195,IL,Whiteside,,2014,7,26581,28576,1995
17195,IL,Whiteside,,2015,6.2,26796,28567,1771
17195,IL,Whiteside,,2016,5.8,27177,28851,1674
17195,IL,Whiteside,,2017,4.8,26869,28228,1359
17195,IL,Whiteside,,2018,4.5,27371,28652,1281
17195,IL,Whiteside,,2019,4.1,27593,28759,1166
17195,IL,Whiteside,,2020,8.2,25367,27618,2251
17195,IL,Whiteside,,2021,4.8,26015,27339,1324
17197,IL,Will,,2007,4.9,342270,359958,17688
17197,IL,Will,,2008,6.3,342189,365116,22927
17197,IL,Will,,2009,10.2,328507,366000,37493
17197,IL,Will,,2010,11.2,315408,355134,39726
17197,IL,Will,,2011,10.7,314639,352460,37821
17197,IL,Will,,2012,9.8,322411,357443,35032
17197,IL,Will,,2013,9.9,323807,359245,35438
17197,IL,Will,,2014,7.7,329806,357335,27529
17197,IL,Will,,2015,6.3,334632,356963,22331
17197,IL,Will,,2016,6.1,340783,362899,22116
17197,IL,Will,,2017,5.1,348996,367608,18612
17197,IL,Will,,2018,4.2,352220,367616,15396
17197,IL,Will,,2019,4,356223,370932,14709
17197,IL,Will,,2020,9.1,326219,358767,32548
17197,IL,Will,,2021,5.7,334452,354842,20390
17199,IL,Williamson,,2007,6.5,33856,36212,2356
17199,IL,Williamson,,2008,7.1,32820,35312,2492
17199,IL,Williamson,,2009,9.3,31333,34559,3226
17199,IL,Williamson,,2010,9.8,29292,32485,3193
17199,IL,Williamson,,2011,9.1,29384,32317,2933
17199,IL,Williamson,,2012,8.7,28964,31721,2757
17199,IL,Williamson,,2013,9,28631,31456,2825
17199,IL,Williamson,,2014,7.2,29133,31389,2256
17199,IL,Williamson,,2015,6.2,30002,31983,1981
17199,IL,Williamson,,2016,6.1,30465,32460,1995
17199,IL,Williamson,,2017,5.1,30213,31852,1639
17199,IL,Williamson,,2018,5,30576,32198,1622
17199,IL,Williamson,,2019,4.1,30886,32203,1317
17199,IL,Williamson,,2020,8.8,28585,31360,2775
17199,IL,Williamson,,2021,5.5,29419,31145,1726
17201,IL,Winnebago,,2007,6.1,139654,148651,8997
17201,IL,Winnebago,,2008,8.6,134880,147583,12703
17201,IL,Winnebago,,2009,15.2,122725,144667,21942
17201,IL,Winnebago,,2010,14.1,128423,149585,21162
17201,IL,Winnebago,,2011,11.9,129684,147218,17534
17201,IL,Winnebago,,2012,10.6,129872,145295,15423
17201,IL,Winnebago,,2013,10.5,127922,142881,14959
17201,IL,Winnebago,,2014,8.4,129969,141833,11864
17201,IL,Winnebago,,2015,7,132206,142199,9993
17201,IL,Winnebago,,2016,6.7,132448,141910,9462
17201,IL,Winnebago,,2017,6.4,130256,139230,8974
17201,IL,Winnebago,,2018,5.6,133661,141660,7999
17201,IL,Winnebago,,2019,5.4,132166,139696,7530
17201,IL,Winnebago,,2020,11.5,119837,135434,15597
17201,IL,Winnebago,,2021,8.4,122161,133417,11256
17203,IL,Woodford,,2007,3.5,20693,21439,746
17203,IL,Woodford,,2008,4.3,20740,21680,940
17203,IL,Woodford,,2009,8.3,19423,21183,1760
17203,IL,Woodford,,2010,7.7,18719,20285,1566
17203,IL,Woodford,,2011,6.4,19167,20487,1320
17203,IL,Woodford,,2012,6,19176,20400,1224
17203,IL,Woodford,,2013,7.1,18492,19898,1406
17203,IL,Woodford,,2014,5.6,18574,19671,1097
17203,IL,Woodford,,2015,5.1,18598,19594,996
17203,IL,Woodford,,2016,5.5,18367,19433,1066
17203,IL,Woodford,,2017,4.4,18125,18956,831
17203,IL,Woodford,,2018,4,18341,19114,773
17203,IL,Woodford,,2019,3.5,18294,18967,673
17203,IL,Woodford,,2020,6.2,16831,17945,1114
17203,IL,Woodford,,2021,4,17289,18001,712
18000,IN,Indiana,,2007,4.6,3054548,3202589,148041
18000,IN,Indiana,,2008,5.9,3053593,3244790,191197
18000,IN,Indiana,,2009,10.5,2880173,3216535,336362
18000,IN,Indiana,,2010,10.1,2854843,3175885,321042
18000,IN,Indiana,,2011,8.9,2904397,3189011,284614
18000,IN,Indiana,,2012,8.2,2911925,3172556,260631
18000,IN,Indiana,,2013,7.5,2953672,3193683,240011
18000,IN,Indiana,,2014,5.9,3036685,3228524,191839
18000,IN,Indiana,,2015,4.8,3109791,3266392,156601
18000,IN,Indiana,,2016,4.4,3186420,3331821,145401
18000,IN,Indiana,,2017,3.5,3217049,3333693,116644
18000,IN,Indiana,,2018,3.4,3270727,3385707,114980
18000,IN,Indiana,,2019,3.3,3282443,3393763,111320
18000,IN,Indiana,,2020,7.2,3083159,3322829,239670
18000,IN,Indiana,,2021,3.6,3203166,3321548,118382
18001,IN,Adams,,2007,4.3,15245,15933,688
18001,IN,Adams,,2008,7.7,14389,15581,1192
18001,IN,Adams,,2009,14.8,12979,15237,2258
18001,IN,Adams,,2010,9.8,14792,16403,1611
18001,IN,Adams,,2011,7.6,14955,16192,1237
18001,IN,Adams,,2012,6.9,14797,15901,1104
18001,IN,Adams,,2013,6,14969,15919,950
18001,IN,Adams,,2014,4.6,15673,16424,751
18001,IN,Adams,,2015,3.8,16257,16898,641
18001,IN,Adams,,2016,3.5,16454,17057,603
18001,IN,Adams,,2017,2.6,16812,17260,448
18001,IN,Adams,,2018,2.6,17062,17515,453
18001,IN,Adams,,2019,2.7,16929,17396,467
18001,IN,Adams,,2020,5.6,15831,16776,945
18001,IN,Adams,,2021,2.2,16326,16691,365
18003,IN,Allen,,2007,4.8,171736,180425,8689
18003,IN,Allen,,2008,6,171141,182016,10875
18003,IN,Allen,,2009,10.6,160367,179446,19079
18003,IN,Allen,,2010,10.5,157623,176022,18399
18003,IN,Allen,,2011,9.1,160474,176618,16144
18003,IN,Allen,,2012,8.3,159595,173981,14386
18003,IN,Allen,,2013,7.4,161561,174458,12897
18003,IN,Allen,,2014,5.7,165714,175752,10038
18003,IN,Allen,,2015,4.6,169861,178004,8143
18003,IN,Allen,,2016,4.2,173422,181043,7621
18003,IN,Allen,,2017,3.3,175203,181184,5981
18003,IN,Allen,,2018,3.1,179078,184869,5791
18003,IN,Allen,,2019,3.1,181889,187735,5846
18003,IN,Allen,,2020,7.8,170981,185442,14461
18003,IN,Allen,,2021,3.7,177326,184097,6771
18005,IN,Bartholomew,,2007,3.6,37077,38478,1401
18005,IN,Bartholomew,,2008,4.6,37870,39713,1843
18005,IN,Bartholomew,,2009,9.7,34947,38710,3763
18005,IN,Bartholomew,,2010,9.3,34840,38406,3566
18005,IN,Bartholomew,,2011,7.4,37140,40123,2983
18005,IN,Bartholomew,,2012,6.3,38847,41457,2610
18005,IN,Bartholomew,,2013,5.9,39227,41670,2443
18005,IN,Bartholomew,,2014,4.4,40766,42629,1863
18005,IN,Bartholomew,,2015,3.6,42013,43579,1566
18005,IN,Bartholomew,,2016,3.3,43010,44497,1487
18005,IN,Bartholomew,,2017,2.7,43301,44507,1206
18005,IN,Bartholomew,,2018,2.6,44002,45181,1179
18005,IN,Bartholomew,,2019,2.5,44108,45228,1120
18005,IN,Bartholomew,,2020,6.6,40792,43673,2881
18005,IN,Bartholomew,,2021,2.9,41594,42821,1227
18007,IN,Benton,,2007,4.4,4137,4329,192
18007,IN,Benton,,2008,5.2,4190,4422,232
18007,IN,Benton,,2009,10.1,3877,4313,436
18007,IN,Benton,,2010,9,4246,4664,418
18007,IN,Benton,,2011,7.7,4295,4654,359
18007,IN,Benton,,2012,7.3,4220,4554,334
18007,IN,Benton,,2013,6.9,4160,4469,309
18007,IN,Benton,,2014,5.4,4233,4475,242
18007,IN,Benton,,2015,4.5,4374,4578,204
18007,IN,Benton,,2016,4.2,4379,4570,191
18007,IN,Benton,,2017,3.4,4344,4496,152
18007,IN,Benton,,2018,3.2,4421,4567,146
18007,IN,Benton,,2019,3.2,4396,4539,143
18007,IN,Benton,,2020,5.4,3938,4162,224
18007,IN,Benton,,2021,2.7,4085,4199,114
18009,IN,Blackford,,2007,5.8,6159,6540,381
18009,IN,Blackford,,2008,7.6,6012,6509,497
18009,IN,Blackford,,2009,14.3,5541,6462,921
18009,IN,Blackford,,2010,14,5023,5841,818
18009,IN,Blackford,,2011,12,4954,5632,678
18009,IN,Blackford,,2012,11.3,4847,5463,616
18009,IN,Blackford,,2013,9.7,4918,5447,529
18009,IN,Blackford,,2014,7.4,4877,5266,389
18009,IN,Blackford,,2015,6,4927,5241,314
18009,IN,Blackford,,2016,5.3,5059,5341,282
18009,IN,Blackford,,2017,4,5127,5340,213
18009,IN,Blackford,,2018,3.8,5124,5327,203
18009,IN,Blackford,,2019,3.8,4820,5013,193
18009,IN,Blackford,,2020,8.1,4440,4829,389
18009,IN,Blackford,,2021,3.7,4512,4685,173
18011,IN,Boone,,2007,3.5,26938,27912,974
18011,IN,Boone,,2008,4.3,27303,28542,1239
18011,IN,Boone,,2009,7.9,26230,28469,2239
18011,IN,Boone,,2010,7.4,27251,29421,2170
18011,IN,Boone,,2011,6.6,27932,29896,1964
18011,IN,Boone,,2012,6,28450,30262,1812
18011,IN,Boone,,2013,5.6,29402,31144,1742
18011,IN,Boone,,2014,4.4,30795,32204,1409
18011,IN,Boone,,2015,3.7,32264,33492,1228
18011,IN,Boone,,2016,3.3,33733,34896,1163
18011,IN,Boone,,2017,2.8,34398,35395,997
18011,IN,Boone,,2018,2.7,35270,36241,971
18011,IN,Boone,,2019,2.4,35861,36757,896
18011,IN,Boone,,2020,4.3,34547,36106,1559
18011,IN,Boone,,2021,2.1,36190,36964,774
18013,IN,Brown,,2007,4.4,7265,7602,337
18013,IN,Brown,,2008,5.7,7185,7618,433
18013,IN,Brown,,2009,10.1,6747,7504,757
18013,IN,Brown,,2010,10.1,6803,7568,765
18013,IN,Brown,,2011,9,6775,7446,671
18013,IN,Brown,,2012,7.9,6751,7329,578
18013,IN,Brown,,2013,7.3,6795,7329,534
18013,IN,Brown,,2014,6,6922,7361,439
18013,IN,Brown,,2015,4.8,7088,7442,354
18013,IN,Brown,,2016,4,7232,7531,299
18013,IN,Brown,,2017,3.4,7301,7556,255
18013,IN,Brown,,2018,3.1,7460,7701,241
18013,IN,Brown,,2019,3,7418,7646,228
18013,IN,Brown,,2020,6.8,7018,7532,514
18013,IN,Brown,,2021,3.2,7389,7637,248
18015,IN,Carroll,,2007,4.1,9503,9910,407
18015,IN,Carroll,,2008,5.9,9610,10210,600
18015,IN,Carroll,,2009,10.8,9001,10087,1086
18015,IN,Carroll,,2010,9.6,9269,10258,989
18015,IN,Carroll,,2011,8.1,9322,10149,827
18015,IN,Carroll,,2012,7.2,9271,9995,724
18015,IN,Carroll,,2013,6.9,9238,9923,685
18015,IN,Carroll,,2014,5.2,9371,9887,516
18015,IN,Carroll,,2015,4.3,9589,10021,432
18015,IN,Carroll,,2016,4.2,9695,10118,423
18015,IN,Carroll,,2017,3.4,9730,10072,342
18015,IN,Carroll,,2018,3.2,9906,10238,332
18015,IN,Carroll,,2019,3,9826,10131,305
18015,IN,Carroll,,2020,6.3,8816,9408,592
18015,IN,Carroll,,2021,2.9,9219,9497,278
18017,IN,Cass,,2007,5,17720,18643,923
18017,IN,Cass,,2008,6.3,17691,18878,1187
18017,IN,Cass,,2009,12.2,16564,18865,2301
18017,IN,Cass,,2010,10.6,16865,18855,1990
18017,IN,Cass,,2011,9.2,16538,18219,1681
18017,IN,Cass,,2012,8.5,16285,17792,1507
18017,IN,Cass,,2013,7.5,16361,17695,1334
18017,IN,Cass,,2014,5.7,16722,17740,1018
18017,IN,Cass,,2015,4.6,16947,17758,811
18017,IN,Cass,,2016,4.6,17238,18065,827
18017,IN,Cass,,2017,3.8,17213,17889,676
18017,IN,Cass,,2018,3.6,17611,18276,665
18017,IN,Cass,,2019,3.4,17470,18089,619
18017,IN,Cass,,2020,6.9,16420,17636,1216
18017,IN,Cass,,2021,3.6,16594,17216,622
18019,IN,Clark,,2007,4.4,52636,55051,2415
18019,IN,Clark,,2008,5.3,53281,56284,3003
18019,IN,Clark,,2009,8.8,51409,56399,4990
18019,IN,Clark,,2010,9.3,50206,55330,5124
18019,IN,Clark,,2011,8.7,50825,55676,4851
18019,IN,Clark,,2012,7.7,51182,55457,4275
18019,IN,Clark,,2013,6.8,52510,56329,3819
18019,IN,Clark,,2014,5.4,54537,57640,3103
18019,IN,Clark,,2015,4.5,56146,58777,2631
18019,IN,Clark,,2016,4.1,58105,60593,2488
18019,IN,Clark,,2017,3.5,58780,60883,2103
18019,IN,Clark,,2018,3.4,59852,61947,2095
18019,IN,Clark,,2019,3.3,60480,62520,2040
18019,IN,Clark,,2020,7.3,57175,61662,4487
18019,IN,Clark,,2021,3.2,59580,61556,1976
18021,IN,Clay,,2007,5.9,12106,12859,753
18021,IN,Clay,,2008,7.1,12006,12923,917
18021,IN,Clay,,2009,11.4,11602,13099,1497
18021,IN,Clay,,2010,10.9,11750,13182,1432
18021,IN,Clay,,2011,10.2,11696,13023,1327
18021,IN,Clay,,2012,9.7,11570,12815,1245
18021,IN,Clay,,2013,8.8,11495,12598,1103
18021,IN,Clay,,2014,6.7,11604,12440,836
18021,IN,Clay,,2015,5.3,11715,12365,650
18021,IN,Clay,,2016,4.6,11826,12399,573
18021,IN,Clay,,2017,3.7,11831,12284,453
18021,IN,Clay,,2018,3.9,11862,12338,476
18021,IN,Clay,,2019,3.6,11394,11822,428
18021,IN,Clay,,2020,6.6,10826,11593,767
18021,IN,Clay,,2021,3.6,11063,11473,410
18023,IN,Clinton,,2007,4.6,15979,16742,763
18023,IN,Clinton,,2008,5.5,16018,16947,929
18023,IN,Clinton,,2009,10.9,15203,17069,1866
18023,IN,Clinton,,2010,9.9,15234,16905,1671
18023,IN,Clinton,,2011,8.4,15370,16788,1418
18023,IN,Clinton,,2012,7.9,15273,16584,1311
18023,IN,Clinton,,2013,7,15304,16449,1145
18023,IN,Clinton,,2014,5.1,15812,16663,851
18023,IN,Clinton,,2015,4,16241,16917,676
18023,IN,Clinton,,2016,3.8,16512,17170,658
18023,IN,Clinton,,2017,3,16460,16976,516
18023,IN,Clinton,,2018,2.8,16723,17204,481
18023,IN,Clinton,,2019,2.7,16818,17276,458
18023,IN,Clinton,,2020,5.7,15785,16738,953
18023,IN,Clinton,,2021,2.8,16261,16723,462
18025,IN,Crawford,,2007,6.1,4910,5231,321
18025,IN,Crawford,,2008,7.5,5002,5410,408
18025,IN,Crawford,,2009,12.4,4600,5254,654
18025,IN,Crawford,,2010,12.6,4297,4917,620
18025,IN,Crawford,,2011,11.6,4308,4875,567
18025,IN,Crawford,,2012,10.5,4291,4793,502
18025,IN,Crawford,,2013,9.8,4370,4846,476
18025,IN,Crawford,,2014,7.6,4521,4895,374
18025,IN,Crawford,,2015,6,4619,4914,295
18025,IN,Crawford,,2016,5.6,4725,5003,278
18025,IN,Crawford,,2017,4.4,4728,4946,218
18025,IN,Crawford,,2018,4.4,4735,4954,219
18025,IN,Crawford,,2019,4.1,4690,4888,198
18025,IN,Crawford,,2020,7.3,4515,4869,354
18025,IN,Crawford,,2021,3.7,4613,4788,175
18027,IN,Daviess,,2007,3.1,14629,15096,467
18027,IN,Daviess,,2008,3.8,14676,15261,585
18027,IN,Daviess,,2009,6,14130,15026,896
18027,IN,Daviess,,2010,6.3,13835,14768,933
18027,IN,Daviess,,2011,6,14039,14930,891
18027,IN,Daviess,,2012,5.9,13930,14807,877
18027,IN,Daviess,,2013,5.5,14072,14898,826
18027,IN,Daviess,,2014,4.5,14507,15184,677
18027,IN,Daviess,,2015,3.8,15104,15695,591
18027,IN,Daviess,,2016,3.5,15432,15990,558
18027,IN,Daviess,,2017,2.8,15501,15943,442
18027,IN,Daviess,,2018,2.7,16088,16531,443
18027,IN,Daviess,,2019,2.6,16385,16818,433
18027,IN,Daviess,,2020,3.9,15909,16549,640
18027,IN,Daviess,,2021,2.3,16030,16405,375
18029,IN,Dearborn,,2007,5.1,24725,26052,1327
18029,IN,Dearborn,,2008,5.9,24803,26348,1545
18029,IN,Dearborn,,2009,10,23657,26275,2618
18029,IN,Dearborn,,2010,10.6,22826,25530,2704
18029,IN,Dearborn,,2011,9.5,22997,25399,2402
18029,IN,Dearborn,,2012,8.8,22805,24998,2193
18029,IN,Dearborn,,2013,8.3,23117,25212,2095
18029,IN,Dearborn,,2014,6.6,23479,25126,1647
18029,IN,Dearborn,,2015,5.1,23925,25210,1285
18029,IN,Dearborn,,2016,4.6,24431,25622,1191
18029,IN,Dearborn,,2017,3.8,24769,25754,985
18029,IN,Dearborn,,2018,3.6,24967,25901,934
18029,IN,Dearborn,,2019,3.5,25055,25962,907
18029,IN,Dearborn,,2020,7,23576,25346,1770
18029,IN,Dearborn,,2021,3,24500,25257,757
18031,IN,Decatur,,2007,4.6,11726,12290,564
18031,IN,Decatur,,2008,6.3,11932,12730,798
18031,IN,Decatur,,2009,12.6,11119,12720,1601
18031,IN,Decatur,,2010,11.3,11452,12917,1465
18031,IN,Decatur,,2011,9.6,11791,13041,1250
18031,IN,Decatur,,2012,8,12508,13593,1085
18031,IN,Decatur,,2013,6.6,12974,13885,911
18031,IN,Decatur,,2014,4.9,13494,14189,695
18031,IN,Decatur,,2015,4,13713,14291,578
18031,IN,Decatur,,2016,3.5,14059,14571,512
18031,IN,Decatur,,2017,2.9,14273,14699,426
18031,IN,Decatur,,2018,3,14522,14964,442
18031,IN,Decatur,,2019,2.8,15089,15517,428
18031,IN,Decatur,,2020,7.6,13821,14956,1135
18031,IN,Decatur,,2021,2.8,14368,14786,418
18033,IN,DeKalb,,2007,5.5,19522,20666,1144
18033,IN,DeKalb,,2008,7.3,19193,20699,1506
18033,IN,DeKalb,,2009,13.9,17665,20508,2843
18033,IN,DeKalb,,2010,11.6,18197,20591,2394
18033,IN,DeKalb,,2011,9.5,18581,20531,1950
18033,IN,DeKalb,,2012,8.2,18894,20589,1695
18033,IN,DeKalb,,2013,7,19505,20979,1474
18033,IN,DeKalb,,2014,5.2,20164,21268,1104
18033,IN,DeKalb,,2015,4.1,20891,21781,890
18033,IN,DeKalb,,2016,3.9,21397,22257,860
18033,IN,DeKalb,,2017,2.9,21621,22266,645
18033,IN,DeKalb,,2018,2.8,21896,22528,632
18033,IN,DeKalb,,2019,2.8,22111,22746,635
18033,IN,DeKalb,,2020,6.9,20670,22211,1541
18033,IN,DeKalb,,2021,2.7,21434,22028,594
18035,IN,Delaware,,2007,5.3,52112,55056,2944
18035,IN,Delaware,,2008,6.7,51955,55689,3734
18035,IN,Delaware,,2009,10.8,49694,55728,6034
18035,IN,Delaware,,2010,11.2,48559,54704,6145
18035,IN,Delaware,,2011,9.9,49312,54745,5433
18035,IN,Delaware,,2012,9.2,49864,54933,5069
18035,IN,Delaware,,2013,8.5,49652,54238,4586
18035,IN,Delaware,,2014,7,49868,53602,3734
18035,IN,Delaware,,2015,5.7,51349,54427,3078
18035,IN,Delaware,,2016,5.1,52342,55129,2787
18035,IN,Delaware,,2017,4.2,52060,54357,2297
18035,IN,Delaware,,2018,4,52048,54201,2153
18035,IN,Delaware,,2019,3.8,51643,53692,2049
18035,IN,Delaware,,2020,7.4,48593,52470,3877
18035,IN,Delaware,,2021,3.9,49842,51868,2026
18037,IN,Dubois,,2007,3.1,21424,22110,686
18037,IN,Dubois,,2008,3.9,21518,22380,862
18037,IN,Dubois,,2009,7.6,20518,22200,1682
18037,IN,Dubois,,2010,7.3,20351,21951,1600
18037,IN,Dubois,,2011,5.9,20695,22002,1307
18037,IN,Dubois,,2012,5.6,20396,21611,1215
18037,IN,Dubois,,2013,5.2,20545,21676,1131
18037,IN,Dubois,,2014,4.1,21157,22052,895
18037,IN,Dubois,,2015,3.4,21910,22673,763
18037,IN,Dubois,,2016,3.1,22702,23421,719
18037,IN,Dubois,,2017,2.6,22607,23201,594
18037,IN,Dubois,,2018,2.4,22791,23363,572
18037,IN,Dubois,,2019,2.4,22705,23253,548
18037,IN,Dubois,,2020,4.6,21563,22595,1032
18037,IN,Dubois,,2021,2.4,21490,22020,530
18039,IN,Elkhart,,2007,4.6,96453,101144,4691
18039,IN,Elkhart,,2008,8.6,89778,98188,8410
18039,IN,Elkhart,,2009,18.1,74872,91469,16597
18039,IN,Elkhart,,2010,13,82165,94442,12277
18039,IN,Elkhart,,2011,10.5,85490,95546,10056
18039,IN,Elkhart,,2012,8.8,88387,96921,8534
18039,IN,Elkhart,,2013,7.1,92097,99135,7038
18039,IN,Elkhart,,2014,5.1,97040,102208,5168
18039,IN,Elkhart,,2015,3.9,100665,104706,4041
18039,IN,Elkhart,,2016,3.4,104854,108584,3730
18039,IN,Elkhart,,2017,2.5,109531,112355,2824
18039,IN,Elkhart,,2018,2.6,113186,116165,2979
18039,IN,Elkhart,,2019,3,109538,112981,3443
18039,IN,Elkhart,,2020,7.6,102105,110525,8420
18039,IN,Elkhart,,2021,2.5,113007,115907,2900
18041,IN,Fayette,,2007,7.3,9655,10417,762
18041,IN,Fayette,,2008,11.4,8967,10119,1152
18041,IN,Fayette,,2009,15.4,8404,9931,1527
18041,IN,Fayette,,2010,14.3,8369,9761,1392
18041,IN,Fayette,,2011,12.3,8353,9526,1173
18041,IN,Fayette,,2012,11,8162,9170,1008
18041,IN,Fayette,,2013,10.1,8117,9033,916
18041,IN,Fayette,,2014,7.8,8386,9093,707
18041,IN,Fayette,,2015,6.5,8400,8987,587
18041,IN,Fayette,,2016,5.7,8827,9358,531
18041,IN,Fayette,,2017,5,8624,9076,452
18041,IN,Fayette,,2018,4.6,8745,9165,420
18041,IN,Fayette,,2019,4.7,8388,8798,410
18041,IN,Fayette,,2020,9.8,7753,8600,847
18041,IN,Fayette,,2021,4.4,8023,8393,370
18043,IN,Floyd,,2007,4.2,36298,37887,1589
18043,IN,Floyd,,2008,5.1,36533,38498,1965
18043,IN,Floyd,,2009,8.7,34915,38232,3317
18043,IN,Floyd,,2010,8.6,34617,37875,3258
18043,IN,Floyd,,2011,7.8,34902,37854,2952
18043,IN,Floyd,,2012,7,35171,37820,2649
18043,IN,Floyd,,2013,6.2,36176,38575,2399
18043,IN,Floyd,,2014,5.1,37113,39092,1979
18043,IN,Floyd,,2015,4.3,38157,39855,1698
18043,IN,Floyd,,2016,4,39369,41025,1656
18043,IN,Floyd,,2017,3.3,39537,40885,1348
18043,IN,Floyd,,2018,3.3,40494,41855,1361
18043,IN,Floyd,,2019,3.1,40974,42282,1308
18043,IN,Floyd,,2020,6.6,38615,41324,2709
18043,IN,Floyd,,2021,2.8,40221,41370,1149
18045,IN,Fountain,,2007,4.2,8272,8638,366
18045,IN,Fountain,,2008,5.3,8223,8686,463
18045,IN,Fountain,,2009,12.9,7380,8469,1089
18045,IN,Fountain,,2010,11.5,7612,8601,989
18045,IN,Fountain,,2011,9.4,7830,8642,812
18045,IN,Fountain,,2012,8.3,7832,8538,706
18045,IN,Fountain,,2013,9.6,7521,8322,801
18045,IN,Fountain,,2014,7,7623,8194,571
18045,IN,Fountain,,2015,5.9,7565,8039,474
18045,IN,Fountain,,2016,5.7,7520,7977,457
18045,IN,Fountain,,2017,4,7597,7910,313
18045,IN,Fountain,,2018,3.6,7815,8105,290
18045,IN,Fountain,,2019,3.5,7776,8054,278
18045,IN,Fountain,,2020,6.6,7219,7732,513
18045,IN,Fountain,,2021,2.9,7409,7628,219
18047,IN,Franklin,,2007,5.6,11111,11767,656
18047,IN,Franklin,,2008,6.6,11147,11935,788
18047,IN,Franklin,,2009,10.7,10436,11681,1245
18047,IN,Franklin,,2010,11.1,10121,11391,1270
18047,IN,Franklin,,2011,9.8,10137,11241,1104
18047,IN,Franklin,,2012,9.4,9574,10564,990
18047,IN,Franklin,,2013,8.5,9867,10783,916
18047,IN,Franklin,,2014,6.5,10179,10887,708
18047,IN,Franklin,,2015,5,10812,11386,574
18047,IN,Franklin,,2016,4.3,10998,11490,492
18047,IN,Franklin,,2017,3.6,10816,11217,401
18047,IN,Franklin,,2018,3.7,10995,11413,418
18047,IN,Franklin,,2019,3.4,11128,11517,389
18047,IN,Franklin,,2020,6,10644,11319,675
18047,IN,Franklin,,2021,2.7,10893,11196,303
18049,IN,Fulton,,2007,4.9,9842,10347,505
18049,IN,Fulton,,2008,6.6,9640,10318,678
18049,IN,Fulton,,2009,12.9,8773,10075,1302
18049,IN,Fulton,,2010,11.1,9139,10284,1145
18049,IN,Fulton,,2011,9,9298,10223,925
18049,IN,Fulton,,2012,8.2,9258,10090,832
18049,IN,Fulton,,2013,8.1,9096,9898,802
18049,IN,Fulton,,2014,6.2,9184,9796,612
18049,IN,Fulton,,2015,4.7,9391,9859,468
18049,IN,Fulton,,2016,4.6,9439,9896,457
18049,IN,Fulton,,2017,3.5,9428,9765,337
18049,IN,Fulton,,2018,3.3,9679,10011,332
18049,IN,Fulton,,2019,3.1,9615,9924,309
18049,IN,Fulton,,2020,6.6,9034,9676,642
18049,IN,Fulton,,2021,3.3,9133,9445,312
18051,IN,Gibson,,2007,4.6,15960,16732,772
18051,IN,Gibson,,2008,5.2,16018,16895,877
18051,IN,Gibson,,2009,8.9,15356,16857,1501
18051,IN,Gibson,,2010,7.8,15593,16911,1318
18051,IN,Gibson,,2011,7.2,16084,17326,1242
18051,IN,Gibson,,2012,6.7,16240,17415,1175
18051,IN,Gibson,,2013,5.7,17013,18050,1037
18051,IN,Gibson,,2014,4.5,17615,18440,825
18051,IN,Gibson,,2015,3.8,18147,18859,712
18051,IN,Gibson,,2016,3.6,18532,19219,687
18051,IN,Gibson,,2017,2.9,18553,19111,558
18051,IN,Gibson,,2018,2.6,18943,19455,512
18051,IN,Gibson,,2019,2.5,19140,19629,489
18051,IN,Gibson,,2020,6.3,18352,19577,1225
18051,IN,Gibson,,2021,2.5,18653,19133,480
18053,IN,Grant,,2007,6.2,29668,31635,1967
18053,IN,Grant,,2008,7.6,30040,32514,2474
18053,IN,Grant,,2009,11.9,29335,33306,3971
18053,IN,Grant,,2010,11.3,29763,33556,3793
18053,IN,Grant,,2011,10.2,30096,33504,3408
18053,IN,Grant,,2012,9.6,29253,32357,3104
18053,IN,Grant,,2013,8.9,29625,32508,2883
18053,IN,Grant,,2014,6.8,30437,32671,2234
18053,IN,Grant,,2015,5.4,30766,32517,1751
18053,IN,Grant,,2016,4.9,30606,32170,1564
18053,IN,Grant,,2017,3.8,30623,31847,1224
18053,IN,Grant,,2018,3.8,30982,32202,1220
18053,IN,Grant,,2019,3.6,30769,31933,1164
18053,IN,Grant,,2020,6.4,29582,31602,2020
18053,IN,Grant,,2021,3.7,29939,31094,1155
18055,IN,Greene,,2007,5.2,14968,15786,818
18055,IN,Greene,,2008,6.2,15083,16076,993
18055,IN,Greene,,2009,8.6,14704,16096,1392
18055,IN,Greene,,2010,10.4,12898,14395,1497
18055,IN,Greene,,2011,10.2,12764,14212,1448
18055,IN,Greene,,2012,10.3,12394,13819,1425
18055,IN,Greene,,2013,10,12391,13774,1383
18055,IN,Greene,,2014,7.9,12760,13858,1098
18055,IN,Greene,,2015,6.8,12811,13750,939
18055,IN,Greene,,2016,6.5,12864,13751,887
18055,IN,Greene,,2017,4.7,12966,13605,639
18055,IN,Greene,,2018,4.4,13152,13752,600
18055,IN,Greene,,2019,4.1,13140,13700,560
18055,IN,Greene,,2020,6.3,12435,13267,832
18055,IN,Greene,,2021,3.4,12967,13423,456
18057,IN,Hamilton,,2007,3,136329,140492,4163
18057,IN,Hamilton,,2008,3.8,140159,145713,5554
18057,IN,Hamilton,,2009,6.7,136275,146050,9775
18057,IN,Hamilton,,2010,6.5,135598,145059,9461
18057,IN,Hamilton,,2011,5.7,140111,148561,8450
18057,IN,Hamilton,,2012,5.2,143404,151320,7916
18057,IN,Hamilton,,2013,4.9,148370,156093,7723
18057,IN,Hamilton,,2014,4.1,154656,161190,6534
18057,IN,Hamilton,,2015,3.4,161612,167231,5619
18057,IN,Hamilton,,2016,3.2,169167,174686,5519
18057,IN,Hamilton,,2017,2.7,173483,178341,4858
18057,IN,Hamilton,,2018,2.7,178344,183248,4904
18057,IN,Hamilton,,2019,2.5,183590,188283,4693
18057,IN,Hamilton,,2020,4.7,176246,184949,8703
18057,IN,Hamilton,,2021,2.2,184603,188744,4141
18059,IN,Hancock,,2007,3.8,34397,35758,1361
18059,IN,Hancock,,2008,4.8,34804,36565,1761
18059,IN,Hancock,,2009,8.7,33199,36346,3147
18059,IN,Hancock,,2010,9,32597,35819,3222
18059,IN,Hancock,,2011,8,32988,35871,2883
18059,IN,Hancock,,2012,7.2,33179,35763,2584
18059,IN,Hancock,,2013,6.5,33780,36133,2353
18059,IN,Hancock,,2014,5.2,34737,36626,1889
18059,IN,Hancock,,2015,4.2,35800,37367,1567
18059,IN,Hancock,,2016,3.7,37281,38727,1446
18059,IN,Hancock,,2017,3,37972,39143,1171
18059,IN,Hancock,,2018,3,38982,40186,1204
18059,IN,Hancock,,2019,2.8,40094,41243,1149
18059,IN,Hancock,,2020,5.7,38451,40767,2316
18059,IN,Hancock,,2021,2.6,40259,41318,1059
18061,IN,Harrison,,2007,4.5,18498,19378,880
18061,IN,Harrison,,2008,5.9,18567,19731,1164
18061,IN,Harrison,,2009,9.3,17825,19662,1837
18061,IN,Harrison,,2010,9.6,17174,18998,1824
18061,IN,Harrison,,2011,8.8,17169,18818,1649
18061,IN,Harrison,,2012,7.6,17161,18575,1414
18061,IN,Harrison,,2013,6.9,17454,18738,1284
18061,IN,Harrison,,2014,5.6,17988,19049,1061
18061,IN,Harrison,,2015,4.6,18496,19379,883
18061,IN,Harrison,,2016,4.1,19148,19976,828
18061,IN,Harrison,,2017,3.4,19237,19922,685
18061,IN,Harrison,,2018,3.4,19741,20434,693
18061,IN,Harrison,,2019,3.2,19861,20510,649
18061,IN,Harrison,,2020,6.3,18699,19966,1267
18061,IN,Harrison,,2021,2.7,19485,20019,534
18063,IN,Hendricks,,2007,3.3,69899,72292,2393
18063,IN,Hendricks,,2008,4.3,71090,74291,3201
18063,IN,Hendricks,,2009,7.7,68405,74142,5737
18063,IN,Hendricks,,2010,7.6,69076,74792,5716
18063,IN,Hendricks,,2011,6.8,71016,76220,5204
18063,IN,Hendricks,,2012,6.2,72185,76982,4797
18063,IN,Hendricks,,2013,5.7,74332,78810,4478
18063,IN,Hendricks,,2014,4.6,77028,80729,3701
18063,IN,Hendricks,,2015,3.8,79705,82856,3151
18063,IN,Hendricks,,2016,3.4,82920,85878,2958
18063,IN,Hendricks,,2017,2.9,84702,87205,2503
18063,IN,Hendricks,,2018,2.9,87137,89701,2564
18063,IN,Hendricks,,2019,2.7,89345,91794,2449
18063,IN,Hendricks,,2020,5.1,85655,90251,4596
18063,IN,Hendricks,,2021,2.5,89665,91963,2298
18065,IN,Henry,,2007,5.8,21119,22431,1312
18065,IN,Henry,,2008,7,21215,22812,1597
18065,IN,Henry,,2009,12.8,20004,22953,2949
18065,IN,Henry,,2010,13.5,18486,21375,2889
18065,IN,Henry,,2011,11.3,18919,21323,2404
18065,IN,Henry,,2012,9.9,19059,21156,2097
18065,IN,Henry,,2013,8.7,19489,21341,1852
18065,IN,Henry,,2014,6.8,20015,21471,1456
18065,IN,Henry,,2015,5.3,20516,21659,1143
18065,IN,Henry,,2016,4.6,21128,22136,1008
18065,IN,Henry,,2017,3.6,21373,22177,804
18065,IN,Henry,,2018,3.5,21667,22445,778
18065,IN,Henry,,2019,3.2,21534,22252,718
18065,IN,Henry,,2020,6.6,20431,21883,1452
18065,IN,Henry,,2021,3.2,20971,21673,702
18067,IN,Howard,,2007,5.6,35447,37531,2084
18067,IN,Howard,,2008,7.8,34354,37261,2907
18067,IN,Howard,,2009,15,30512,35899,5387
18067,IN,Howard,,2010,12.3,31402,35792,4390
18067,IN,Howard,,2011,10.2,32428,36120,3692
18067,IN,Howard,,2012,8.9,32729,35941,3212
18067,IN,Howard,,2013,8,33555,36467,2912
18067,IN,Howard,,2014,6.3,34640,36950,2310
18067,IN,Howard,,2015,5,35148,36982,1834
18067,IN,Howard,,2016,4.6,36365,38114,1749
18067,IN,Howard,,2017,3.8,36537,37973,1436
18067,IN,Howard,,2018,4,35952,37468,1516
18067,IN,Howard,,2019,4,35132,36596,1464
18067,IN,Howard,,2020,11,33065,37140,4075
18067,IN,Howard,,2021,6.2,32591,34727,2136
18069,IN,Huntington,,2007,4.8,19035,19993,958
18069,IN,Huntington,,2008,6.7,18903,20258,1355
18069,IN,Huntington,,2009,13,17294,19878,2584
18069,IN,Huntington,,2010,11.6,16828,19035,2207
18069,IN,Huntington,,2011,9.6,17344,19190,1846
18069,IN,Huntington,,2012,8.7,16987,18601,1614
18069,IN,Huntington,,2013,7.6,17146,18551,1405
18069,IN,Huntington,,2014,5.8,17486,18559,1073
18069,IN,Huntington,,2015,4.4,17828,18639,811
18069,IN,Huntington,,2016,4,17958,18707,749
18069,IN,Huntington,,2017,3.5,17752,18403,651
18069,IN,Huntington,,2018,3.5,17757,18401,644
18069,IN,Huntington,,2019,3.2,17759,18352,593
18069,IN,Huntington,,2020,6.7,16857,18060,1203
18069,IN,Huntington,,2021,3,17472,18004,532
18071,IN,Jackson,,2007,4,20991,21855,864
18071,IN,Jackson,,2008,5.3,20708,21874,1166
18071,IN,Jackson,,2009,11.3,18986,21405,2419
18071,IN,Jackson,,2010,10.3,18383,20484,2101
18071,IN,Jackson,,2011,8.6,18833,20601,1768
18071,IN,Jackson,,2012,7.4,18998,20506,1508
18071,IN,Jackson,,2013,6.4,19556,20887,1331
18071,IN,Jackson,,2014,5,20268,21329,1061
18071,IN,Jackson,,2015,4,20922,21784,862
18071,IN,Jackson,,2016,3.6,21563,22370,807
18071,IN,Jackson,,2017,3,21787,22451,664
18071,IN,Jackson,,2018,2.8,22206,22850,644
18071,IN,Jackson,,2019,2.6,22418,23020,602
18071,IN,Jackson,,2020,7.2,21431,23103,1672
18071,IN,Jackson,,2021,3,22522,23214,692
18073,IN,Jasper,,2007,4.8,14744,15487,743
18073,IN,Jasper,,2008,5.8,14889,15813,924
18073,IN,Jasper,,2009,10.3,14164,15796,1632
18073,IN,Jasper,,2010,10.2,14503,16144,1641
18073,IN,Jasper,,2011,8.9,14698,16131,1433
18073,IN,Jasper,,2012,8,14706,15985,1279
18073,IN,Jasper,,2013,7.6,14752,15965,1213
18073,IN,Jasper,,2014,6.7,15075,16149,1074
18073,IN,Jasper,,2015,5.8,15411,16357,946
18073,IN,Jasper,,2016,5.3,15714,16585,871
18073,IN,Jasper,,2017,4.3,15695,16395,700
18073,IN,Jasper,,2018,3.9,15849,16488,639
18073,IN,Jasper,,2019,3.7,15683,16281,598
18073,IN,Jasper,,2020,7.1,14428,15535,1107
18073,IN,Jasper,,2021,3.5,14814,15355,541
18075,IN,Jay,,2007,4.4,11081,11589,508
18075,IN,Jay,,2008,5.8,11113,11797,684
18075,IN,Jay,,2009,11.4,10138,11448,1310
18075,IN,Jay,,2010,10.4,9525,10627,1102
18075,IN,Jay,,2011,8.8,9624,10555,931
18075,IN,Jay,,2012,7.8,9306,10094,788
18075,IN,Jay,,2013,7.6,9300,10063,763
18075,IN,Jay,,2014,5.8,9521,10106,585
18075,IN,Jay,,2015,5,9451,9945,494
18075,IN,Jay,,2016,4.5,9510,9955,445
18075,IN,Jay,,2017,3.5,9445,9787,342
18075,IN,Jay,,2018,3.3,9470,9790,320
18075,IN,Jay,,2019,3,9176,9456,280
18075,IN,Jay,,2020,6.6,8231,8815,584
18075,IN,Jay,,2021,2.7,8512,8746,234
18077,IN,Jefferson,,2007,5,16209,17055,846
18077,IN,Jefferson,,2008,6.1,15787,16811,1024
18077,IN,Jefferson,,2009,11,14850,16691,1841
18077,IN,Jefferson,,2010,11.1,13753,15467,1714
18077,IN,Jefferson,,2011,9.6,13746,15210,1464
18077,IN,Jefferson,,2012,8.4,13960,15237,1277
18077,IN,Jefferson,,2013,7.8,14146,15335,1189
18077,IN,Jefferson,,2014,6.1,14156,15069,913
18077,IN,Jefferson,,2015,4.8,14586,15324,738
18077,IN,Jefferson,,2016,4.6,14597,15300,703
18077,IN,Jefferson,,2017,3.7,14521,15075,554
18077,IN,Jefferson,,2018,3.4,14616,15126,510
18077,IN,Jefferson,,2019,3.3,14654,15158,504
18077,IN,Jefferson,,2020,7.5,13834,14955,1121
18077,IN,Jefferson,,2021,3.1,14422,14891,469
18079,IN,Jennings,,2007,5.2,12937,13644,707
18079,IN,Jennings,,2008,7.2,12856,13848,992
18079,IN,Jennings,,2009,13.8,11835,13730,1895
18079,IN,Jennings,,2010,12.6,11619,13298,1679
18079,IN,Jennings,,2011,11.3,11854,13362,1508
18079,IN,Jennings,,2012,10.2,11786,13118,1332
18079,IN,Jennings,,2013,9,11872,13048,1176
18079,IN,Jennings,,2014,6.7,12221,13095,874
18079,IN,Jennings,,2015,5.1,12494,13166,672
18079,IN,Jennings,,2016,4.7,12656,13278,622
18079,IN,Jennings,,2017,3.8,12744,13243,499
18079,IN,Jennings,,2018,3.6,13127,13615,488
18079,IN,Jennings,,2019,3.2,13216,13655,439
18079,IN,Jennings,,2020,7.8,12508,13559,1051
18079,IN,Jennings,,2021,3.7,12852,13342,490
18081,IN,Johnson,,2007,3.5,70499,73082,2583
18081,IN,Johnson,,2008,4.7,71956,75486,3530
18081,IN,Johnson,,2009,8.4,68719,75019,6300
18081,IN,Johnson,,2010,8.6,65495,71626,6131
18081,IN,Johnson,,2011,7.6,66756,72215,5459
18081,IN,Johnson,,2012,6.9,67639,72616,4977
18081,IN,Johnson,,2013,6.1,69288,73806,4518
18081,IN,Johnson,,2014,5,71807,75554,3747
18081,IN,Johnson,,2015,4.1,74437,77580,3143
18081,IN,Johnson,,2016,3.6,77460,80340,2880
18081,IN,Johnson,,2017,2.9,78569,80941,2372
18081,IN,Johnson,,2018,2.9,80411,82772,2361
18081,IN,Johnson,,2019,2.7,81817,84055,2238
18081,IN,Johnson,,2020,5.7,78282,82993,4711
18081,IN,Johnson,,2021,2.6,81932,84093,2161
18083,IN,Knox,,2007,4.1,18894,19692,798
18083,IN,Knox,,2008,5,19246,20266,1020
18083,IN,Knox,,2009,7.5,18442,19944,1502
18083,IN,Knox,,2010,8,17061,18537,1476
18083,IN,Knox,,2011,7.3,17157,18508,1351
18083,IN,Knox,,2012,7,17420,18740,1320
18083,IN,Knox,,2013,6.6,17427,18663,1236
18083,IN,Knox,,2014,5.2,17870,18851,981
18083,IN,Knox,,2015,4.6,18158,19024,866
18083,IN,Knox,,2016,4.3,18261,19084,823
18083,IN,Knox,,2017,3.4,17996,18627,631
18083,IN,Knox,,2018,3.1,18285,18875,590
18083,IN,Knox,,2019,3,18019,18577,558
18083,IN,Knox,,2020,6,17175,18271,1096
18083,IN,Knox,,2021,2.8,17576,18090,514
18085,IN,Kosciusko,,2007,4.5,39188,41018,1830
18085,IN,Kosciusko,,2008,6.5,39469,42230,2761
18085,IN,Kosciusko,,2009,12.6,36465,41700,5235
18085,IN,Kosciusko,,2010,10.7,35013,39230,4217
18085,IN,Kosciusko,,2011,8.8,35643,39067,3424
18085,IN,Kosciusko,,2012,7.6,35836,38780,2944
18085,IN,Kosciusko,,2013,6.5,37230,39804,2574
18085,IN,Kosciusko,,2014,4.9,38375,40341,1966
18085,IN,Kosciusko,,2015,4,39016,40659,1643
18085,IN,Kosciusko,,2016,3.7,40008,41542,1534
18085,IN,Kosciusko,,2017,2.7,40450,41574,1124
18085,IN,Kosciusko,,2018,2.6,41681,42793,1112
18085,IN,Kosciusko,,2019,2.8,41496,42670,1174
18085,IN,Kosciusko,,2020,6.2,38796,41373,2577
18085,IN,Kosciusko,,2021,2.7,39392,40499,1107
18087,IN,LaGrange,,2007,4.9,16161,17001,840
18087,IN,LaGrange,,2008,8.6,15228,16661,1433
18087,IN,LaGrange,,2009,17.7,12906,15676,2770
18087,IN,LaGrange,,2010,11.7,14622,16567,1945
18087,IN,LaGrange,,2011,8.8,15233,16703,1470
18087,IN,LaGrange,,2012,7,15826,17019,1193
18087,IN,LaGrange,,2013,5.8,16623,17646,1023
18087,IN,LaGrange,,2014,4.4,17419,18230,811
18087,IN,LaGrange,,2015,3.6,18213,18900,687
18087,IN,LaGrange,,2016,3.4,18784,19445,661
18087,IN,LaGrange,,2017,2.5,19483,19988,505
18087,IN,LaGrange,,2018,2.5,20161,20672,511
18087,IN,LaGrange,,2019,2.8,19544,20097,553
18087,IN,LaGrange,,2020,6.5,18047,19299,1252
18087,IN,LaGrange,,2021,2,20017,20421,404
18089,IN,Lake,,2007,5.2,213961,225767,11806
18089,IN,Lake,,2008,6.2,215032,229273,14241
18089,IN,Lake,,2009,10.8,203038,227636,24598
18089,IN,Lake,,2010,10.5,205072,229122,24050
18089,IN,Lake,,2011,9.4,208263,229759,21496
18089,IN,Lake,,2012,9,208488,229040,20552
18089,IN,Lake,,2013,8.9,209792,230264,20472
18089,IN,Lake,,2014,7.9,212526,230655,18129
18089,IN,Lake,,2015,6.8,214098,229650,15552
18089,IN,Lake,,2016,6.2,217907,232420,14513
18089,IN,Lake,,2017,5.1,218433,230066,11633
18089,IN,Lake,,2018,4.9,220711,232050,11339
18089,IN,Lake,,2019,4.9,218059,229282,11223
18089,IN,Lake,,2020,10.4,202695,226215,23520
18089,IN,Lake,,2021,6.1,209298,222818,13520
18091,IN,LaPorte,,2007,5.1,49809,52496,2687
18091,IN,LaPorte,,2008,6.2,49608,52910,3302
18091,IN,LaPorte,,2009,12,46596,52969,6373
18091,IN,LaPorte,,2010,11.7,45305,51325,6020
18091,IN,LaPorte,,2011,10.2,45414,50555,5141
18091,IN,LaPorte,,2012,9.6,44948,49730,4782
18091,IN,LaPorte,,2013,9.1,44520,48999,4479
18091,IN,LaPorte,,2014,7.6,45175,48898,3723
18091,IN,LaPorte,,2015,6.2,45486,48508,3022
18091,IN,LaPorte,,2016,5.8,45863,48689,2826
18091,IN,LaPorte,,2017,4.4,45695,47805,2110
18091,IN,LaPorte,,2018,4.3,46059,48130,2071
18091,IN,LaPorte,,2019,4.2,45604,47621,2017
18091,IN,LaPorte,,2020,9.7,42770,47361,4591
18091,IN,LaPorte,,2021,5.1,43873,46208,2335
18093,IN,Lawrence,,2007,6.6,20652,22103,1451
18093,IN,Lawrence,,2008,8.3,20312,22150,1838
18093,IN,Lawrence,,2009,13.4,19001,21936,2935
18093,IN,Lawrence,,2010,12.4,18158,20719,2561
18093,IN,Lawrence,,2011,11.4,18454,20824,2370
18093,IN,Lawrence,,2012,10.8,18341,20563,2222
18093,IN,Lawrence,,2013,9.9,18630,20681,2051
18093,IN,Lawrence,,2014,8.1,18747,20390,1643
18093,IN,Lawrence,,2015,6.5,18953,20273,1320
18093,IN,Lawrence,,2016,5.6,19455,20611,1156
18093,IN,Lawrence,,2017,4.3,19911,20815,904
18093,IN,Lawrence,,2018,3.8,20350,21151,801
18093,IN,Lawrence,,2019,3.6,20437,21191,754
18093,IN,Lawrence,,2020,7.1,19223,20682,1459
18093,IN,Lawrence,,2021,3.5,20007,20729,722
18095,IN,Madison,,2007,6.4,56581,60456,3875
18095,IN,Madison,,2008,7,57383,61669,4286
18095,IN,Madison,,2009,11.1,55867,62823,6956
18095,IN,Madison,,2010,11.8,52412,59393,6981
18095,IN,Madison,,2011,10.7,52634,58924,6290
18095,IN,Madison,,2012,9.8,52315,58025,5710
18095,IN,Madison,,2013,9.2,52821,58141,5320
18095,IN,Madison,,2014,7.1,53843,57963,4120
18095,IN,Madison,,2015,5.6,54928,58211,3283
18095,IN,Madison,,2016,5,56085,59021,2936
18095,IN,Madison,,2017,3.9,56248,58558,2310
18095,IN,Madison,,2018,3.9,56770,59050,2280
18095,IN,Madison,,2019,3.7,57004,59166,2162
18095,IN,Madison,,2020,8,53754,58444,4690
18095,IN,Madison,,2021,4.1,56257,58663,2406
18097,IN,Marion,,2007,4.6,438287,459316,21029
18097,IN,Marion,,2008,5.6,438816,465015,26199
18097,IN,Marion,,2009,9.5,417053,460644,43591
18097,IN,Marion,,2010,10.3,406386,452930,46544
18097,IN,Marion,,2011,9.7,412726,456896,44170
18097,IN,Marion,,2012,9.1,416997,458702,41705
18097,IN,Marion,,2013,8.3,425318,464051,38733
18097,IN,Marion,,2014,6.5,437320,467693,30373
18097,IN,Marion,,2015,5,448465,472230,23765
18097,IN,Marion,,2016,4.4,460661,481919,21258
18097,IN,Marion,,2017,3.6,466168,483473,17305
18097,IN,Marion,,2018,3.5,472325,489271,16946
18097,IN,Marion,,2019,3.2,479869,495927,16058
18097,IN,Marion,,2020,8,453225,492797,39572
18097,IN,Marion,,2021,4.4,474976,497073,22097
18099,IN,Marshall,,2007,4.9,21647,22759,1112
18099,IN,Marshall,,2008,7.3,21573,23272,1699
18099,IN,Marshall,,2009,13.7,19601,22715,3114
18099,IN,Marshall,,2010,11,20890,23475,2585
18099,IN,Marshall,,2011,9.3,21322,23503,2181
18099,IN,Marshall,,2012,8.1,21120,22978,1858
18099,IN,Marshall,,2013,7.2,21453,23128,1675
18099,IN,Marshall,,2014,5.4,22436,23729,1293
18099,IN,Marshall,,2015,4.1,23011,24006,995
18099,IN,Marshall,,2016,3.7,23451,24351,900
18099,IN,Marshall,,2017,3,22959,23678,719
18099,IN,Marshall,,2018,3.1,22662,23394,732
18099,IN,Marshall,,2019,3.1,22662,23375,713
18099,IN,Marshall,,2020,6.5,21212,22685,1473
18099,IN,Marshall,,2021,2.7,21850,22445,595
18101,IN,Martin,,2007,3.9,4923,5125,202
18101,IN,Martin,,2008,4.9,4912,5163,251
18101,IN,Martin,,2009,7.4,4866,5254,388
18101,IN,Martin,,2010,7.4,4881,5269,388
18101,IN,Martin,,2011,7.4,4965,5361,396
18101,IN,Martin,,2012,7,4728,5085,357
18101,IN,Martin,,2013,6.2,4652,4960,308
18101,IN,Martin,,2014,5.3,4694,4958,264
18101,IN,Martin,,2015,4.2,4835,5046,211
18101,IN,Martin,,2016,4,4947,5155,208
18101,IN,Martin,,2017,3,4985,5137,152
18101,IN,Martin,,2018,2.7,5082,5224,142
18101,IN,Martin,,2019,2.6,5259,5399,140
18101,IN,Martin,,2020,4.3,5173,5407,234
18101,IN,Martin,,2021,2.5,5252,5389,137
18103,IN,Miami,,2007,5.7,15499,16441,942
18103,IN,Miami,,2008,7.9,15342,16667,1325
18103,IN,Miami,,2009,14.7,13911,16306,2395
18103,IN,Miami,,2010,12.2,14002,15942,1940
18103,IN,Miami,,2011,10.2,14334,15968,1634
18103,IN,Miami,,2012,9.6,14145,15645,1500
18103,IN,Miami,,2013,8.5,14296,15628,1332
18103,IN,Miami,,2014,6.6,14646,15677,1031
18103,IN,Miami,,2015,5.2,14934,15749,815
18103,IN,Miami,,2016,4.7,15351,16103,752
18103,IN,Miami,,2017,3.9,15246,15862,616
18103,IN,Miami,,2018,4,15221,15848,627
18103,IN,Miami,,2019,3.9,14764,15361,597
18103,IN,Miami,,2020,8.2,13928,15180,1252
18103,IN,Miami,,2021,4.4,14076,14721,645
18105,IN,Monroe,,2007,3.8,65976,68561,2585
18105,IN,Monroe,,2008,4.5,66898,70082,3184
18105,IN,Monroe,,2009,6.6,66334,70999,4665
18105,IN,Monroe,,2010,7.7,62576,67804,5228
18105,IN,Monroe,,2011,7.4,62739,67738,4999
18105,IN,Monroe,,2012,7.2,62036,66823,4787
18105,IN,Monroe,,2013,6.7,62293,66779,4486
18105,IN,Monroe,,2014,5.7,63675,67528,3853
18105,IN,Monroe,,2015,4.9,64069,67361,3292
18105,IN,Monroe,,2016,4.6,64931,68053,3122
18105,IN,Monroe,,2017,3.6,66031,68496,2465
18105,IN,Monroe,,2018,3.6,67160,69640,2480
18105,IN,Monroe,,2019,3.3,68277,70605,2328
18105,IN,Monroe,,2020,5.6,64099,67917,3818
18105,IN,Monroe,,2021,2.9,67166,69181,2015
18107,IN,Montgomery,,2007,3.9,18470,19219,749
18107,IN,Montgomery,,2008,4.9,18219,19166,947
18107,IN,Montgomery,,2009,10.3,16972,18919,1947
18107,IN,Montgomery,,2010,9.9,17025,18894,1869
18107,IN,Montgomery,,2011,8.7,17128,18750,1622
18107,IN,Montgomery,,2012,8.1,17110,18608,1498
18107,IN,Montgomery,,2013,7,17133,18427,1294
18107,IN,Montgomery,,2014,5.4,17695,18701,1006
18107,IN,Montgomery,,2015,4,18500,19265,765
18107,IN,Montgomery,,2016,3.8,18450,19178,728
18107,IN,Montgomery,,2017,3,18416,18991,575
18107,IN,Montgomery,,2018,3,18556,19129,573
18107,IN,Montgomery,,2019,3,18344,18912,568
18107,IN,Montgomery,,2020,5.3,17632,18609,977
18107,IN,Montgomery,,2021,2.6,17933,18414,481
18109,IN,Morgan,,2007,4.2,35198,36750,1552
18109,IN,Morgan,,2008,5.8,35496,37668,2172
18109,IN,Morgan,,2009,9.3,33436,36876,3440
18109,IN,Morgan,,2010,10.1,31496,35035,3539
18109,IN,Morgan,,2011,9.1,31773,34966,3193
18109,IN,Morgan,,2012,8.3,31838,34705,2867
18109,IN,Morgan,,2013,7.4,32296,34880,2584
18109,IN,Morgan,,2014,5.8,32982,35009,2027
18109,IN,Morgan,,2015,4.7,33710,35365,1655
18109,IN,Morgan,,2016,4.2,34561,36074,1513
18109,IN,Morgan,,2017,3.5,34617,35868,1251
18109,IN,Morgan,,2018,3.4,35105,36324,1219
18109,IN,Morgan,,2019,3,35452,36563,1111
18109,IN,Morgan,,2020,5.5,33531,35482,1951
18109,IN,Morgan,,2021,2.9,35153,36205,1052
18111,IN,Newton,,2007,5.3,6587,6956,369
18111,IN,Newton,,2008,6.3,6561,7001,440
18111,IN,Newton,,2009,11.4,6102,6884,782
18111,IN,Newton,,2010,11.1,6293,7075,782
18111,IN,Newton,,2011,9.7,6327,7005,678
18111,IN,Newton,,2012,9.4,6272,6926,654
18111,IN,Newton,,2013,8.8,6309,6916,607
18111,IN,Newton,,2014,6.9,6468,6951,483
18111,IN,Newton,,2015,5.8,6558,6960,402
18111,IN,Newton,,2016,5.5,6655,7043,388
18111,IN,Newton,,2017,4.8,6737,7073,336
18111,IN,Newton,,2018,4.3,6759,7062,303
18111,IN,Newton,,2019,4.1,6635,6919,284
18111,IN,Newton,,2020,7,6100,6557,457
18111,IN,Newton,,2021,3.8,6280,6526,246
18113,IN,Noble,,2007,5.5,21857,23127,1270
18113,IN,Noble,,2008,8.5,20902,22836,1934
18113,IN,Noble,,2009,17.4,18456,22349,3893
18113,IN,Noble,,2010,12.8,20049,22998,2949
18113,IN,Noble,,2011,9.9,20891,23179,2288
18113,IN,Noble,,2012,8.5,20717,22638,1921
18113,IN,Noble,,2013,7.2,21027,22655,1628
18113,IN,Noble,,2014,5.2,21947,23144,1197
18113,IN,Noble,,2015,4.2,22647,23649,1002
18113,IN,Noble,,2016,4,22419,23354,935
18113,IN,Noble,,2017,3.1,22425,23132,707
18113,IN,Noble,,2018,2.9,22997,23683,686
18113,IN,Noble,,2019,3.1,23075,23801,726
18113,IN,Noble,,2020,8.4,20926,22856,1930
18113,IN,Noble,,2021,3.3,21273,21988,715
18115,IN,Ohio,,2007,5,2871,3022,151
18115,IN,Ohio,,2008,6.2,2867,3057,190
18115,IN,Ohio,,2009,10.9,2770,3110,340
18115,IN,Ohio,,2010,10.8,2912,3264,352
18115,IN,Ohio,,2011,9.3,2918,3218,300
18115,IN,Ohio,,2012,8.7,2904,3182,278
18115,IN,Ohio,,2013,8.1,2911,3169,258
18115,IN,Ohio,,2014,6.9,2998,3219,221
18115,IN,Ohio,,2015,5.5,3003,3177,174
18115,IN,Ohio,,2016,4.8,3072,3227,155
18115,IN,Ohio,,2017,3.6,3038,3151,113
18115,IN,Ohio,,2018,3.4,3082,3192,110
18115,IN,Ohio,,2019,3.4,3117,3228,111
18115,IN,Ohio,,2020,7.4,2923,3158,235
18115,IN,Ohio,,2021,2.5,3042,3121,79
18117,IN,Orange,,2007,5.2,9897,10439,542
18117,IN,Orange,,2008,6.4,9776,10443,667
18117,IN,Orange,,2009,10.9,9382,10524,1142
18117,IN,Orange,,2010,12.4,7974,9098,1124
18117,IN,Orange,,2011,11.6,7850,8877,1027
18117,IN,Orange,,2012,10.6,7848,8780,932
18117,IN,Orange,,2013,9.7,7912,8766,854
18117,IN,Orange,,2014,7.7,7885,8544,659
18117,IN,Orange,,2015,5.9,8206,8724,518
18117,IN,Orange,,2016,5,8443,8888,445
18117,IN,Orange,,2017,3.9,8374,8717,343
18117,IN,Orange,,2018,3.8,8249,8579,330
18117,IN,Orange,,2019,3.4,8404,8698,294
18117,IN,Orange,,2020,11.2,7552,8504,952
18117,IN,Orange,,2021,4.2,7804,8149,345
18119,IN,Owen,,2007,5,10618,11175,557
18119,IN,Owen,,2008,6.4,10726,11460,734
18119,IN,Owen,,2009,9.6,10504,11616,1112
18119,IN,Owen,,2010,11.3,9155,10316,1161
18119,IN,Owen,,2011,11,9037,10159,1122
18119,IN,Owen,,2012,10.7,8782,9836,1054
18119,IN,Owen,,2013,9.9,8695,9649,954
18119,IN,Owen,,2014,8.1,8719,9486,767
18119,IN,Owen,,2015,6.3,8701,9283,582
18119,IN,Owen,,2016,5.5,8759,9268,509
18119,IN,Owen,,2017,4.3,8794,9190,396
18119,IN,Owen,,2018,4.3,8945,9347,402
18119,IN,Owen,,2019,4,8965,9334,369
18119,IN,Owen,,2020,6.4,8436,9015,579
18119,IN,Owen,,2021,3.6,8830,9156,326
18121,IN,Parke,,2007,5,7609,8012,403
18121,IN,Parke,,2008,6,7598,8086,488
18121,IN,Parke,,2009,10.2,7267,8089,822
18121,IN,Parke,,2010,10.7,6552,7333,781
18121,IN,Parke,,2011,10.2,6470,7208,738
18121,IN,Parke,,2012,10.1,6288,6994,706
18121,IN,Parke,,2013,9.1,6312,6941,629
18121,IN,Parke,,2014,7,6469,6953,484
18121,IN,Parke,,2015,5.6,6655,7051,396
18121,IN,Parke,,2016,5.1,6899,7273,374
18121,IN,Parke,,2017,4,6905,7190,285
18121,IN,Parke,,2018,4,6875,7159,284
18121,IN,Parke,,2019,3.8,6789,7054,265
18121,IN,Parke,,2020,5.5,6474,6853,379
18121,IN,Parke,,2021,2.9,6715,6916,201
18123,IN,Perry,,2007,4.5,9255,9690,435
18123,IN,Perry,,2008,5.2,9240,9745,505
18123,IN,Perry,,2009,10.4,8681,9685,1004
18123,IN,Perry,,2010,10.3,8013,8934,921
18123,IN,Perry,,2011,8.9,8273,9086,813
18123,IN,Perry,,2012,8.3,8146,8882,736
18123,IN,Perry,,2013,7.6,8264,8947,683
18123,IN,Perry,,2014,5.8,8646,9181,535
18123,IN,Perry,,2015,4.7,8798,9230,432
18123,IN,Perry,,2016,4.5,9044,9470,426
18123,IN,Perry,,2017,3.8,8913,9264,351
18123,IN,Perry,,2018,3.7,9000,9341,341
18123,IN,Perry,,2019,3.3,8976,9279,303
18123,IN,Perry,,2020,6.6,8480,9079,599
18123,IN,Perry,,2021,3.1,8495,8766,271
18125,IN,Pike,,2007,4.4,5737,5998,261
18125,IN,Pike,,2008,5.6,5714,6055,341
18125,IN,Pike,,2009,9.7,5319,5890,571
18125,IN,Pike,,2010,9.3,5630,6205,575
18125,IN,Pike,,2011,7.7,5769,6250,481
18125,IN,Pike,,2012,7.3,5691,6137,446
18125,IN,Pike,,2013,6.7,5855,6273,418
18125,IN,Pike,,2014,5.1,6029,6350,321
18125,IN,Pike,,2015,4.3,5920,6188,268
18125,IN,Pike,,2016,4.3,6065,6337,272
18125,IN,Pike,,2017,3.3,6236,6449,213
18125,IN,Pike,,2018,3.5,5932,6144,212
18125,IN,Pike,,2019,3.3,5944,6144,200
18125,IN,Pike,,2020,5.9,5808,6171,363
18125,IN,Pike,,2021,3.4,5586,5782,196
18127,IN,Porter,,2007,3.9,79723,82936,3213
18127,IN,Porter,,2008,4.8,80644,84701,4057
18127,IN,Porter,,2009,9.5,76748,84794,8046
18127,IN,Porter,,2010,9.2,74116,81658,7542
18127,IN,Porter,,2011,8,75892,82497,6605
18127,IN,Porter,,2012,7.5,76282,82465,6183
18127,IN,Porter,,2013,7.1,77418,83317,5899
18127,IN,Porter,,2014,6.2,78881,84077,5196
18127,IN,Porter,,2015,5.3,80174,84689,4515
18127,IN,Porter,,2016,5.1,81990,86357,4367
18127,IN,Porter,,2017,4,82509,85962,3453
18127,IN,Porter,,2018,3.8,84168,87469,3301
18127,IN,Porter,,2019,3.7,83354,86580,3226
18127,IN,Porter,,2020,8.2,77433,84310,6877
18127,IN,Porter,,2021,3.9,79974,83182,3208
18129,IN,Posey,,2007,4.3,12769,13342,573
18129,IN,Posey,,2008,4.9,12760,13414,654
18129,IN,Posey,,2009,8.3,12166,13265,1099
18129,IN,Posey,,2010,7.6,12481,13502,1021
18129,IN,Posey,,2011,6.7,12552,13457,905
18129,IN,Posey,,2012,6.7,12326,13205,879
18129,IN,Posey,,2013,6.2,12164,12970,806
18129,IN,Posey,,2014,4.8,12534,13161,627
18129,IN,Posey,,2015,3.9,12774,13299,525
18129,IN,Posey,,2016,3.9,12941,13465,524
18129,IN,Posey,,2017,3,13133,13535,402
18129,IN,Posey,,2018,2.8,13351,13734,383
18129,IN,Posey,,2019,2.7,13149,13516,367
18129,IN,Posey,,2020,5,12136,12774,638
18129,IN,Posey,,2021,2.6,12484,12821,337
18131,IN,Pulaski,,2007,4.2,6504,6789,285
18131,IN,Pulaski,,2008,5.6,6441,6825,384
18131,IN,Pulaski,,2009,10.6,6078,6798,720
18131,IN,Pulaski,,2010,9.7,5755,6373,618
18131,IN,Pulaski,,2011,7.9,5909,6417,508
18131,IN,Pulaski,,2012,7.3,5821,6277,456
18131,IN,Pulaski,,2013,6.9,5705,6127,422
18131,IN,Pulaski,,2014,5.4,5864,6197,333
18131,IN,Pulaski,,2015,4.5,5991,6273,282
18131,IN,Pulaski,,2016,4.4,6104,6386,282
18131,IN,Pulaski,,2017,3.4,6161,6380,219
18131,IN,Pulaski,,2018,3.1,6316,6515,199
18131,IN,Pulaski,,2019,3,6369,6566,197
18131,IN,Pulaski,,2020,6.1,6009,6401,392
18131,IN,Pulaski,,2021,2.9,6091,6276,185
18133,IN,Putnam,,2007,5.4,16546,17492,946
18133,IN,Putnam,,2008,6.7,16574,17772,1198
18133,IN,Putnam,,2009,11.1,15422,17344,1922
18133,IN,Putnam,,2010,11.4,14780,16673,1893
18133,IN,Putnam,,2011,10.6,14863,16626,1763
18133,IN,Putnam,,2012,9.8,14753,16348,1595
18133,IN,Putnam,,2013,8.5,14808,16183,1375
18133,IN,Putnam,,2014,6.6,15199,16275,1076
18133,IN,Putnam,,2015,5.1,15566,16398,832
18133,IN,Putnam,,2016,4.4,15880,16619,739
18133,IN,Putnam,,2017,3.6,15998,16596,598
18133,IN,Putnam,,2018,3.7,16160,16788,628
18133,IN,Putnam,,2019,3.4,16136,16706,570
18133,IN,Putnam,,2020,6.4,15155,16188,1033
18133,IN,Putnam,,2021,3.1,15854,16353,499
18135,IN,Randolph,,2007,5.7,11917,12637,720
18135,IN,Randolph,,2008,6.9,11884,12766,882
18135,IN,Randolph,,2009,12.1,11371,12942,1571
18135,IN,Randolph,,2010,11.5,11524,13017,1493
18135,IN,Randolph,,2011,10.2,11722,13049,1327
18135,IN,Randolph,,2012,9.4,11567,12768,1201
18135,IN,Randolph,,2013,8.5,11525,12593,1068
18135,IN,Randolph,,2014,6.4,11687,12489,802
18135,IN,Randolph,,2015,4.9,12059,12683,624
18135,IN,Randolph,,2016,4.4,12118,12681,563
18135,IN,Randolph,,2017,4.1,11250,11734,484
18135,IN,Randolph,,2018,3.9,11180,11628,448
18135,IN,Randolph,,2019,3.7,10935,11351,416
18135,IN,Randolph,,2020,6.6,10452,11194,742
18135,IN,Randolph,,2021,2.9,11524,11874,350
18137,IN,Ripley,,2007,4.6,13251,13889,638
18137,IN,Ripley,,2008,6,13265,14107,842
18137,IN,Ripley,,2009,11,12340,13863,1523
18137,IN,Ripley,,2010,10.9,12940,14523,1583
18137,IN,Ripley,,2011,9.2,13585,14968,1383
18137,IN,Ripley,,2012,8.8,12630,13856,1226
18137,IN,Ripley,,2013,8.4,12504,13653,1149
18137,IN,Ripley,,2014,6.6,12748,13645,897
18137,IN,Ripley,,2015,5.3,12905,13631,726
18137,IN,Ripley,,2016,4.5,13442,14078,636
18137,IN,Ripley,,2017,3.5,13574,14067,493
18137,IN,Ripley,,2018,3.5,13621,14122,501
18137,IN,Ripley,,2019,3.2,13926,14384,458
18137,IN,Ripley,,2020,6.5,13020,13919,899
18137,IN,Ripley,,2021,2.8,13159,13534,375
18139,IN,Rush,,2007,4.6,9001,9433,432
18139,IN,Rush,,2008,6.2,8696,9267,571
18139,IN,Rush,,2009,10.7,8175,9150,975
18139,IN,Rush,,2010,10.9,7741,8685,944
18139,IN,Rush,,2011,9.4,7800,8605,805
18139,IN,Rush,,2012,8.4,7682,8384,702
18139,IN,Rush,,2013,7.3,7742,8349,607
18139,IN,Rush,,2014,5.6,8056,8534,478
18139,IN,Rush,,2015,4.3,8457,8837,380
18139,IN,Rush,,2016,3.7,8654,8987,333
18139,IN,Rush,,2017,3,8662,8932,270
18139,IN,Rush,,2018,2.8,8794,9050,256
18139,IN,Rush,,2019,2.6,8814,9052,238
18139,IN,Rush,,2020,6.3,8213,8766,553
18139,IN,Rush,,2021,2.8,8511,8755,244
18141,IN,St. Joseph,,2007,4.9,126025,132579,6554
18141,IN,St. Joseph,,2008,6.6,124654,133416,8762
18141,IN,St. Joseph,,2009,11.7,114865,130031,15166
18141,IN,St. Joseph,,2010,11.3,115758,130450,14692
18141,IN,St. Joseph,,2011,9.9,117889,130857,12968
18141,IN,St. Joseph,,2012,9.3,115943,127863,11920
18141,IN,St. Joseph,,2013,8.5,116405,127277,10872
18141,IN,St. Joseph,,2014,6.5,120407,128812,8405
18141,IN,St. Joseph,,2015,5,123868,130384,6516
18141,IN,St. Joseph,,2016,4.5,128253,134247,5994
18141,IN,St. Joseph,,2017,3.5,129844,134613,4769
18141,IN,St. Joseph,,2018,3.5,131849,136657,4808
18141,IN,St. Joseph,,2019,3.5,133631,138514,4883
18141,IN,St. Joseph,,2020,8.5,122108,133500,11392
18141,IN,St. Joseph,,2021,4.2,125454,130947,5493
18143,IN,Scott,,2007,5.3,10451,11036,585
18143,IN,Scott,,2008,6.5,10419,11142,723
18143,IN,Scott,,2009,13.1,9585,11032,1447
18143,IN,Scott,,2010,12.8,9225,10584,1359
18143,IN,Scott,,2011,11.6,9186,10394,1208
18143,IN,Scott,,2012,10.2,9153,10187,1034
18143,IN,Scott,,2013,8.8,9354,10253,899
18143,IN,Scott,,2014,6.8,9502,10193,691
18143,IN,Scott,,2015,5.4,9709,10266,557
18143,IN,Scott,,2016,4.8,9984,10486,502
18143,IN,Scott,,2017,3.8,10073,10466,393
18143,IN,Scott,,2018,3.8,10226,10635,409
18143,IN,Scott,,2019,3.5,10247,10622,375
18143,IN,Scott,,2020,8.5,9569,10463,894
18143,IN,Scott,,2021,3.9,9961,10362,401
18145,IN,Shelby,,2007,4.4,22510,23545,1035
18145,IN,Shelby,,2008,5.9,22508,23910,1402
18145,IN,Shelby,,2009,10.6,21291,23815,2524
18145,IN,Shelby,,2010,10.7,20289,22713,2424
18145,IN,Shelby,,2011,9.3,20468,22563,2095
18145,IN,Shelby,,2012,8.2,20498,22336,1838
18145,IN,Shelby,,2013,7.2,20771,22382,1611
18145,IN,Shelby,,2014,5.7,21174,22447,1273
18145,IN,Shelby,,2015,4.4,21623,22623,1000
18145,IN,Shelby,,2016,3.9,22074,22980,906
18145,IN,Shelby,,2017,3.3,22132,22886,754
18145,IN,Shelby,,2018,3.1,22413,23124,711
18145,IN,Shelby,,2019,2.9,22580,23246,666
18145,IN,Shelby,,2020,7.3,21342,23019,1677
18145,IN,Shelby,,2021,3,22337,23037,700
18147,IN,Spencer,,2007,4.2,9971,10410,439
18147,IN,Spencer,,2008,5.1,10025,10560,535
18147,IN,Spencer,,2009,9.4,9481,10459,978
18147,IN,Spencer,,2010,8.6,10063,11004,941
18147,IN,Spencer,,2011,7.5,10230,11060,830
18147,IN,Spencer,,2012,7.1,10035,10803,768
18147,IN,Spencer,,2013,6.5,10009,10709,700
18147,IN,Spencer,,2014,5.1,10202,10752,550
18147,IN,Spencer,,2015,4.1,10522,10973,451
18147,IN,Spencer,,2016,4,10543,10988,445
18147,IN,Spencer,,2017,3.3,10557,10919,362
18147,IN,Spencer,,2018,3.2,10637,10993,356
18147,IN,Spencer,,2019,3.1,10556,10890,334
18147,IN,Spencer,,2020,5.6,9754,10337,583
18147,IN,Spencer,,2021,2.7,10133,10418,285
18149,IN,Starke,,2007,6,9814,10438,624
18149,IN,Starke,,2008,7.8,9909,10743,834
18149,IN,Starke,,2009,14.4,9256,10813,1557
18149,IN,Starke,,2010,13,9081,10437,1356
18149,IN,Starke,,2011,11.2,9193,10350,1157
18149,IN,Starke,,2012,10.5,9056,10113,1057
18149,IN,Starke,,2013,9.3,9276,10226,950
18149,IN,Starke,,2014,7.2,9498,10238,740
18149,IN,Starke,,2015,5.9,9923,10546,623
18149,IN,Starke,,2016,5.3,10289,10869,580
18149,IN,Starke,,2017,4.4,9998,10453,455
18149,IN,Starke,,2018,4.3,9970,10420,450
18149,IN,Starke,,2019,4.3,9513,9939,426
18149,IN,Starke,,2020,8.1,8954,9746,792
18149,IN,Starke,,2021,4.3,9142,9555,413
18151,IN,Steuben,,2007,6.1,15473,16470,997
18151,IN,Steuben,,2008,7.5,15023,16241,1218
18151,IN,Steuben,,2009,14.8,14004,16431,2427
18151,IN,Steuben,,2010,10.8,16439,18439,2000
18151,IN,Steuben,,2011,8.8,16975,18608,1633
18151,IN,Steuben,,2012,7.2,17574,18934,1360
18151,IN,Steuben,,2013,6.1,18167,19357,1190
18151,IN,Steuben,,2014,4.8,18864,19819,955
18151,IN,Steuben,,2015,3.9,19203,19979,776
18151,IN,Steuben,,2016,3.6,19379,20104,725
18151,IN,Steuben,,2017,2.9,19386,19962,576
18151,IN,Steuben,,2018,2.6,19808,20344,536
18151,IN,Steuben,,2019,2.6,20210,20758,548
18151,IN,Steuben,,2020,6.3,18649,19907,1258
18151,IN,Steuben,,2021,2.5,19386,19886,500
18153,IN,Sullivan,,2007,5.6,8408,8905,497
18153,IN,Sullivan,,2008,6.7,8307,8904,597
18153,IN,Sullivan,,2009,10.1,8013,8911,898
18153,IN,Sullivan,,2010,9.8,8196,9086,890
18153,IN,Sullivan,,2011,9.1,8098,8909,811
18153,IN,Sullivan,,2012,9.2,7999,8807,808
18153,IN,Sullivan,,2013,8.9,7943,8716,773
18153,IN,Sullivan,,2014,7.1,8036,8653,617
18153,IN,Sullivan,,2015,6.2,8119,8655,536
18153,IN,Sullivan,,2016,5.8,8202,8707,505
18153,IN,Sullivan,,2017,4.4,8202,8578,376
18153,IN,Sullivan,,2018,4.6,8209,8605,396
18153,IN,Sullivan,,2019,4.3,7856,8209,353
18153,IN,Sullivan,,2020,7,7407,7965,558
18153,IN,Sullivan,,2021,3.8,7535,7836,301
18155,IN,Switzerland,,2007,3.9,5455,5678,223
18155,IN,Switzerland,,2008,5,5428,5716,288
18155,IN,Switzerland,,2009,8,5251,5710,459
18155,IN,Switzerland,,2010,9.1,4573,5029,456
18155,IN,Switzerland,,2011,8,4600,5001,401
18155,IN,Switzerland,,2012,7.6,4522,4895,373
18155,IN,Switzerland,,2013,7.3,4533,4891,358
18155,IN,Switzerland,,2014,5.9,4523,4806,283
18155,IN,Switzerland,,2015,4.9,4614,4853,239
18155,IN,Switzerland,,2016,4.8,4759,5000,241
18155,IN,Switzerland,,2017,4,4800,4998,198
18155,IN,Switzerland,,2018,3.8,4882,5077,195
18155,IN,Switzerland,,2019,3.3,4877,5043,166
18155,IN,Switzerland,,2020,8.2,4413,4805,392
18155,IN,Switzerland,,2021,3.5,4505,4666,161
18157,IN,Tippecanoe,,2007,4,78126,81376,3250
18157,IN,Tippecanoe,,2008,4.7,79925,83886,3961
18157,IN,Tippecanoe,,2009,9.2,76989,84835,7846
18157,IN,Tippecanoe,,2010,8.6,79118,86557,7439
18157,IN,Tippecanoe,,2011,7.3,81267,87661,6394
18157,IN,Tippecanoe,,2012,6.9,82474,88542,6068
18157,IN,Tippecanoe,,2013,6.5,83941,89799,5858
18157,IN,Tippecanoe,,2014,5,86782,91364,4582
18157,IN,Tippecanoe,,2015,4.2,89182,93108,3926
18157,IN,Tippecanoe,,2016,4,90699,94482,3783
18157,IN,Tippecanoe,,2017,3.2,92552,95596,3044
18157,IN,Tippecanoe,,2018,3.1,95164,98257,3093
18157,IN,Tippecanoe,,2019,3,95360,98284,2924
18157,IN,Tippecanoe,,2020,6.6,85742,91769,6027
18157,IN,Tippecanoe,,2021,3.3,90171,93208,3037
18159,IN,Tipton,,2007,4.7,7334,7697,363
18159,IN,Tipton,,2008,7.2,7076,7628,552
18159,IN,Tipton,,2009,13.2,6310,7272,962
18159,IN,Tipton,,2010,10,7244,8048,804
18159,IN,Tipton,,2011,8.8,7271,7974,703
18159,IN,Tipton,,2012,7.7,7403,8017,614
18159,IN,Tipton,,2013,6.6,7446,7974,528
18159,IN,Tipton,,2014,5.2,7747,8170,423
18159,IN,Tipton,,2015,4,8047,8380,333
18159,IN,Tipton,,2016,3.8,8213,8537,324
18159,IN,Tipton,,2017,3,8287,8545,258
18159,IN,Tipton,,2018,2.8,8993,9248,255
18159,IN,Tipton,,2019,2.7,9114,9363,249
18159,IN,Tipton,,2020,6.2,8465,9028,563
18159,IN,Tipton,,2021,3,8691,8960,269
18161,IN,Union,,2007,4.7,3441,3612,171
18161,IN,Union,,2008,6.2,3394,3618,224
18161,IN,Union,,2009,10.4,3183,3552,369
18161,IN,Union,,2010,10,3357,3730,373
18161,IN,Union,,2011,8.6,3358,3674,316
18161,IN,Union,,2012,7.9,3277,3559,282
18161,IN,Union,,2013,7.1,3276,3525,249
18161,IN,Union,,2014,5.6,3346,3545,199
18161,IN,Union,,2015,4.4,3402,3560,158
18161,IN,Union,,2016,4,3496,3641,145
18161,IN,Union,,2017,3.1,3500,3611,111
18161,IN,Union,,2018,3.1,3457,3568,111
18161,IN,Union,,2019,3.2,3480,3595,115
18161,IN,Union,,2020,5.6,3274,3468,194
18161,IN,Union,,2021,2.4,3389,3471,82
18163,IN,Vanderburgh,,2007,4.7,86371,90672,4301
18163,IN,Vanderburgh,,2008,5.2,87069,91843,4774
18163,IN,Vanderburgh,,2009,8.3,83593,91197,7604
18163,IN,Vanderburgh,,2010,8.7,84166,92169,8003
18163,IN,Vanderburgh,,2011,7.8,85708,92968,7260
18163,IN,Vanderburgh,,2012,7.5,84972,91909,6937
18163,IN,Vanderburgh,,2013,7,84680,91056,6376
18163,IN,Vanderburgh,,2014,5.4,87183,92139,4956
18163,IN,Vanderburgh,,2015,4.2,88320,92229,3909
18163,IN,Vanderburgh,,2016,4.1,89539,93328,3789
18163,IN,Vanderburgh,,2017,3.2,90702,93716,3014
18163,IN,Vanderburgh,,2018,3.1,92165,95151,2986
18163,IN,Vanderburgh,,2019,3,91550,94428,2878
18163,IN,Vanderburgh,,2020,7.2,85529,92161,6632
18163,IN,Vanderburgh,,2021,3.6,88095,91401,3306
18165,IN,Vermillion,,2007,5.7,7431,7878,447
18165,IN,Vermillion,,2008,7.3,7273,7842,569
18165,IN,Vermillion,,2009,12.3,7047,8033,986
18165,IN,Vermillion,,2010,12.6,6821,7806,985
18165,IN,Vermillion,,2011,11.5,6778,7659,881
18165,IN,Vermillion,,2012,11.2,6632,7471,839
18165,IN,Vermillion,,2013,10.6,6558,7332,774
18165,IN,Vermillion,,2014,8.6,6610,7230,620
18165,IN,Vermillion,,2015,7.1,6713,7224,511
18165,IN,Vermillion,,2016,6.5,6803,7276,473
18165,IN,Vermillion,,2017,5.3,6763,7145,382
18165,IN,Vermillion,,2018,5.4,6776,7165,389
18165,IN,Vermillion,,2019,5.3,6502,6863,361
18165,IN,Vermillion,,2020,7.6,6098,6598,500
18165,IN,Vermillion,,2021,4,6222,6480,258
18167,IN,Vigo,,2007,5.4,47366,50044,2678
18167,IN,Vigo,,2008,6.4,47346,50602,3256
18167,IN,Vigo,,2009,10.3,46050,51316,5266
18167,IN,Vigo,,2010,10.9,45548,51135,5587
18167,IN,Vigo,,2011,10.1,45505,50629,5124
18167,IN,Vigo,,2012,9.8,45259,50169,4910
18167,IN,Vigo,,2013,9.2,45021,49588,4567
18167,IN,Vigo,,2014,7.6,45748,49505,3757
18167,IN,Vigo,,2015,6.1,45990,48977,2987
18167,IN,Vigo,,2016,5.3,46792,49419,2627
18167,IN,Vigo,,2017,4.2,46914,48956,2042
18167,IN,Vigo,,2018,4.3,47041,49172,2131
18167,IN,Vigo,,2019,4.4,44941,46991,2050
18167,IN,Vigo,,2020,7.9,42549,46209,3660
18167,IN,Vigo,,2021,4.3,43523,45481,1958
18169,IN,Wabash,,2007,4.9,16139,16966,827
18169,IN,Wabash,,2008,7.5,15358,16607,1249
18169,IN,Wabash,,2009,13.3,14274,16455,2181
18169,IN,Wabash,,2010,11.1,14179,15954,1775
18169,IN,Wabash,,2011,9.4,14266,15739,1473
18169,IN,Wabash,,2012,8.4,14393,15707,1314
18169,IN,Wabash,,2013,7.5,14320,15478,1158
18169,IN,Wabash,,2014,5.5,14620,15479,859
18169,IN,Wabash,,2015,4.8,14653,15385,732
18169,IN,Wabash,,2016,4.2,14842,15493,651
18169,IN,Wabash,,2017,3.5,14608,15130,522
18169,IN,Wabash,,2018,3.4,14498,15009,511
18169,IN,Wabash,,2019,3.1,14611,15072,461
18169,IN,Wabash,,2020,6.2,13578,14471,893
18169,IN,Wabash,,2021,2.9,13986,14406,420
18171,IN,Warren,,2007,3.3,4820,4982,162
18171,IN,Warren,,2008,4.1,4616,4814,198
18171,IN,Warren,,2009,10.6,4181,4679,498
18171,IN,Warren,,2010,10.3,3770,4203,433
18171,IN,Warren,,2011,8,3941,4286,345
18171,IN,Warren,,2012,7.3,3896,4202,306
18171,IN,Warren,,2013,8.6,3799,4158,359
18171,IN,Warren,,2014,6.1,3849,4098,249
18171,IN,Warren,,2015,4.9,3895,4097,202
18171,IN,Warren,,2016,4.8,3919,4116,197
18171,IN,Warren,,2017,3.3,3955,4092,137
18171,IN,Warren,,2018,3.2,4079,4213,134
18171,IN,Warren,,2019,2.9,4088,4212,124
18171,IN,Warren,,2020,5.5,3745,3964,219
18171,IN,Warren,,2021,2.6,3870,3973,103
18173,IN,Warrick,,2007,3.9,29242,30438,1196
18173,IN,Warrick,,2008,4.6,29719,31166,1447
18173,IN,Warrick,,2009,7.8,28844,31292,2448
18173,IN,Warrick,,2010,7.8,28437,30846,2409
18173,IN,Warrick,,2011,6.9,29035,31201,2166
18173,IN,Warrick,,2012,6.7,28781,30846,2065
18173,IN,Warrick,,2013,6.2,28869,30769,1900
18173,IN,Warrick,,2014,4.9,29676,31202,1526
18173,IN,Warrick,,2015,4,30469,31751,1282
18173,IN,Warrick,,2016,4,31221,32516,1295
18173,IN,Warrick,,2017,3.1,31650,32666,1016
18173,IN,Warrick,,2018,2.9,32290,33256,966
18173,IN,Warrick,,2019,2.9,32206,33159,953
18173,IN,Warrick,,2020,5.5,30074,31818,1744
18173,IN,Warrick,,2021,2.6,31028,31859,831
18175,IN,Washington,,2007,5.3,13249,13989,740
18175,IN,Washington,,2008,6.7,13220,14162,942
18175,IN,Washington,,2009,12.1,12426,14143,1717
18175,IN,Washington,,2010,11.9,12157,13802,1645
18175,IN,Washington,,2011,10.4,12133,13540,1407
18175,IN,Washington,,2012,9.3,11956,13184,1228
18175,IN,Washington,,2013,8.6,12032,13161,1129
18175,IN,Washington,,2014,6.6,12441,13326,885
18175,IN,Washington,,2015,5.2,12804,13501,697
18175,IN,Washington,,2016,4.5,13078,13696,618
18175,IN,Washington,,2017,3.7,13129,13631,502
18175,IN,Washington,,2018,3.5,13364,13846,482
18175,IN,Washington,,2019,3.3,13393,13843,450
18175,IN,Washington,,2020,7,12609,13558,949
18175,IN,Washington,,2021,3.1,13088,13510,422
18177,IN,Wayne,,2007,5.4,31916,33749,1833
18177,IN,Wayne,,2008,7.1,31034,33411,2377
18177,IN,Wayne,,2009,12.5,28459,32534,4075
18177,IN,Wayne,,2010,12.5,27398,31315,3917
18177,IN,Wayne,,2011,10.9,27666,31046,3380
18177,IN,Wayne,,2012,9.8,27716,30711,2995
18177,IN,Wayne,,2013,8.5,27976,30578,2602
18177,IN,Wayne,,2014,6.5,28924,30933,2009
18177,IN,Wayne,,2015,5.3,29022,30641,1619
18177,IN,Wayne,,2016,4.7,29514,30980,1466
18177,IN,Wayne,,2017,3.7,29701,30846,1145
18177,IN,Wayne,,2018,3.5,30188,31298,1110
18177,IN,Wayne,,2019,3.5,29957,31044,1087
18177,IN,Wayne,,2020,6.8,28071,30125,2054
18177,IN,Wayne,,2021,3.6,28379,29433,1054
18179,IN,Wells,,2007,4.2,14032,14646,614
18179,IN,Wells,,2008,5.6,13961,14796,835
18179,IN,Wells,,2009,10.8,12772,14324,1552
18179,IN,Wells,,2010,9.5,12798,14144,1346
18179,IN,Wells,,2011,8.1,12948,14084,1136
18179,IN,Wells,,2012,7.1,12755,13725,970
18179,IN,Wells,,2013,6.2,12825,13676,851
18179,IN,Wells,,2014,4.8,13107,13765,658
18179,IN,Wells,,2015,3.9,13489,14035,546
18179,IN,Wells,,2016,3.5,13685,14183,498
18179,IN,Wells,,2017,2.9,13705,14118,413
18179,IN,Wells,,2018,2.8,14015,14416,401
18179,IN,Wells,,2019,2.7,14099,14488,389
18179,IN,Wells,,2020,5.9,13059,13871,812
18179,IN,Wells,,2021,2.6,13496,13851,355
18181,IN,White,,2007,4.5,11719,12266,547
18181,IN,White,,2008,5.8,11740,12461,721
18181,IN,White,,2009,11.2,11111,12516,1405
18181,IN,White,,2010,10.2,11651,12980,1329
18181,IN,White,,2011,8.5,12027,13142,1115
18181,IN,White,,2012,7.7,12039,13042,1003
18181,IN,White,,2013,6.7,12081,12955,874
18181,IN,White,,2014,5.1,12780,13461,681
18181,IN,White,,2015,4,13059,13609,550
18181,IN,White,,2016,3.9,13122,13658,536
18181,IN,White,,2017,3.3,12915,13349,434
18181,IN,White,,2018,3,13286,13701,415
18181,IN,White,,2019,2.7,13254,13615,361
18181,IN,White,,2020,5.1,12492,13168,676
18181,IN,White,,2021,2.6,12775,13117,342
18183,IN,Whitley,,2007,4.5,16907,17708,801
18183,IN,Whitley,,2008,6.4,16806,17949,1143
18183,IN,Whitley,,2009,12.8,15691,17988,2297
18183,IN,Whitley,,2010,11.2,15630,17602,1972
18183,IN,Whitley,,2011,9.1,15777,17362,1585
18183,IN,Whitley,,2012,7.8,15591,16916,1325
18183,IN,Whitley,,2013,6.8,15640,16790,1150
18183,IN,Whitley,,2014,5.1,15984,16850,866
18183,IN,Whitley,,2015,4.1,16322,17016,694
18183,IN,Whitley,,2016,3.8,16591,17252,661
18183,IN,Whitley,,2017,2.9,16781,17283,502
18183,IN,Whitley,,2018,2.8,17194,17696,502
18183,IN,Whitley,,2019,2.9,17211,17733,522
18183,IN,Whitley,,2020,6,16233,17272,1039
18183,IN,Whitley,,2021,2.7,16793,17253,460
19000,IA,Iowa,,2007,3.7,1600507,1662155,61648
19000,IA,Iowa,,2008,4.1,1612459,1682209,69750
19000,IA,Iowa,,2009,6.4,1569561,1677059,107498
19000,IA,Iowa,,2010,6.1,1571960,1674411,102451
19000,IA,Iowa,,2011,5.6,1575767,1670056,94289
19000,IA,Iowa,,2012,5.1,1576236,1660180,83944
19000,IA,Iowa,,2013,4.7,1597139,1676565,79426
19000,IA,Iowa,,2014,4.2,1626676,1698718,72042
19000,IA,Iowa,,2015,3.7,1637467,1700549,63082
19000,IA,Iowa,,2016,3.6,1642152,1703164,61012
19000,IA,Iowa,,2017,3.1,1645660,1697495,51835
19000,IA,Iowa,,2018,2.5,1671631,1714951,43320
19000,IA,Iowa,,2019,2.6,1704063,1749620,45557
19000,IA,Iowa,,2020,5.1,1595824,1682257,86433
19000,IA,Iowa,,2021,4.2,1605206,1676075,70869
19001,IA,Adair,,2007,3.5,4250,4404,154
19001,IA,Adair,,2008,4,4209,4384,175
19001,IA,Adair,,2009,5.8,3969,4212,243
19001,IA,Adair,,2010,5.6,3864,4095,231
19001,IA,Adair,,2011,4.9,3910,4113,203
19001,IA,Adair,,2012,4.4,3885,4064,179
19001,IA,Adair,,2013,4.2,3906,4078,172
19001,IA,Adair,,2014,4,3985,4151,166
19001,IA,Adair,,2015,3.2,4089,4224,135
19001,IA,Adair,,2016,2.9,4131,4255,124
19001,IA,Adair,,2017,2.8,4061,4176,115
19001,IA,Adair,,2018,2.4,4096,4195,99
19001,IA,Adair,,2019,2.2,4250,4347,97
19001,IA,Adair,,2020,3.8,4076,4239,163
19001,IA,Adair,,2021,3.1,4174,4307,133
19003,IA,Adams,,2007,4.2,2014,2102,88
19003,IA,Adams,,2008,4.2,2026,2115,89
19003,IA,Adams,,2009,6.1,2011,2142,131
19003,IA,Adams,,2010,4.9,2124,2234,110
19003,IA,Adams,,2011,4.5,2118,2218,100
19003,IA,Adams,,2012,4,2104,2191,87
19003,IA,Adams,,2013,3.7,2074,2153,79
19003,IA,Adams,,2014,3.3,2138,2212,74
19003,IA,Adams,,2015,2.8,2226,2289,63
19003,IA,Adams,,2016,2.6,2169,2227,58
19003,IA,Adams,,2017,2.3,2104,2154,50
19003,IA,Adams,,2018,1.9,2107,2148,41
19003,IA,Adams,,2019,1.7,2184,2221,37
19003,IA,Adams,,2020,3.7,1981,2057,76
19003,IA,Adams,,2021,3,1966,2027,61
19005,IA,Allamakee,,2007,4.8,7780,8170,390
19005,IA,Allamakee,,2008,6.4,7393,7895,502
19005,IA,Allamakee,,2009,10.2,6744,7511,767
19005,IA,Allamakee,,2010,8,7270,7899,629
19005,IA,Allamakee,,2011,7.3,7213,7781,568
19005,IA,Allamakee,,2012,6.5,7133,7626,493
19005,IA,Allamakee,,2013,6.3,7177,7662,485
19005,IA,Allamakee,,2014,5.6,7270,7703,433
19005,IA,Allamakee,,2015,4.8,7325,7697,372
19005,IA,Allamakee,,2016,4.9,7329,7708,379
19005,IA,Allamakee,,2017,3.9,7288,7586,298
19005,IA,Allamakee,,2018,3.1,7251,7480,229
19005,IA,Allamakee,,2019,3.3,7269,7520,251
19005,IA,Allamakee,,2020,5,6746,7098,352
19005,IA,Allamakee,,2021,4.6,6718,7039,321
19007,IA,Appanoose,,2007,6.9,5555,5964,409
19007,IA,Appanoose,,2008,5.4,5708,6037,329
19007,IA,Appanoose,,2009,8.7,5668,6206,538
19007,IA,Appanoose,,2010,7.4,5728,6189,461
19007,IA,Appanoose,,2011,7,5652,6080,428
19007,IA,Appanoose,,2012,6.6,5619,6013,394
19007,IA,Appanoose,,2013,6.4,5556,5935,379
19007,IA,Appanoose,,2014,5.7,5799,6149,350
19007,IA,Appanoose,,2015,4.8,5919,6220,301
19007,IA,Appanoose,,2016,4.7,5900,6190,290
19007,IA,Appanoose,,2017,3.7,5865,6092,227
19007,IA,Appanoose,,2018,3.3,5774,5972,198
19007,IA,Appanoose,,2019,3.4,5869,6075,206
19007,IA,Appanoose,,2020,5.2,5625,5934,309
19007,IA,Appanoose,,2021,4.3,5706,5961,255
19009,IA,Audubon,,2007,3.9,3151,3279,128
19009,IA,Audubon,,2008,4.5,3090,3234,144
19009,IA,Audubon,,2009,5.8,3080,3271,191
19009,IA,Audubon,,2010,5.7,3272,3469,197
19009,IA,Audubon,,2011,5.8,3181,3378,197
19009,IA,Audubon,,2012,4.8,3074,3229,155
19009,IA,Audubon,,2013,4.9,3083,3241,158
19009,IA,Audubon,,2014,4.3,3118,3258,140
19009,IA,Audubon,,2015,3.9,3110,3237,127
19009,IA,Audubon,,2016,3.3,3185,3293,108
19009,IA,Audubon,,2017,3,3090,3187,97
19009,IA,Audubon,,2018,2.5,3058,3135,77
19009,IA,Audubon,,2019,2.4,3102,3177,75
19009,IA,Audubon,,2020,3.4,2924,3026,102
19009,IA,Audubon,,2021,3.2,2938,3034,96
19011,IA,Benton,,2007,3.9,13726,14283,557
19011,IA,Benton,,2008,4.1,13850,14449,599
19011,IA,Benton,,2009,6.3,13730,14654,924
19011,IA,Benton,,2010,6.3,13395,14294,899
19011,IA,Benton,,2011,5.9,13343,14179,836
19011,IA,Benton,,2012,5.3,13093,13830,737
19011,IA,Benton,,2013,5.1,13042,13741,699
19011,IA,Benton,,2014,4.6,13224,13862,638
19011,IA,Benton,,2015,3.8,13239,13769,530
19011,IA,Benton,,2016,3.6,13179,13666,487
19011,IA,Benton,,2017,3.2,13049,13483,434
19011,IA,Benton,,2018,2.7,13163,13530,367
19011,IA,Benton,,2019,2.8,13415,13802,387
19011,IA,Benton,,2020,5,12274,12916,642
19011,IA,Benton,,2021,4.5,12274,12847,573
19013,IA,Black Hawk,,2007,3.7,70031,72754,2723
19013,IA,Black Hawk,,2008,4.1,70851,73858,3007
19013,IA,Black Hawk,,2009,6.1,69984,74537,4553
19013,IA,Black Hawk,,2010,6.3,66355,70810,4455
19013,IA,Black Hawk,,2011,5.9,67006,71234,4228
19013,IA,Black Hawk,,2012,5.5,67615,71516,3901
19013,IA,Black Hawk,,2013,5.1,68173,71842,3669
19013,IA,Black Hawk,,2014,4.9,68621,72154,3533
19013,IA,Black Hawk,,2015,4.5,67292,70483,3191
19013,IA,Black Hawk,,2016,4.6,66425,69624,3199
19013,IA,Black Hawk,,2017,3.7,66516,69065,2549
19013,IA,Black Hawk,,2018,2.8,67585,69528,1943
19013,IA,Black Hawk,,2019,3,68621,70771,2150
19013,IA,Black Hawk,,2020,6,63732,67814,4082
19013,IA,Black Hawk,,2021,4.6,64194,67282,3088
19015,IA,Boone,,2007,3.3,14990,15498,508
19015,IA,Boone,,2008,3.6,15127,15686,559
19015,IA,Boone,,2009,5.9,14791,15724,933
19015,IA,Boone,,2010,5.8,13946,14806,860
19015,IA,Boone,,2011,5,13977,14720,743
19015,IA,Boone,,2012,4.3,13994,14630,636
19015,IA,Boone,,2013,4.1,14298,14902,604
19015,IA,Boone,,2014,3.4,14677,15193,516
19015,IA,Boone,,2015,3,14855,15313,458
19015,IA,Boone,,2016,2.8,14772,15193,421
19015,IA,Boone,,2017,2.4,14618,14978,360
19015,IA,Boone,,2018,2.1,14737,15058,321
19015,IA,Boone,,2019,2.3,14892,15235,343
19015,IA,Boone,,2020,4,14002,14580,578
19015,IA,Boone,,2021,3.5,14056,14563,507
19017,IA,Bremer,,2007,3.1,13410,13842,432
19017,IA,Bremer,,2008,3.5,13447,13939,492
19017,IA,Bremer,,2009,5.4,13059,13806,747
19017,IA,Bremer,,2010,5,13136,13826,690
19017,IA,Bremer,,2011,4.4,13283,13901,618
19017,IA,Bremer,,2012,3.9,13386,13922,536
19017,IA,Bremer,,2013,3.8,13486,14017,531
19017,IA,Bremer,,2014,3.7,13657,14176,519
19017,IA,Bremer,,2015,3.5,13483,13969,486
19017,IA,Bremer,,2016,3.5,13483,13979,496
19017,IA,Bremer,,2017,2.8,13530,13913,383
19017,IA,Bremer,,2018,2,13723,14008,285
19017,IA,Bremer,,2019,2.2,14082,14395,313
19017,IA,Bremer,,2020,3.8,13259,13783,524
19017,IA,Bremer,,2021,3.2,13351,13793,442
19019,IA,Buchanan,,2007,4.2,10579,11041,462
19019,IA,Buchanan,,2008,4,10743,11196,453
19019,IA,Buchanan,,2009,6.6,10425,11163,738
19019,IA,Buchanan,,2010,6.1,10633,11322,689
19019,IA,Buchanan,,2011,5.8,10570,11215,645
19019,IA,Buchanan,,2012,4.8,10535,11069,534
19019,IA,Buchanan,,2013,4.7,10652,11182,530
19019,IA,Buchanan,,2014,4.6,10933,11465,532
19019,IA,Buchanan,,2015,4.2,10836,11313,477
19019,IA,Buchanan,,2016,4.1,10799,11259,460
19019,IA,Buchanan,,2017,3.1,10853,11205,352
19019,IA,Buchanan,,2018,2.6,11091,11382,291
19019,IA,Buchanan,,2019,2.6,11315,11617,302
19019,IA,Buchanan,,2020,4.5,10708,11208,500
19019,IA,Buchanan,,2021,3.7,10764,11178,414
19021,IA,Buena Vista,,2007,3.2,10067,10397,330
19021,IA,Buena Vista,,2008,3.6,10268,10648,380
19021,IA,Buena Vista,,2009,5.2,10149,10711,562
19021,IA,Buena Vista,,2010,4.8,10842,11391,549
19021,IA,Buena Vista,,2011,4.6,10862,11385,523
19021,IA,Buena Vista,,2012,4.2,10801,11272,471
19021,IA,Buena Vista,,2013,4,10875,11323,448
19021,IA,Buena Vista,,2014,4,11027,11481,454
19021,IA,Buena Vista,,2015,3.6,11163,11582,419
19021,IA,Buena Vista,,2016,3.5,11167,11571,404
19021,IA,Buena Vista,,2017,2.6,11361,11659,298
19021,IA,Buena Vista,,2018,2.1,11465,11709,244
19021,IA,Buena Vista,,2019,2,11707,11945,238
19021,IA,Buena Vista,,2020,3.6,11319,11740,421
19021,IA,Buena Vista,,2021,3.2,11260,11628,368
19023,IA,Butler,,2007,4,7935,8267,332
19023,IA,Butler,,2008,4.6,8123,8516,393
19023,IA,Butler,,2009,6.6,7895,8450,555
19023,IA,Butler,,2010,6.2,7675,8179,504
19023,IA,Butler,,2011,5.1,7786,8206,420
19023,IA,Butler,,2012,4.5,7871,8245,374
19023,IA,Butler,,2013,4.5,7898,8273,375
19023,IA,Butler,,2014,4.2,8026,8379,353
19023,IA,Butler,,2015,4.3,7920,8279,359
19023,IA,Butler,,2016,4.3,7722,8070,348
19023,IA,Butler,,2017,3.5,7653,7933,280
19023,IA,Butler,,2018,2.7,7713,7930,217
19023,IA,Butler,,2019,3,7811,8055,244
19023,IA,Butler,,2020,4.5,7389,7740,351
19023,IA,Butler,,2021,3.8,7587,7883,296
19025,IA,Calhoun,,2007,3.3,5049,5219,170
19025,IA,Calhoun,,2008,3.5,5110,5294,184
19025,IA,Calhoun,,2009,5.2,4969,5239,270
19025,IA,Calhoun,,2010,6.1,4360,4644,284
19025,IA,Calhoun,,2011,5.8,4266,4528,262
19025,IA,Calhoun,,2012,5.5,4200,4446,246
19025,IA,Calhoun,,2013,5.2,4140,4367,227
19025,IA,Calhoun,,2014,4.8,4207,4420,213
19025,IA,Calhoun,,2015,4.3,4265,4455,190
19025,IA,Calhoun,,2016,3.7,4375,4545,170
19025,IA,Calhoun,,2017,3,4204,4334,130
19025,IA,Calhoun,,2018,2.5,4237,4346,109
19025,IA,Calhoun,,2019,2.4,4232,4337,105
19025,IA,Calhoun,,2020,4,3938,4102,164
19025,IA,Calhoun,,2021,3.9,3901,4061,160
19027,IA,Carroll,,2007,2.6,11927,12250,323
19027,IA,Carroll,,2008,2.8,12021,12372,351
19027,IA,Carroll,,2009,4.2,11791,12309,518
19027,IA,Carroll,,2010,4.4,11168,11680,512
19027,IA,Carroll,,2011,4.1,11180,11659,479
19027,IA,Carroll,,2012,3.8,10954,11382,428
19027,IA,Carroll,,2013,3.4,10907,11286,379
19027,IA,Carroll,,2014,3.2,10871,11225,354
19027,IA,Carroll,,2015,2.6,11011,11304,293
19027,IA,Carroll,,2016,2.5,11049,11337,288
19027,IA,Carroll,,2017,2.3,10887,11138,251
19027,IA,Carroll,,2018,1.9,10773,10977,204
19027,IA,Carroll,,2019,1.8,10957,11162,205
19027,IA,Carroll,,2020,3.9,10201,10611,410
19027,IA,Carroll,,2021,3.1,10232,10559,327
19029,IA,Cass,,2007,4.1,7296,7611,315
19029,IA,Cass,,2008,4.6,7272,7620,348
19029,IA,Cass,,2009,6.8,7109,7624,515
19029,IA,Cass,,2010,6.4,6920,7391,471
19029,IA,Cass,,2011,6.1,6877,7321,444
19029,IA,Cass,,2012,5.2,6846,7222,376
19029,IA,Cass,,2013,5,6932,7300,368
19029,IA,Cass,,2014,4.3,7064,7383,319
19029,IA,Cass,,2015,3.6,7189,7457,268
19029,IA,Cass,,2016,3.2,7065,7301,236
19029,IA,Cass,,2017,3.5,6942,7196,254
19029,IA,Cass,,2018,2.7,7015,7206,191
19029,IA,Cass,,2019,2.7,6864,7053,189
19029,IA,Cass,,2020,3.8,6543,6802,259
19029,IA,Cass,,2021,3.7,6520,6768,248
19031,IA,Cedar,,2007,3.2,10555,10909,354
19031,IA,Cedar,,2008,3.6,10933,11344,411
19031,IA,Cedar,,2009,5.6,10750,11386,636
19031,IA,Cedar,,2010,5.5,10358,10959,601
19031,IA,Cedar,,2011,5.3,10346,10920,574
19031,IA,Cedar,,2012,4.6,10218,10707,489
19031,IA,Cedar,,2013,4.3,10361,10827,466
19031,IA,Cedar,,2014,3.9,10504,10925,421
19031,IA,Cedar,,2015,3.4,10612,10985,373
19031,IA,Cedar,,2016,3.3,10554,10914,360
19031,IA,Cedar,,2017,2.8,10587,10897,310
19031,IA,Cedar,,2018,2.4,10675,10940,265
19031,IA,Cedar,,2019,2.4,10789,11049,260
19031,IA,Cedar,,2020,4.3,10022,10468,446
19031,IA,Cedar,,2021,3.8,9962,10351,389
19033,IA,Cerro Gordo,,2007,3.9,24663,25669,1006
19033,IA,Cerro Gordo,,2008,4.7,24533,25753,1220
19033,IA,Cerro Gordo,,2009,6.9,23646,25407,1761
19033,IA,Cerro Gordo,,2010,7,22799,24504,1705
19033,IA,Cerro Gordo,,2011,6.2,22754,24266,1512
19033,IA,Cerro Gordo,,2012,5.6,22484,23816,1332
19033,IA,Cerro Gordo,,2013,5.4,22103,23365,1262
19033,IA,Cerro Gordo,,2014,4.6,22155,23232,1077
19033,IA,Cerro Gordo,,2015,3.9,22107,23007,900
19033,IA,Cerro Gordo,,2016,3.6,22408,23235,827
19033,IA,Cerro Gordo,,2017,3,22744,23450,706
19033,IA,Cerro Gordo,,2018,2.6,23012,23627,615
19033,IA,Cerro Gordo,,2019,2.6,23430,24055,625
19033,IA,Cerro Gordo,,2020,5.1,22076,23259,1183
19033,IA,Cerro Gordo,,2021,4.3,21534,22505,971
19035,IA,Cherokee,,2007,3.6,6390,6630,240
19035,IA,Cherokee,,2008,3.5,6278,6506,228
19035,IA,Cherokee,,2009,4.6,6273,6574,301
19035,IA,Cherokee,,2010,4.6,6745,7069,324
19035,IA,Cherokee,,2011,4.8,6628,6965,337
19035,IA,Cherokee,,2012,4.4,6585,6885,300
19035,IA,Cherokee,,2013,4.3,6555,6850,295
19035,IA,Cherokee,,2014,5.1,6294,6630,336
19035,IA,Cherokee,,2015,5.1,6015,6340,325
19035,IA,Cherokee,,2016,3.6,6124,6353,229
19035,IA,Cherokee,,2017,2.5,5954,6105,151
19035,IA,Cherokee,,2018,2.1,5940,6070,130
19035,IA,Cherokee,,2019,2.4,6126,6275,149
19035,IA,Cherokee,,2020,3.7,6004,6235,231
19035,IA,Cherokee,,2021,3.4,5912,6119,207
19037,IA,Chickasaw,,2007,4.2,6268,6541,273
19037,IA,Chickasaw,,2008,4.9,6565,6902,337
19037,IA,Chickasaw,,2009,8.9,6305,6918,613
19037,IA,Chickasaw,,2010,7.6,6047,6543,496
19037,IA,Chickasaw,,2011,6.4,6104,6520,416
19037,IA,Chickasaw,,2012,5.2,5991,6321,330
19037,IA,Chickasaw,,2013,5,6057,6375,318
19037,IA,Chickasaw,,2014,4.7,6172,6478,306
19037,IA,Chickasaw,,2015,4.5,6167,6455,288
19037,IA,Chickasaw,,2016,4.4,6175,6458,283
19037,IA,Chickasaw,,2017,3.1,6230,6432,202
19037,IA,Chickasaw,,2018,2.7,6335,6509,174
19037,IA,Chickasaw,,2019,2.7,6432,6612,180
19037,IA,Chickasaw,,2020,4.6,6038,6326,288
19037,IA,Chickasaw,,2021,3.6,6146,6373,227
19039,IA,Clarke,,2007,4.2,4629,4830,201
19039,IA,Clarke,,2008,4.6,4690,4916,226
19039,IA,Clarke,,2009,7.6,4534,4907,373
19039,IA,Clarke,,2010,7.8,4402,4774,372
19039,IA,Clarke,,2011,7.1,4371,4707,336
19039,IA,Clarke,,2012,6,4350,4629,279
19039,IA,Clarke,,2013,5.5,4338,4591,253
19039,IA,Clarke,,2014,4.5,4469,4678,209
19039,IA,Clarke,,2015,4,4575,4768,193
19039,IA,Clarke,,2016,3.3,4693,4855,162
19039,IA,Clarke,,2017,3.1,4683,4831,148
19039,IA,Clarke,,2018,2.8,4747,4885,138
19039,IA,Clarke,,2019,2.7,4847,4984,137
19039,IA,Clarke,,2020,5.2,4552,4804,252
19039,IA,Clarke,,2021,4.3,4624,4833,209
19041,IA,Clay,,2007,3.1,9460,9765,305
19041,IA,Clay,,2008,3.4,9414,9746,332
19041,IA,Clay,,2009,6.8,8877,9525,648
19041,IA,Clay,,2010,6,8767,9323,556
19041,IA,Clay,,2011,5.5,8778,9293,515
19041,IA,Clay,,2012,5.1,8468,8920,452
19041,IA,Clay,,2013,4.5,8429,8827,398
19041,IA,Clay,,2014,4.2,8569,8942,373
19041,IA,Clay,,2015,3.6,8533,8850,317
19041,IA,Clay,,2016,3.8,8429,8764,335
19041,IA,Clay,,2017,3.7,8328,8645,317
19041,IA,Clay,,2018,3.2,8372,8649,277
19041,IA,Clay,,2019,2.6,8440,8667,227
19041,IA,Clay,,2020,4.4,8068,8438,370
19041,IA,Clay,,2021,3.6,8170,8479,309
19043,IA,Clayton,,2007,4.8,9279,9750,471
19043,IA,Clayton,,2008,5.4,9445,9987,542
19043,IA,Clayton,,2009,8.6,9083,9934,851
19043,IA,Clayton,,2010,7.3,9702,10461,759
19043,IA,Clayton,,2011,6.3,9735,10386,651
19043,IA,Clayton,,2012,5.7,9625,10207,582
19043,IA,Clayton,,2013,5.6,9519,10088,569
19043,IA,Clayton,,2014,5,9682,10188,506
19043,IA,Clayton,,2015,4.1,9868,10290,422
19043,IA,Clayton,,2016,4.2,9918,10354,436
19043,IA,Clayton,,2017,3.9,9877,10276,399
19043,IA,Clayton,,2018,3.2,9963,10288,325
19043,IA,Clayton,,2019,3.5,9991,10349,358
19043,IA,Clayton,,2020,5.6,9197,9739,542
19043,IA,Clayton,,2021,5.1,9139,9632,493
19045,IA,Clinton,,2007,3.7,26442,27469,1027
19045,IA,Clinton,,2008,4.2,26978,28159,1181
19045,IA,Clinton,,2009,7.3,26021,28056,2035
19045,IA,Clinton,,2010,7.2,24505,26397,1892
19045,IA,Clinton,,2011,6.7,24224,25977,1753
19045,IA,Clinton,,2012,6.2,23642,25201,1559
19045,IA,Clinton,,2013,5.8,23520,24957,1437
19045,IA,Clinton,,2014,5.2,23484,24783,1299
19045,IA,Clinton,,2015,4.9,23219,24428,1209
19045,IA,Clinton,,2016,4.9,22765,23936,1171
19045,IA,Clinton,,2017,4,22462,23396,934
19045,IA,Clinton,,2018,3.2,22256,22991,735
19045,IA,Clinton,,2019,3.5,22448,23270,822
19045,IA,Clinton,,2020,6.6,20724,22182,1458
19045,IA,Clinton,,2021,5.3,20798,21967,1169
19047,IA,Crawford,,2007,3.3,9003,9311,308
19047,IA,Crawford,,2008,3.3,9099,9409,310
19047,IA,Crawford,,2009,4.6,9060,9500,440
19047,IA,Crawford,,2010,4.8,8530,8958,428
19047,IA,Crawford,,2011,4.8,8429,8856,427
19047,IA,Crawford,,2012,4.5,8398,8792,394
19047,IA,Crawford,,2013,4.4,8398,8781,383
19047,IA,Crawford,,2014,4.1,8377,8732,355
19047,IA,Crawford,,2015,4.1,8386,8749,363
19047,IA,Crawford,,2016,5.4,8020,8479,459
19047,IA,Crawford,,2017,4,7996,8332,336
19047,IA,Crawford,,2018,3.4,8001,8282,281
19047,IA,Crawford,,2019,3.4,8014,8293,279
19047,IA,Crawford,,2020,5.2,7580,7992,412
19047,IA,Crawford,,2021,5.2,7460,7867,407
19049,IA,Dallas,,2007,2.9,31640,32574,934
19049,IA,Dallas,,2008,3.2,32911,34014,1103
19049,IA,Dallas,,2009,4.9,33059,34776,1717
19049,IA,Dallas,,2010,4.6,35464,37190,1726
19049,IA,Dallas,,2011,4.3,36706,38374,1668
19049,IA,Dallas,,2012,3.9,37779,39323,1544
19049,IA,Dallas,,2013,3.6,39477,40955,1478
19049,IA,Dallas,,2014,3.3,41312,42713,1401
19049,IA,Dallas,,2015,2.8,42443,43682,1239
19049,IA,Dallas,,2016,2.6,44856,46059,1203
19049,IA,Dallas,,2017,2.1,46381,47374,993
19049,IA,Dallas,,2018,1.7,48520,49367,847
19049,IA,Dallas,,2019,1.8,51183,52144,961
19049,IA,Dallas,,2020,3.5,49331,51107,1776
19049,IA,Dallas,,2021,2.9,50351,51851,1500
19051,IA,Davis,,2007,4.5,3899,4084,185
19051,IA,Davis,,2008,5,3873,4076,203
19051,IA,Davis,,2009,9.1,3662,4030,368
19051,IA,Davis,,2010,7.3,3936,4246,310
19051,IA,Davis,,2011,6.2,3945,4207,262
19051,IA,Davis,,2012,5.8,3870,4107,237
19051,IA,Davis,,2013,5.5,3899,4127,228
19051,IA,Davis,,2014,5.1,3900,4110,210
19051,IA,Davis,,2015,4.4,3992,4176,184
19051,IA,Davis,,2016,4.2,4130,4311,181
19051,IA,Davis,,2017,3.3,4164,4305,141
19051,IA,Davis,,2018,2.7,4157,4271,114
19051,IA,Davis,,2019,2.7,4188,4304,116
19051,IA,Davis,,2020,3.9,3987,4150,163
19051,IA,Davis,,2021,3.3,4029,4168,139
19053,IA,Decatur,,2007,4.1,4029,4200,171
19053,IA,Decatur,,2008,3.8,4118,4280,162
19053,IA,Decatur,,2009,6.7,3897,4178,281
19053,IA,Decatur,,2010,6.2,4180,4455,275
19053,IA,Decatur,,2011,5.1,4140,4361,221
19053,IA,Decatur,,2012,4.5,4071,4261,190
19053,IA,Decatur,,2013,4.5,4113,4307,194
19053,IA,Decatur,,2014,3.8,4272,4440,168
19053,IA,Decatur,,2015,3.3,4285,4429,144
19053,IA,Decatur,,2016,3.2,4287,4428,141
19053,IA,Decatur,,2017,2.6,4207,4320,113
19053,IA,Decatur,,2018,2.3,4296,4395,99
19053,IA,Decatur,,2019,2.1,4363,4457,94
19053,IA,Decatur,,2020,3.7,4073,4231,158
19053,IA,Decatur,,2021,3.3,4128,4271,143
19055,IA,Delaware,,2007,3.6,10396,10779,383
19055,IA,Delaware,,2008,3.9,10435,10861,426
19055,IA,Delaware,,2009,6.7,10090,10816,726
19055,IA,Delaware,,2010,6.2,9699,10336,637
19055,IA,Delaware,,2011,5.6,9725,10298,573
19055,IA,Delaware,,2012,4.5,9835,10298,463
19055,IA,Delaware,,2013,4.3,9955,10402,447
19055,IA,Delaware,,2014,3.8,10129,10525,396
19055,IA,Delaware,,2015,3.3,10327,10684,357
19055,IA,Delaware,,2016,3.4,10412,10782,370
19055,IA,Delaware,,2017,2.6,10326,10603,277
19055,IA,Delaware,,2018,2.1,10367,10585,218
19055,IA,Delaware,,2019,2.2,10566,10806,240
19055,IA,Delaware,,2020,3.9,10065,10470,405
19055,IA,Delaware,,2021,3.3,10067,10412,345
19057,IA,Des Moines,,2007,4.4,20149,21084,935
19057,IA,Des Moines,,2008,5.8,19698,20908,1210
19057,IA,Des Moines,,2009,8,19367,21059,1692
19057,IA,Des Moines,,2010,7.6,18641,20173,1532
19057,IA,Des Moines,,2011,6.9,18998,20398,1400
19057,IA,Des Moines,,2012,6.2,18929,20175,1246
19057,IA,Des Moines,,2013,6,19284,20524,1240
19057,IA,Des Moines,,2014,5,19796,20839,1043
19057,IA,Des Moines,,2015,4.7,19555,20514,959
19057,IA,Des Moines,,2016,4.9,19155,20141,986
19057,IA,Des Moines,,2017,4.2,19008,19832,824
19057,IA,Des Moines,,2018,3.3,19071,19714,643
19057,IA,Des Moines,,2019,3.7,18985,19722,737
19057,IA,Des Moines,,2020,7.3,17364,18726,1362
19057,IA,Des Moines,,2021,6.3,17262,18427,1165
19059,IA,Dickinson,,2007,3.9,9371,9753,382
19059,IA,Dickinson,,2008,4.4,9287,9710,423
19059,IA,Dickinson,,2009,7.1,8665,9329,664
19059,IA,Dickinson,,2010,6.9,8634,9274,640
19059,IA,Dickinson,,2011,6.4,8702,9298,596
19059,IA,Dickinson,,2012,5.7,8694,9217,523
19059,IA,Dickinson,,2013,5.3,8851,9349,498
19059,IA,Dickinson,,2014,4.7,9257,9710,453
19059,IA,Dickinson,,2015,3.8,9816,10209,393
19059,IA,Dickinson,,2016,4.3,9912,10354,442
19059,IA,Dickinson,,2017,3.6,9831,10198,367
19059,IA,Dickinson,,2018,3.2,9667,9983,316
19059,IA,Dickinson,,2019,2.7,9984,10266,282
19059,IA,Dickinson,,2020,5,9364,9853,489
19059,IA,Dickinson,,2021,3.9,9728,10128,400
19061,IA,Dubuque,,2007,4,50011,52085,2074
19061,IA,Dubuque,,2008,4.3,50012,52284,2272
19061,IA,Dubuque,,2009,6.6,49113,52584,3471
19061,IA,Dubuque,,2010,5.9,50899,54082,3183
19061,IA,Dubuque,,2011,5.1,51803,54611,2808
19061,IA,Dubuque,,2012,4.5,52350,54844,2494
19061,IA,Dubuque,,2013,4.5,52622,55126,2504
19061,IA,Dubuque,,2014,4.1,53278,55567,2289
19061,IA,Dubuque,,2015,3.6,53699,55719,2020
19061,IA,Dubuque,,2016,3.5,53029,54968,1939
19061,IA,Dubuque,,2017,2.9,53438,55053,1615
19061,IA,Dubuque,,2018,2.4,54774,56129,1355
19061,IA,Dubuque,,2019,2.5,55840,57275,1435
19061,IA,Dubuque,,2020,5.7,52324,55483,3159
19061,IA,Dubuque,,2021,4.4,52531,54963,2432
19063,IA,Emmet,,2007,3.7,5715,5934,219
19063,IA,Emmet,,2008,3.9,5716,5950,234
19063,IA,Emmet,,2009,8.3,5353,5836,483
19063,IA,Emmet,,2010,7.2,5437,5857,420
19063,IA,Emmet,,2011,5.7,5481,5813,332
19063,IA,Emmet,,2012,4.5,5479,5736,257
19063,IA,Emmet,,2013,4.1,5458,5691,233
19063,IA,Emmet,,2014,3.9,5507,5733,226
19063,IA,Emmet,,2015,3.7,5455,5664,209
19063,IA,Emmet,,2016,4.2,5387,5624,237
19063,IA,Emmet,,2017,3.1,5285,5456,171
19063,IA,Emmet,,2018,2.7,5227,5374,147
19063,IA,Emmet,,2019,2.4,5232,5363,131
19063,IA,Emmet,,2020,4.8,4830,5075,245
19063,IA,Emmet,,2021,4.1,4727,4928,201
19065,IA,Fayette,,2007,4.4,10433,10913,480
19065,IA,Fayette,,2008,5.3,10368,10947,579
19065,IA,Fayette,,2009,8.6,9969,10908,939
19065,IA,Fayette,,2010,7.3,10190,10990,800
19065,IA,Fayette,,2011,6.3,10388,11088,700
19065,IA,Fayette,,2012,5.4,10247,10837,590
19065,IA,Fayette,,2013,5.3,10118,10681,563
19065,IA,Fayette,,2014,5,10253,10792,539
19065,IA,Fayette,,2015,4.5,10327,10812,485
19065,IA,Fayette,,2016,4.4,10293,10767,474
19065,IA,Fayette,,2017,3.6,10207,10586,379
19065,IA,Fayette,,2018,3,10349,10665,316
19065,IA,Fayette,,2019,3.4,10439,10805,366
19065,IA,Fayette,,2020,5.3,9771,10323,552
19065,IA,Fayette,,2021,4.7,9694,10172,478
19067,IA,Floyd,,2007,4.5,8329,8719,390
19067,IA,Floyd,,2008,5.8,8125,8625,500
19067,IA,Floyd,,2009,8.7,7771,8516,745
19067,IA,Floyd,,2010,7.4,7900,8532,632
19067,IA,Floyd,,2011,6.6,7780,8330,550
19067,IA,Floyd,,2012,6.3,7647,8158,511
19067,IA,Floyd,,2013,5.5,7827,8285,458
19067,IA,Floyd,,2014,4.5,8030,8409,379
19067,IA,Floyd,,2015,3.7,8375,8700,325
19067,IA,Floyd,,2016,3.6,8420,8735,315
19067,IA,Floyd,,2017,3.2,8580,8860,280
19067,IA,Floyd,,2018,2.7,8711,8951,240
19067,IA,Floyd,,2019,3.4,8699,9001,302
19067,IA,Floyd,,2020,5.9,7810,8299,489
19067,IA,Floyd,,2021,4.3,7843,8197,354
19069,IA,Franklin,,2007,3.5,5759,5969,210
19069,IA,Franklin,,2008,4.4,5600,5858,258
19069,IA,Franklin,,2009,7.4,5412,5844,432
19069,IA,Franklin,,2010,6.3,5630,6011,381
19069,IA,Franklin,,2011,5.2,5683,5995,312
19069,IA,Franklin,,2012,4.5,5574,5836,262
19069,IA,Franklin,,2013,4.5,5659,5923,264
19069,IA,Franklin,,2014,3.9,5741,5977,236
19069,IA,Franklin,,2015,3.3,5760,5958,198
19069,IA,Franklin,,2016,3.4,5770,5975,205
19069,IA,Franklin,,2017,2.7,5682,5839,157
19069,IA,Franklin,,2018,2.1,5740,5864,124
19069,IA,Franklin,,2019,2.2,5689,5819,130
19069,IA,Franklin,,2020,3.7,5421,5630,209
19069,IA,Franklin,,2021,3.7,5407,5617,210
19071,IA,Fremont,,2007,4,3801,3961,160
19071,IA,Fremont,,2008,4.5,3742,3917,175
19071,IA,Fremont,,2009,6.9,3513,3772,259
19071,IA,Fremont,,2010,6,3730,3968,238
19071,IA,Fremont,,2011,5.9,3751,3986,235
19071,IA,Fremont,,2012,5.1,3819,4026,207
19071,IA,Fremont,,2013,4.2,3959,4133,174
19071,IA,Fremont,,2014,3.9,4008,4169,161
19071,IA,Fremont,,2015,3.3,4013,4149,136
19071,IA,Fremont,,2016,3.3,3878,4009,131
19071,IA,Fremont,,2017,2.6,3749,3848,99
19071,IA,Fremont,,2018,1.9,3701,3771,70
19071,IA,Fremont,,2019,2.6,3688,3786,98
19071,IA,Fremont,,2020,3,3612,3724,112
19071,IA,Fremont,,2021,2.9,3613,3720,107
19073,IA,Greene,,2007,3.5,4817,4994,177
19073,IA,Greene,,2008,3.9,4890,5088,198
19073,IA,Greene,,2009,5.9,4791,5090,299
19073,IA,Greene,,2010,6,4877,5188,311
19073,IA,Greene,,2011,5.7,4915,5211,296
19073,IA,Greene,,2012,5,4882,5138,256
19073,IA,Greene,,2013,4.7,4890,5130,240
19073,IA,Greene,,2014,4,5061,5273,212
19073,IA,Greene,,2015,3.5,5376,5570,194
19073,IA,Greene,,2016,3.1,5520,5697,177
19073,IA,Greene,,2017,2.7,5332,5480,148
19073,IA,Greene,,2018,2.3,5345,5469,124
19073,IA,Greene,,2019,2.3,5400,5526,126
19073,IA,Greene,,2020,4.1,5128,5350,222
19073,IA,Greene,,2021,3.4,5152,5336,184
19075,IA,Grundy,,2007,3.2,6594,6811,217
19075,IA,Grundy,,2008,3.6,6643,6888,245
19075,IA,Grundy,,2009,5.8,6511,6914,403
19075,IA,Grundy,,2010,5.8,6348,6738,390
19075,IA,Grundy,,2011,5.1,6390,6731,341
19075,IA,Grundy,,2012,4.6,6373,6679,306
19075,IA,Grundy,,2013,4.4,6320,6608,288
19075,IA,Grundy,,2014,4.1,6444,6723,279
19075,IA,Grundy,,2015,3.8,6479,6732,253
19075,IA,Grundy,,2016,3.4,6441,6669,228
19075,IA,Grundy,,2017,2.9,6409,6598,189
19075,IA,Grundy,,2018,2.5,6436,6600,164
19075,IA,Grundy,,2019,2.6,6511,6685,174
19075,IA,Grundy,,2020,4.3,6068,6338,270
19075,IA,Grundy,,2021,3.6,6106,6337,231
19077,IA,Guthrie,,2007,3.8,5638,5862,224
19077,IA,Guthrie,,2008,4.3,5556,5807,251
19077,IA,Guthrie,,2009,6.3,5339,5697,358
19077,IA,Guthrie,,2010,6.6,5454,5838,384
19077,IA,Guthrie,,2011,6.2,5360,5715,355
19077,IA,Guthrie,,2012,5.6,5263,5578,315
19077,IA,Guthrie,,2013,5.1,5255,5540,285
19077,IA,Guthrie,,2014,4.4,5366,5611,245
19077,IA,Guthrie,,2015,3.7,5412,5622,210
19077,IA,Guthrie,,2016,3.6,5452,5654,202
19077,IA,Guthrie,,2017,3.2,5435,5612,177
19077,IA,Guthrie,,2018,2.6,5473,5619,146
19077,IA,Guthrie,,2019,2.9,5527,5690,163
19077,IA,Guthrie,,2020,4.9,5167,5432,265
19077,IA,Guthrie,,2021,4.2,5258,5491,233
19079,IA,Hamilton,,2007,3.2,8375,8652,277
19079,IA,Hamilton,,2008,3.8,8266,8594,328
19079,IA,Hamilton,,2009,7.6,7586,8212,626
19079,IA,Hamilton,,2010,7.4,7468,8066,598
19079,IA,Hamilton,,2011,9,6833,7507,674
19079,IA,Hamilton,,2012,6.9,6587,7078,491
19079,IA,Hamilton,,2013,5.5,6664,7049,385
19079,IA,Hamilton,,2014,4.5,6777,7098,321
19079,IA,Hamilton,,2015,4.2,6924,7228,304
19079,IA,Hamilton,,2016,3.7,6910,7178,268
19079,IA,Hamilton,,2017,3.2,6903,7130,227
19079,IA,Hamilton,,2018,2.7,6857,7046,189
19079,IA,Hamilton,,2019,2.7,6854,7043,189
19079,IA,Hamilton,,2020,4.3,6534,6828,294
19079,IA,Hamilton,,2021,4.2,6538,6826,288
19081,IA,Hancock,,2007,3.8,5815,6043,228
19081,IA,Hancock,,2008,6.3,5579,5957,378
19081,IA,Hancock,,2009,10,5056,5617,561
19081,IA,Hancock,,2010,6.8,5646,6056,410
19081,IA,Hancock,,2011,5.7,5624,5963,339
19081,IA,Hancock,,2012,4.6,5730,6005,275
19081,IA,Hancock,,2013,4,5969,6218,249
19081,IA,Hancock,,2014,3.3,6090,6297,207
19081,IA,Hancock,,2015,2.7,6196,6367,171
19081,IA,Hancock,,2016,2.7,6252,6424,172
19081,IA,Hancock,,2017,2.6,6033,6191,158
19081,IA,Hancock,,2018,2.3,5918,6058,140
19081,IA,Hancock,,2019,2.3,5881,6018,137
19081,IA,Hancock,,2020,4.5,5533,5796,263
19081,IA,Hancock,,2021,3.8,5500,5718,218
19083,IA,Hardin,,2007,3.8,8720,9064,344
19083,IA,Hardin,,2008,4.2,8888,9281,393
19083,IA,Hardin,,2009,6.6,8703,9314,611
19083,IA,Hardin,,2010,6.6,8506,9110,604
19083,IA,Hardin,,2011,6,8486,9025,539
19083,IA,Hardin,,2012,5.4,8321,8793,472
19083,IA,Hardin,,2013,5.1,8264,8708,444
19083,IA,Hardin,,2014,4.3,8333,8708,375
19083,IA,Hardin,,2015,3.9,8470,8815,345
19083,IA,Hardin,,2016,3.9,8285,8617,332
19083,IA,Hardin,,2017,3.1,8253,8521,268
19083,IA,Hardin,,2018,2.8,8125,8363,238
19083,IA,Hardin,,2019,3,8023,8273,250
19083,IA,Hardin,,2020,4.5,7481,7835,354
19083,IA,Hardin,,2021,4.2,7466,7790,324
19085,IA,Harrison,,2007,4.2,7460,7786,326
19085,IA,Harrison,,2008,4.2,7437,7761,324
19085,IA,Harrison,,2009,5,7276,7655,379
19085,IA,Harrison,,2010,5.7,7527,7980,453
19085,IA,Harrison,,2011,5.6,7409,7852,443
19085,IA,Harrison,,2012,5.1,7185,7568,383
19085,IA,Harrison,,2013,4.5,7179,7518,339
19085,IA,Harrison,,2014,4,7236,7538,302
19085,IA,Harrison,,2015,3.4,7285,7538,253
19085,IA,Harrison,,2016,3.4,7238,7489,251
19085,IA,Harrison,,2017,2.7,7175,7374,199
19085,IA,Harrison,,2018,2.2,7197,7361,164
19085,IA,Harrison,,2019,2.4,7259,7434,175
19085,IA,Harrison,,2020,4,6745,7026,281
19085,IA,Harrison,,2021,3.9,6755,7029,274
19087,IA,Henry,,2007,4.7,9838,10324,486
19087,IA,Henry,,2008,5.3,9635,10176,541
19087,IA,Henry,,2009,9.3,8889,9802,913
19087,IA,Henry,,2010,8.5,9099,9939,840
19087,IA,Henry,,2011,6.9,9192,9874,682
19087,IA,Henry,,2012,6,9084,9661,577
19087,IA,Henry,,2013,5.3,9055,9561,506
19087,IA,Henry,,2014,4.4,9126,9544,418
19087,IA,Henry,,2015,3.9,9225,9597,372
19087,IA,Henry,,2016,3.5,9273,9612,339
19087,IA,Henry,,2017,2.9,9478,9764,286
19087,IA,Henry,,2018,2.5,9615,9857,242
19087,IA,Henry,,2019,2.5,9753,10004,251
19087,IA,Henry,,2020,5.2,9036,9530,494
19087,IA,Henry,,2021,4.2,9104,9502,398
19089,IA,Howard,,2007,3.7,5056,5248,192
19089,IA,Howard,,2008,4.7,4980,5224,244
19089,IA,Howard,,2009,8.8,4621,5066,445
19089,IA,Howard,,2010,6.5,4985,5329,344
19089,IA,Howard,,2011,5.5,5053,5345,292
19089,IA,Howard,,2012,4.6,4979,5221,242
19089,IA,Howard,,2013,4.6,4995,5237,242
19089,IA,Howard,,2014,4,5101,5316,215
19089,IA,Howard,,2015,3.6,5185,5376,191
19089,IA,Howard,,2016,3.6,5166,5357,191
19089,IA,Howard,,2017,3,4993,5146,153
19089,IA,Howard,,2018,2.5,5128,5261,133
19089,IA,Howard,,2019,2.7,5129,5270,141
19089,IA,Howard,,2020,4.3,4914,5137,223
19089,IA,Howard,,2021,3.8,4930,5126,196
19091,IA,Humboldt,,2007,3.1,5043,5204,161
19091,IA,Humboldt,,2008,3.6,4985,5173,188
19091,IA,Humboldt,,2009,5.9,4818,5122,304
19091,IA,Humboldt,,2010,5.3,4938,5212,274
19091,IA,Humboldt,,2011,5.1,4926,5192,266
19091,IA,Humboldt,,2012,4.2,4958,5178,220
19091,IA,Humboldt,,2013,4.1,5010,5223,213
19091,IA,Humboldt,,2014,3.8,5061,5260,199
19091,IA,Humboldt,,2015,3.3,5167,5343,176
19091,IA,Humboldt,,2016,2.9,5260,5415,155
19091,IA,Humboldt,,2017,3,5152,5311,159
19091,IA,Humboldt,,2018,2.5,5134,5266,132
19091,IA,Humboldt,,2019,2.5,5093,5225,132
19091,IA,Humboldt,,2020,4.1,4769,4974,205
19091,IA,Humboldt,,2021,3.5,4775,4946,171
19093,IA,Ida,,2007,3.3,3904,4039,135
19093,IA,Ida,,2008,3.8,4047,4208,161
19093,IA,Ida,,2009,5.4,3746,3961,215
19093,IA,Ida,,2010,5.2,3637,3836,199
19093,IA,Ida,,2011,4.9,3621,3809,188
19093,IA,Ida,,2012,4,3635,3788,153
19093,IA,Ida,,2013,4,3666,3818,152
19093,IA,Ida,,2014,3.6,3751,3890,139
19093,IA,Ida,,2015,3.1,3839,3961,122
19093,IA,Ida,,2016,2.5,3944,4046,102
19093,IA,Ida,,2017,2.3,3970,4063,93
19093,IA,Ida,,2018,2,4070,4151,81
19093,IA,Ida,,2019,1.9,4132,4211,79
19093,IA,Ida,,2020,3.5,3868,4008,140
19093,IA,Ida,,2021,3.2,3852,3978,126
19095,IA,Iowa,,2007,3.7,8301,8619,318
19095,IA,Iowa,,2008,4.2,8311,8672,361
19095,IA,Iowa,,2009,7.1,7935,8543,608
19095,IA,Iowa,,2010,5.6,9096,9634,538
19095,IA,Iowa,,2011,5.1,9158,9648,490
19095,IA,Iowa,,2012,4.5,9198,9633,435
19095,IA,Iowa,,2013,4.1,9529,9941,412
19095,IA,Iowa,,2014,4.2,9781,10206,425
19095,IA,Iowa,,2015,3.5,10022,10383,361
19095,IA,Iowa,,2016,3.1,10286,10613,327
19095,IA,Iowa,,2017,2.6,10263,10534,271
19095,IA,Iowa,,2018,2.1,10360,10578,218
19095,IA,Iowa,,2019,2.1,10519,10745,226
19095,IA,Iowa,,2020,4.3,9701,10137,436
19095,IA,Iowa,,2021,3.8,9590,9966,376
19097,IA,Jackson,,2007,4.7,10662,11184,522
19097,IA,Jackson,,2008,5.1,10740,11321,581
19097,IA,Jackson,,2009,8.4,10237,11171,934
19097,IA,Jackson,,2010,7.4,10274,11090,816
19097,IA,Jackson,,2011,6.6,10311,11044,733
19097,IA,Jackson,,2012,5.5,10266,10863,597
19097,IA,Jackson,,2013,5.4,10275,10859,584
19097,IA,Jackson,,2014,5,10463,11019,556
19097,IA,Jackson,,2015,4.2,10700,11165,465
19097,IA,Jackson,,2016,4.1,10658,11119,461
19097,IA,Jackson,,2017,3.3,10621,10987,366
19097,IA,Jackson,,2018,2.8,10796,11103,307
19097,IA,Jackson,,2019,3,10890,11226,336
19097,IA,Jackson,,2020,6,10035,10670,635
19097,IA,Jackson,,2021,5,10059,10589,530
19099,IA,Jasper,,2007,6.3,16816,17956,1140
19099,IA,Jasper,,2008,7.6,16415,17764,1349
19099,IA,Jasper,,2009,8.6,16204,17724,1520
19099,IA,Jasper,,2010,7.5,17572,18992,1420
19099,IA,Jasper,,2011,6.8,17416,18693,1277
19099,IA,Jasper,,2012,6,17507,18620,1113
19099,IA,Jasper,,2013,5.1,18110,19079,969
19099,IA,Jasper,,2014,4.4,18475,19327,852
19099,IA,Jasper,,2015,3.8,18371,19105,734
19099,IA,Jasper,,2016,3.5,18665,19345,680
19099,IA,Jasper,,2017,3.1,18877,19476,599
19099,IA,Jasper,,2018,2.6,19116,19633,517
19099,IA,Jasper,,2019,2.8,19607,20171,564
19099,IA,Jasper,,2020,5.2,18323,19327,1004
19099,IA,Jasper,,2021,4.3,18299,19128,829
19101,IA,Jefferson,,2007,4.1,8033,8378,345
19101,IA,Jefferson,,2008,4.4,8074,8449,375
19101,IA,Jefferson,,2009,8.6,7513,8221,708
19101,IA,Jefferson,,2010,7.2,8290,8938,648
19101,IA,Jefferson,,2011,6.1,8316,8856,540
19101,IA,Jefferson,,2012,5.3,8333,8797,464
19101,IA,Jefferson,,2013,5,8493,8936,443
19101,IA,Jefferson,,2014,4.4,8685,9080,395
19101,IA,Jefferson,,2015,3.8,8803,9151,348
19101,IA,Jefferson,,2016,3.6,8897,9233,336
19101,IA,Jefferson,,2017,3,8953,9233,280
19101,IA,Jefferson,,2018,2.2,9643,9864,221
19101,IA,Jefferson,,2019,2.3,10011,10249,238
19101,IA,Jefferson,,2020,5.4,9337,9868,531
19101,IA,Jefferson,,2021,4.2,9435,9849,414
19103,IA,Johnson,,2007,2.7,75549,77659,2110
19103,IA,Johnson,,2008,3,77055,79427,2372
19103,IA,Johnson,,2009,4.5,76661,80234,3573
19103,IA,Johnson,,2010,4.3,75638,79040,3402
19103,IA,Johnson,,2011,4.1,76712,80001,3289
19103,IA,Johnson,,2012,3.7,77638,80618,2980
19103,IA,Johnson,,2013,3.4,80025,82852,2827
19103,IA,Johnson,,2014,3.1,81448,84034,2586
19103,IA,Johnson,,2015,2.6,81684,83898,2214
19103,IA,Johnson,,2016,2.6,82580,84759,2179
19103,IA,Johnson,,2017,2.4,84122,86226,2104
19103,IA,Johnson,,2018,1.9,85260,86935,1675
19103,IA,Johnson,,2019,1.9,86888,88580,1692
19103,IA,Johnson,,2020,4.7,81202,85204,4002
19103,IA,Johnson,,2021,3.7,81160,84310,3150
19105,IA,Jones,,2007,4.1,10029,10463,434
19105,IA,Jones,,2008,4.4,10097,10566,469
19105,IA,Jones,,2009,7.2,9943,10709,766
19105,IA,Jones,,2010,6.5,10363,11079,716
19105,IA,Jones,,2011,5.9,10315,10963,648
19105,IA,Jones,,2012,5.3,10153,10719,566
19105,IA,Jones,,2013,5.3,10176,10746,570
19105,IA,Jones,,2014,4.9,10263,10793,530
19105,IA,Jones,,2015,4.1,10335,10781,446
19105,IA,Jones,,2016,4.2,10287,10743,456
19105,IA,Jones,,2017,3.6,10237,10619,382
19105,IA,Jones,,2018,3,10407,10726,319
19105,IA,Jones,,2019,3,10561,10890,329
19105,IA,Jones,,2020,5.6,9730,10303,573
19105,IA,Jones,,2021,4.5,9728,10185,457
19107,IA,Keokuk,,2007,4.2,5398,5634,236
19107,IA,Keokuk,,2008,4.5,5395,5649,254
19107,IA,Keokuk,,2009,8,5223,5676,453
19107,IA,Keokuk,,2010,6.6,5166,5534,368
19107,IA,Keokuk,,2011,6.2,5154,5496,342
19107,IA,Keokuk,,2012,5.5,5146,5446,300
19107,IA,Keokuk,,2013,5.1,5206,5484,278
19107,IA,Keokuk,,2014,4.4,5273,5516,243
19107,IA,Keokuk,,2015,4.2,5195,5424,229
19107,IA,Keokuk,,2016,4.3,5121,5349,228
19107,IA,Keokuk,,2017,3.5,5059,5243,184
19107,IA,Keokuk,,2018,2.9,5073,5223,150
19107,IA,Keokuk,,2019,3.1,5184,5349,165
19107,IA,Keokuk,,2020,4.8,4933,5183,250
19107,IA,Keokuk,,2021,4.4,4953,5181,228
19109,IA,Kossuth,,2007,3.6,8664,8986,322
19109,IA,Kossuth,,2008,3.9,8699,9055,356
19109,IA,Kossuth,,2009,5.9,8401,8925,524
19109,IA,Kossuth,,2010,5.2,7926,8358,432
19109,IA,Kossuth,,2011,4.4,8016,8388,372
19109,IA,Kossuth,,2012,3.9,8090,8418,328
19109,IA,Kossuth,,2013,3.6,8183,8485,302
19109,IA,Kossuth,,2014,3.2,8385,8662,277
19109,IA,Kossuth,,2015,2.8,8585,8835,250
19109,IA,Kossuth,,2016,2.6,8709,8941,232
19109,IA,Kossuth,,2017,2.3,8622,8828,206
19109,IA,Kossuth,,2018,2,8457,8631,174
19109,IA,Kossuth,,2019,2.1,8427,8608,181
19109,IA,Kossuth,,2020,3.7,7865,8167,302
19109,IA,Kossuth,,2021,3.3,7824,8089,265
19111,IA,Lee,,2007,5.7,16353,17350,997
19111,IA,Lee,,2008,6.5,16350,17486,1136
19111,IA,Lee,,2009,10.2,15553,17327,1774
19111,IA,Lee,,2010,9,16108,17706,1598
19111,IA,Lee,,2011,8.2,16073,17518,1445
19111,IA,Lee,,2012,7.2,16284,17550,1266
19111,IA,Lee,,2013,7.1,15926,17149,1223
19111,IA,Lee,,2014,5.9,16691,17733,1042
19111,IA,Lee,,2015,5.3,17293,18265,972
19111,IA,Lee,,2016,6,16499,17549,1050
19111,IA,Lee,,2017,5.3,15486,16361,875
19111,IA,Lee,,2018,4,15535,16182,647
19111,IA,Lee,,2019,3.7,15801,16412,611
19111,IA,Lee,,2020,6.4,14748,15759,1011
19111,IA,Lee,,2021,5.9,14431,15340,909
19113,IA,Linn,,2007,3.7,113920,118269,4349
19113,IA,Linn,,2008,4,116538,121416,4878
19113,IA,Linn,,2009,6.1,115018,122438,7420
19113,IA,Linn,,2010,6.1,112523,119813,7290
19113,IA,Linn,,2011,5.8,112974,119906,6932
19113,IA,Linn,,2012,5.2,113117,119371,6254
19113,IA,Linn,,2013,5,113828,119830,6002
19113,IA,Linn,,2014,4.4,115706,121005,5299
19113,IA,Linn,,2015,3.8,115687,120196,4509
19113,IA,Linn,,2016,3.6,115074,119414,4340
19113,IA,Linn,,2017,3.3,115983,119930,3947
19113,IA,Linn,,2018,2.8,118622,122004,3382
19113,IA,Linn,,2019,2.8,121717,125168,3451
19113,IA,Linn,,2020,6.2,112852,120317,7465
19113,IA,Linn,,2021,5,112825,118805,5980
19115,IA,Louisa,,2007,3.7,6201,6438,237
19115,IA,Louisa,,2008,4.8,6080,6384,304
19115,IA,Louisa,,2009,8.3,5454,5946,492
19115,IA,Louisa,,2010,7.4,5510,5950,440
19115,IA,Louisa,,2011,6.2,5563,5931,368
19115,IA,Louisa,,2012,5.5,5492,5812,320
19115,IA,Louisa,,2013,5.1,5562,5858,296
19115,IA,Louisa,,2014,4.5,5667,5933,266
19115,IA,Louisa,,2015,3.8,5799,6025,226
19115,IA,Louisa,,2016,3.9,5896,6134,238
19115,IA,Louisa,,2017,3.2,5932,6129,197
19115,IA,Louisa,,2018,2.6,5980,6141,161
19115,IA,Louisa,,2019,2.9,5988,6167,179
19115,IA,Louisa,,2020,4.8,5697,5985,288
19115,IA,Louisa,,2021,4.3,5650,5903,253
19117,IA,Lucas,,2007,3.9,4594,4778,184
19117,IA,Lucas,,2008,4.1,4474,4665,191
19117,IA,Lucas,,2009,6.4,4363,4661,298
19117,IA,Lucas,,2010,6.2,3959,4221,262
19117,IA,Lucas,,2011,5.4,3977,4203,226
19117,IA,Lucas,,2012,4.8,3999,4200,201
19117,IA,Lucas,,2013,4.7,4052,4252,200
19117,IA,Lucas,,2014,3.9,4143,4311,168
19117,IA,Lucas,,2015,3.5,4248,4402,154
19117,IA,Lucas,,2016,3.1,4266,4404,138
19117,IA,Lucas,,2017,2.8,4285,4407,122
19117,IA,Lucas,,2018,2,4468,4558,90
19117,IA,Lucas,,2019,1.9,4650,4742,92
19117,IA,Lucas,,2020,3.6,4479,4645,166
19117,IA,Lucas,,2021,3.1,4463,4606,143
19119,IA,Lyon,,2007,2.4,6526,6687,161
19119,IA,Lyon,,2008,2.6,6663,6843,180
19119,IA,Lyon,,2009,4.3,6585,6880,295
19119,IA,Lyon,,2010,3.9,6135,6385,250
19119,IA,Lyon,,2011,3.2,6586,6802,216
19119,IA,Lyon,,2012,3,6657,6861,204
19119,IA,Lyon,,2013,2.9,6665,6864,199
19119,IA,Lyon,,2014,2.5,6838,7016,178
19119,IA,Lyon,,2015,2,6924,7064,140
19119,IA,Lyon,,2016,2,6981,7125,144
19119,IA,Lyon,,2017,1.7,6941,7063,122
19119,IA,Lyon,,2018,1.5,6978,7086,108
19119,IA,Lyon,,2019,1.6,7092,7205,113
19119,IA,Lyon,,2020,2.5,6720,6889,169
19119,IA,Lyon,,2021,2.3,6782,6941,159
19121,IA,Madison,,2007,4.1,7943,8286,343
19121,IA,Madison,,2008,4.8,7945,8343,398
19121,IA,Madison,,2009,6.7,7671,8225,554
19121,IA,Madison,,2010,6.5,7888,8439,551
19121,IA,Madison,,2011,6.1,7807,8310,503
19121,IA,Madison,,2012,5.6,7712,8169,457
19121,IA,Madison,,2013,5.1,7690,8101,411
19121,IA,Madison,,2014,4.5,7859,8231,372
19121,IA,Madison,,2015,3.9,7916,8235,319
19121,IA,Madison,,2016,3.5,8002,8294,292
19121,IA,Madison,,2017,3.5,8079,8376,297
19121,IA,Madison,,2018,3.2,8274,8545,271
19121,IA,Madison,,2019,3.5,8457,8762,305
19121,IA,Madison,,2020,5.6,7949,8419,470
19121,IA,Madison,,2021,4.5,8105,8486,381
19123,IA,Mahaska,,2007,3.6,11331,11758,427
19123,IA,Mahaska,,2008,4.5,11302,11836,534
19123,IA,Mahaska,,2009,8.3,10804,11779,975
19123,IA,Mahaska,,2010,6.9,11073,11891,818
19123,IA,Mahaska,,2011,5.9,11181,11886,705
19123,IA,Mahaska,,2012,5.2,11077,11685,608
19123,IA,Mahaska,,2013,4.8,11105,11667,562
19123,IA,Mahaska,,2014,4.4,11341,11860,519
19123,IA,Mahaska,,2015,3.9,11372,11836,464
19123,IA,Mahaska,,2016,3.7,11424,11859,435
19123,IA,Mahaska,,2017,3.2,11361,11731,370
19123,IA,Mahaska,,2018,2.5,11576,11869,293
19123,IA,Mahaska,,2019,2.4,11831,12121,290
19123,IA,Mahaska,,2020,4.7,11375,11930,555
19123,IA,Mahaska,,2021,3.7,11512,11953,441
19125,IA,Marion,,2007,3.6,17191,17829,638
19125,IA,Marion,,2008,4,17128,17838,710
19125,IA,Marion,,2009,6.7,16221,17380,1159
19125,IA,Marion,,2010,6,16495,17553,1058
19125,IA,Marion,,2011,5.5,16283,17236,953
19125,IA,Marion,,2012,4.8,16307,17132,825
19125,IA,Marion,,2013,4.5,16570,17342,772
19125,IA,Marion,,2014,3.8,16774,17437,663
19125,IA,Marion,,2015,3.2,16870,17435,565
19125,IA,Marion,,2016,3,17014,17538,524
19125,IA,Marion,,2017,2.6,17080,17533,453
19125,IA,Marion,,2018,2,17764,18135,371
19125,IA,Marion,,2019,2,18346,18725,379
19125,IA,Marion,,2020,4.1,17337,18077,740
19125,IA,Marion,,2021,3.1,17970,18549,579
19127,IA,Marshall,,2007,4.1,19658,20488,830
19127,IA,Marshall,,2008,5.1,19488,20534,1046
19127,IA,Marshall,,2009,7.3,18996,20496,1500
19127,IA,Marshall,,2010,7,18708,20107,1399
19127,IA,Marshall,,2011,6.7,18791,20138,1347
19127,IA,Marshall,,2012,6.4,18600,19881,1281
19127,IA,Marshall,,2013,6,18633,19825,1192
19127,IA,Marshall,,2014,5.4,18767,19833,1066
19127,IA,Marshall,,2015,5,18459,19435,976
19127,IA,Marshall,,2016,4.9,18300,19234,934
19127,IA,Marshall,,2017,4.5,17560,18390,830
19127,IA,Marshall,,2018,4.4,17474,18285,811
19127,IA,Marshall,,2019,4.3,17491,18274,783
19127,IA,Marshall,,2020,6.9,16435,17659,1224
19127,IA,Marshall,,2021,6.5,16207,17329,1122
19129,IA,Mills,,2007,3.7,7793,8093,300
19129,IA,Mills,,2008,3.6,7829,8125,296
19129,IA,Mills,,2009,4.6,7551,7914,363
19129,IA,Mills,,2010,5.3,7184,7589,405
19129,IA,Mills,,2011,5,7102,7478,376
19129,IA,Mills,,2012,4.6,6957,7294,337
19129,IA,Mills,,2013,4.4,7014,7336,322
19129,IA,Mills,,2014,4.4,7075,7398,323
19129,IA,Mills,,2015,4,7125,7425,300
19129,IA,Mills,,2016,3.6,7176,7445,269
19129,IA,Mills,,2017,2.7,7182,7382,200
19129,IA,Mills,,2018,2.1,7220,7374,154
19129,IA,Mills,,2019,2.2,7358,7525,167
19129,IA,Mills,,2020,3.9,6738,7013,275
19129,IA,Mills,,2021,3.5,6749,6992,243
19131,IA,Mitchell,,2007,3.3,5390,5576,186
19131,IA,Mitchell,,2008,4,5538,5771,233
19131,IA,Mitchell,,2009,5.9,5459,5800,341
19131,IA,Mitchell,,2010,5.3,5417,5718,301
19131,IA,Mitchell,,2011,4.8,5402,5676,274
19131,IA,Mitchell,,2012,4.6,5320,5575,255
19131,IA,Mitchell,,2013,4.3,5278,5515,237
19131,IA,Mitchell,,2014,3.6,5267,5461,194
19131,IA,Mitchell,,2015,2.8,5440,5596,156
19131,IA,Mitchell,,2016,2.6,5757,5911,154
19131,IA,Mitchell,,2017,2.1,5706,5828,122
19131,IA,Mitchell,,2018,1.8,5898,6005,107
19131,IA,Mitchell,,2019,1.6,6775,6888,113
19131,IA,Mitchell,,2020,3.3,5896,6098,202
19131,IA,Mitchell,,2021,3,5636,5812,176
19133,IA,Monona,,2007,5.5,4337,4589,252
19133,IA,Monona,,2008,5.3,4374,4621,247
19133,IA,Monona,,2009,7.5,4200,4540,340
19133,IA,Monona,,2010,7.3,4519,4877,358
19133,IA,Monona,,2011,7,4458,4796,338
19133,IA,Monona,,2012,6.4,4261,4553,292
19133,IA,Monona,,2013,5.7,4365,4630,265
19133,IA,Monona,,2014,5,4520,4756,236
19133,IA,Monona,,2015,4.3,4555,4762,207
19133,IA,Monona,,2016,4,4558,4750,192
19133,IA,Monona,,2017,3.6,4395,4558,163
19133,IA,Monona,,2018,2.7,4393,4517,124
19133,IA,Monona,,2019,2.8,4404,4531,127
19133,IA,Monona,,2020,4.6,4197,4401,204
19133,IA,Monona,,2021,4.4,4222,4416,194
19135,IA,Monroe,,2007,4.1,4006,4179,173
19135,IA,Monroe,,2008,4.4,4036,4223,187
19135,IA,Monroe,,2009,7.6,3983,4310,327
19135,IA,Monroe,,2010,7.3,3787,4087,300
19135,IA,Monroe,,2011,6.8,3775,4052,277
19135,IA,Monroe,,2012,5.8,3764,3996,232
19135,IA,Monroe,,2013,5.7,3801,4032,231
19135,IA,Monroe,,2014,5.1,3870,4076,206
19135,IA,Monroe,,2015,4.4,3860,4038,178
19135,IA,Monroe,,2016,4.6,3796,3978,182
19135,IA,Monroe,,2017,3.7,3783,3930,147
19135,IA,Monroe,,2018,2.9,3840,3956,116
19135,IA,Monroe,,2019,2.9,3982,4100,118
19135,IA,Monroe,,2020,5.1,3774,3975,201
19135,IA,Monroe,,2021,4.1,3784,3946,162
19137,IA,Montgomery,,2007,6.2,5213,5559,346
19137,IA,Montgomery,,2008,5.7,5111,5419,308
19137,IA,Montgomery,,2009,8.9,4771,5239,468
19137,IA,Montgomery,,2010,8.2,4808,5238,430
19137,IA,Montgomery,,2011,6,4754,5055,301
19137,IA,Montgomery,,2012,5.1,4794,5052,258
19137,IA,Montgomery,,2013,4.9,4878,5129,251
19137,IA,Montgomery,,2014,4.1,4950,5162,212
19137,IA,Montgomery,,2015,3.5,4989,5171,182
19137,IA,Montgomery,,2016,3.5,4959,5139,180
19137,IA,Montgomery,,2017,3.1,4845,5000,155
19137,IA,Montgomery,,2018,2.4,4877,4998,121
19137,IA,Montgomery,,2019,2.5,4963,5091,128
19137,IA,Montgomery,,2020,4.6,4667,4890,223
19137,IA,Montgomery,,2021,4.1,4679,4880,201
19139,IA,Muscatine,,2007,3.4,23205,24018,813
19139,IA,Muscatine,,2008,4.4,22931,23974,1043
19139,IA,Muscatine,,2009,8.7,21668,23730,2062
19139,IA,Muscatine,,2010,8.2,19999,21776,1777
19139,IA,Muscatine,,2011,6.7,20068,21512,1444
19139,IA,Muscatine,,2012,5.8,20099,21326,1227
19139,IA,Muscatine,,2013,5.2,20591,21725,1134
19139,IA,Muscatine,,2014,4.5,21116,22117,1001
19139,IA,Muscatine,,2015,3.8,21364,22214,850
19139,IA,Muscatine,,2016,3.8,21697,22548,851
19139,IA,Muscatine,,2017,3.2,21367,22079,712
19139,IA,Muscatine,,2018,2.6,21497,22082,585
19139,IA,Muscatine,,2019,2.7,21667,22273,606
19139,IA,Muscatine,,2020,5.8,20215,21452,1237
19139,IA,Muscatine,,2021,4.7,19890,20871,981
19141,IA,O'Brien,,2007,3,7514,7749,235
19141,IA,O'Brien,,2008,3.3,7554,7812,258
19141,IA,O'Brien,,2009,5.3,7425,7840,415
19141,IA,O'Brien,,2010,4.7,7738,8122,384
19141,IA,O'Brien,,2011,4.3,7791,8137,346
19141,IA,O'Brien,,2012,3.8,7765,8073,308
19141,IA,O'Brien,,2013,3.6,7760,8053,293
19141,IA,O'Brien,,2014,3.3,7969,8237,268
19141,IA,O'Brien,,2015,2.8,8196,8432,236
19141,IA,O'Brien,,2016,2.7,8174,8405,231
19141,IA,O'Brien,,2017,2.4,7911,8103,192
19141,IA,O'Brien,,2018,2,8065,8228,163
19141,IA,O'Brien,,2019,2,8243,8415,172
19141,IA,O'Brien,,2020,3.3,7884,8152,268
19141,IA,O'Brien,,2021,3,7837,8082,245
19143,IA,Osceola,,2007,3.3,3240,3352,112
19143,IA,Osceola,,2008,3.8,3270,3399,129
19143,IA,Osceola,,2009,6.2,3100,3304,204
19143,IA,Osceola,,2010,5,3476,3659,183
19143,IA,Osceola,,2011,4.5,3382,3543,161
19143,IA,Osceola,,2012,4.2,3256,3398,142
19143,IA,Osceola,,2013,3.8,3283,3414,131
19143,IA,Osceola,,2014,3.3,3345,3460,115
19143,IA,Osceola,,2015,2.8,3445,3545,100
19143,IA,Osceola,,2016,2.6,3566,3662,96
19143,IA,Osceola,,2017,2,3552,3626,74
19143,IA,Osceola,,2018,1.9,3502,3570,68
19143,IA,Osceola,,2019,1.8,3532,3598,66
19143,IA,Osceola,,2020,2.8,3428,3528,100
19143,IA,Osceola,,2021,2.4,3445,3530,85
19145,IA,Page,,2007,4.6,7996,8382,386
19145,IA,Page,,2008,4.8,7778,8167,389
19145,IA,Page,,2009,8.6,7145,7815,670
19145,IA,Page,,2010,6.9,6623,7116,493
19145,IA,Page,,2011,5.8,6487,6889,402
19145,IA,Page,,2012,5.4,6340,6703,363
19145,IA,Page,,2013,5.3,6216,6563,347
19145,IA,Page,,2014,4.4,6306,6598,292
19145,IA,Page,,2015,4.1,6301,6570,269
19145,IA,Page,,2016,5,6176,6498,322
19145,IA,Page,,2017,3.8,6164,6409,245
19145,IA,Page,,2018,2.5,6324,6486,162
19145,IA,Page,,2019,2.4,6350,6507,157
19145,IA,Page,,2020,4.9,5935,6239,304
19145,IA,Page,,2021,4.1,6022,6279,257
19147,IA,Palo Alto,,2007,3.4,5258,5442,184
19147,IA,Palo Alto,,2008,4.2,5220,5449,229
19147,IA,Palo Alto,,2009,7.1,4913,5288,375
19147,IA,Palo Alto,,2010,6.1,4536,4833,297
19147,IA,Palo Alto,,2011,4.8,4565,4795,230
19147,IA,Palo Alto,,2012,4.3,4571,4776,205
19147,IA,Palo Alto,,2013,3.7,4604,4783,179
19147,IA,Palo Alto,,2014,3.6,4679,4854,175
19147,IA,Palo Alto,,2015,3.1,4716,4865,149
19147,IA,Palo Alto,,2016,3.1,4839,4992,153
19147,IA,Palo Alto,,2017,2.6,4811,4941,130
19147,IA,Palo Alto,,2018,2.2,4825,4933,108
19147,IA,Palo Alto,,2019,2.1,4792,4895,103
19147,IA,Palo Alto,,2020,4.5,4377,4582,205
19147,IA,Palo Alto,,2021,3.3,4336,4486,150
19149,IA,Plymouth,,2007,3.1,14004,14445,441
19149,IA,Plymouth,,2008,3.3,13884,14360,476
19149,IA,Plymouth,,2009,4.7,13739,14410,671
19149,IA,Plymouth,,2010,4.6,13865,14527,662
19149,IA,Plymouth,,2011,4.5,13658,14307,649
19149,IA,Plymouth,,2012,4.1,13663,14248,585
19149,IA,Plymouth,,2013,4,13928,14509,581
19149,IA,Plymouth,,2014,3.4,14163,14665,502
19149,IA,Plymouth,,2015,2.8,14380,14793,413
19149,IA,Plymouth,,2016,2.5,14705,15087,382
19149,IA,Plymouth,,2017,2.3,14469,14817,348
19149,IA,Plymouth,,2018,1.9,14595,14878,283
19149,IA,Plymouth,,2019,2.1,14819,15141,322
19149,IA,Plymouth,,2020,3.5,13923,14431,508
19149,IA,Plymouth,,2021,3,14005,14441,436
19151,IA,Pocahontas,,2007,3.2,4004,4136,132
19151,IA,Pocahontas,,2008,3.1,4113,4246,133
19151,IA,Pocahontas,,2009,5.7,3871,4107,236
19151,IA,Pocahontas,,2010,5.2,3835,4045,210
19151,IA,Pocahontas,,2011,4.5,3915,4098,183
19151,IA,Pocahontas,,2012,4,4010,4179,169
19151,IA,Pocahontas,,2013,3.8,4038,4198,160
19151,IA,Pocahontas,,2014,3.5,4177,4328,151
19151,IA,Pocahontas,,2015,3,4181,4311,130
19151,IA,Pocahontas,,2016,2.8,4217,4340,123
19151,IA,Pocahontas,,2017,2.4,4114,4214,100
19151,IA,Pocahontas,,2018,1.8,4329,4409,80
19151,IA,Pocahontas,,2019,1.8,4506,4589,83
19151,IA,Pocahontas,,2020,3.4,4097,4242,145
19151,IA,Pocahontas,,2021,3.1,4099,4228,129
19153,IA,Polk,,2007,3.5,229474,237788,8314
19153,IA,Polk,,2008,4,231688,241374,9686
19153,IA,Polk,,2009,6.1,227606,242474,14868
19153,IA,Polk,,2010,6.1,229491,244314,14823
19153,IA,Polk,,2011,5.8,229969,244046,14077
19153,IA,Polk,,2012,5.2,232379,245132,12753
19153,IA,Polk,,2013,4.8,238664,250729,12065
19153,IA,Polk,,2014,4.2,244872,255659,10787
19153,IA,Polk,,2015,3.6,246352,255669,9317
19153,IA,Polk,,2016,3.4,249790,258689,8899
19153,IA,Polk,,2017,3,254702,262617,7915
19153,IA,Polk,,2018,2.6,261016,267870,6854
19153,IA,Polk,,2019,2.7,267525,274940,7415
19153,IA,Polk,,2020,5.9,250540,266206,15666
19153,IA,Polk,,2021,4.5,255823,267873,12050
19155,IA,Pottawattamie,,2007,4.3,46111,48163,2052
19155,IA,Pottawattamie,,2008,4.2,46651,48693,2042
19155,IA,Pottawattamie,,2009,5.1,45622,48075,2453
19155,IA,Pottawattamie,,2010,5.9,47261,50212,2951
19155,IA,Pottawattamie,,2011,5.7,46925,49755,2830
19155,IA,Pottawattamie,,2012,5.1,46186,48657,2471
19155,IA,Pottawattamie,,2013,4.6,46470,48696,2226
19155,IA,Pottawattamie,,2014,4.3,47086,49193,2107
19155,IA,Pottawattamie,,2015,3.6,47227,49001,1774
19155,IA,Pottawattamie,,2016,3.4,46887,48517,1630
19155,IA,Pottawattamie,,2017,2.7,46692,48011,1319
19155,IA,Pottawattamie,,2018,2.3,47222,48357,1135
19155,IA,Pottawattamie,,2019,2.3,47929,49077,1148
19155,IA,Pottawattamie,,2020,5.2,44961,47408,2447
19155,IA,Pottawattamie,,2021,4.3,45036,47038,2002
19157,IA,Poweshiek,,2007,3.9,10336,10758,422
19157,IA,Poweshiek,,2008,4.5,10028,10503,475
19157,IA,Poweshiek,,2009,6.8,9539,10237,698
19157,IA,Poweshiek,,2010,5.9,9922,10543,621
19157,IA,Poweshiek,,2011,5.7,9850,10442,592
19157,IA,Poweshiek,,2012,4.9,9700,10199,499
19157,IA,Poweshiek,,2013,4.6,9878,10358,480
19157,IA,Poweshiek,,2014,4.2,9964,10406,442
19157,IA,Poweshiek,,2015,3.6,10134,10510,376
19157,IA,Poweshiek,,2016,3.4,10122,10478,356
19157,IA,Poweshiek,,2017,3.1,10194,10517,323
19157,IA,Poweshiek,,2018,2.3,10364,10613,249
19157,IA,Poweshiek,,2019,2.5,10301,10566,265
19157,IA,Poweshiek,,2020,4.8,9360,9832,472
19157,IA,Poweshiek,,2021,4.4,9586,10031,445
19159,IA,Ringgold,,2007,4.2,2355,2457,102
19159,IA,Ringgold,,2008,4.5,2320,2430,110
19159,IA,Ringgold,,2009,5.5,2303,2438,135
19159,IA,Ringgold,,2010,4.8,2483,2608,125
19159,IA,Ringgold,,2011,4.7,2489,2611,122
19159,IA,Ringgold,,2012,4.4,2435,2548,113
19159,IA,Ringgold,,2013,4.3,2410,2518,108
19159,IA,Ringgold,,2014,3.8,2434,2531,97
19159,IA,Ringgold,,2015,3.3,2482,2567,85
19159,IA,Ringgold,,2016,3.5,2530,2621,91
19159,IA,Ringgold,,2017,3,2497,2575,78
19159,IA,Ringgold,,2018,2.8,2491,2562,71
19159,IA,Ringgold,,2019,2.8,2439,2508,69
19159,IA,Ringgold,,2020,3.8,2298,2388,90
19159,IA,Ringgold,,2021,3.4,2303,2383,80
19161,IA,Sac,,2007,3.4,5603,5803,200
19161,IA,Sac,,2008,3.7,5579,5793,214
19161,IA,Sac,,2009,5.1,5471,5764,293
19161,IA,Sac,,2010,4.8,5429,5700,271
19161,IA,Sac,,2011,4.5,5387,5641,254
19161,IA,Sac,,2012,4.3,5290,5525,235
19161,IA,Sac,,2013,4.2,5290,5522,232
19161,IA,Sac,,2014,3.9,5339,5557,218
19161,IA,Sac,,2015,3.3,5456,5642,186
19161,IA,Sac,,2016,3,5359,5523,164
19161,IA,Sac,,2017,2.8,5243,5393,150
19161,IA,Sac,,2018,2.3,5244,5370,126
19161,IA,Sac,,2019,2.2,5285,5406,121
19161,IA,Sac,,2020,3.5,5026,5206,180
19161,IA,Sac,,2021,3.3,5036,5209,173
19163,IA,Scott,,2007,3.8,85615,88952,3337
19163,IA,Scott,,2008,4.2,86809,90614,3805
19163,IA,Scott,,2009,7.1,83653,90024,6371
19163,IA,Scott,,2010,6.7,81133,87001,5868
19163,IA,Scott,,2011,6.2,82023,87484,5461
19163,IA,Scott,,2012,5.7,82565,87600,5035
19163,IA,Scott,,2013,5.6,83316,88245,4929
19163,IA,Scott,,2014,5.2,84265,88865,4600
19163,IA,Scott,,2015,4.6,83842,87907,4065
19163,IA,Scott,,2016,4.5,83275,87175,3900
19163,IA,Scott,,2017,3.6,84102,87229,3127
19163,IA,Scott,,2018,2.9,86193,88802,2609
19163,IA,Scott,,2019,3.2,88287,91161,2874
19163,IA,Scott,,2020,6.6,81621,87409,5788
19163,IA,Scott,,2021,5.4,82382,87116,4734
19165,IA,Shelby,,2007,3.2,7300,7545,245
19165,IA,Shelby,,2008,3,7370,7600,230
19165,IA,Shelby,,2009,4,7251,7554,303
19165,IA,Shelby,,2010,4.6,6288,6593,305
19165,IA,Shelby,,2011,4.4,6448,6744,296
19165,IA,Shelby,,2012,3.8,6754,7019,265
19165,IA,Shelby,,2013,3.8,6689,6950,261
19165,IA,Shelby,,2014,3.1,6833,7053,220
19165,IA,Shelby,,2015,2.8,6821,7020,199
19165,IA,Shelby,,2016,2.9,6659,6859,200
19165,IA,Shelby,,2017,2.3,6586,6744,158
19165,IA,Shelby,,2018,2,6613,6747,134
19165,IA,Shelby,,2019,2,6665,6802,137
19165,IA,Shelby,,2020,3.5,6165,6390,225
19165,IA,Shelby,,2021,3.2,6124,6327,203
19167,IA,Sioux,,2007,2.5,18864,19355,491
19167,IA,Sioux,,2008,2.8,19213,19766,553
19167,IA,Sioux,,2009,4.4,18747,19600,853
19167,IA,Sioux,,2010,4,18831,19613,782
19167,IA,Sioux,,2011,3.8,18873,19609,736
19167,IA,Sioux,,2012,3.5,18778,19452,674
19167,IA,Sioux,,2013,3.5,18916,19593,677
19167,IA,Sioux,,2014,2.9,19544,20134,590
19167,IA,Sioux,,2015,2.4,20258,20763,505
19167,IA,Sioux,,2016,2.3,20323,20796,473
19167,IA,Sioux,,2017,2,20146,20552,406
19167,IA,Sioux,,2018,1.8,20418,20788,370
19167,IA,Sioux,,2019,1.8,21134,21517,383
19167,IA,Sioux,,2020,2.6,20761,21310,549
19167,IA,Sioux,,2021,2.4,21276,21797,521
19169,IA,Story,,2007,2.8,46748,48087,1339
19169,IA,Story,,2008,3.1,47372,48911,1539
19169,IA,Story,,2009,4.7,46733,49059,2326
19169,IA,Story,,2010,4.3,50916,53189,2273
19169,IA,Story,,2011,4,51283,53428,2145
19169,IA,Story,,2012,3.6,51624,53543,1919
19169,IA,Story,,2013,3.3,52998,54826,1828
19169,IA,Story,,2014,2.9,54999,56632,1633
19169,IA,Story,,2015,2.5,56019,57440,1421
19169,IA,Story,,2016,2.3,55939,57270,1331
19169,IA,Story,,2017,2,56779,57909,1130
19169,IA,Story,,2018,1.6,57780,58714,934
19169,IA,Story,,2019,1.7,58409,59442,1033
19169,IA,Story,,2020,3.5,55080,57091,2011
19169,IA,Story,,2021,3,55683,57384,1701
19171,IA,Tama,,2007,4.3,8600,8990,390
19171,IA,Tama,,2008,5.3,8482,8954,472
19171,IA,Tama,,2009,7.2,8275,8919,644
19171,IA,Tama,,2010,6.5,8723,9334,611
19171,IA,Tama,,2011,6.2,8657,9230,573
19171,IA,Tama,,2012,6,8576,9126,550
19171,IA,Tama,,2013,5.6,8613,9120,507
19171,IA,Tama,,2014,5.3,8752,9238,486
19171,IA,Tama,,2015,4.3,9251,9668,417
19171,IA,Tama,,2016,4.1,9411,9818,407
19171,IA,Tama,,2017,3.4,9347,9677,330
19171,IA,Tama,,2018,3,9336,9621,285
19171,IA,Tama,,2019,2.9,9407,9692,285
19171,IA,Tama,,2020,5,8828,9295,467
19171,IA,Tama,,2021,4.7,8719,9146,427
19173,IA,Taylor,,2007,4,3224,3360,136
19173,IA,Taylor,,2008,4,3241,3376,135
19173,IA,Taylor,,2009,6.9,3126,3356,230
19173,IA,Taylor,,2010,5.7,3001,3182,181
19173,IA,Taylor,,2011,4.8,3012,3165,153
19173,IA,Taylor,,2012,4.1,3026,3156,130
19173,IA,Taylor,,2013,3.8,3050,3172,122
19173,IA,Taylor,,2014,3.7,3124,3243,119
19173,IA,Taylor,,2015,3.1,3138,3240,102
19173,IA,Taylor,,2016,2.9,3152,3247,95
19173,IA,Taylor,,2017,2.2,3196,3267,71
19173,IA,Taylor,,2018,2,3218,3282,64
19173,IA,Taylor,,2019,1.8,3192,3250,58
19173,IA,Taylor,,2020,3.6,2984,3094,110
19173,IA,Taylor,,2021,3.1,3003,3100,97
19175,IA,Union,,2007,4.1,6316,6585,269
19175,IA,Union,,2008,4.5,6417,6721,304
19175,IA,Union,,2009,6.6,6436,6890,454
19175,IA,Union,,2010,5.7,6599,7001,402
19175,IA,Union,,2011,5.4,6614,6988,374
19175,IA,Union,,2012,5.1,6531,6880,349
19175,IA,Union,,2013,4.9,6568,6905,337
19175,IA,Union,,2014,4.7,6495,6815,320
19175,IA,Union,,2015,4.1,6304,6576,272
19175,IA,Union,,2016,3.8,6302,6549,247
19175,IA,Union,,2017,3.1,6292,6491,199
19175,IA,Union,,2018,3.5,6233,6462,229
19175,IA,Union,,2019,3.1,6217,6413,196
19175,IA,Union,,2020,5.7,5850,6204,354
19175,IA,Union,,2021,4.5,5817,6088,271
19177,IA,Van Buren,,2007,4.3,3786,3955,169
19177,IA,Van Buren,,2008,4.8,3766,3957,191
19177,IA,Van Buren,,2009,8.8,3490,3827,337
19177,IA,Van Buren,,2010,7.4,3669,3964,295
19177,IA,Van Buren,,2011,6.4,3618,3867,249
19177,IA,Van Buren,,2012,5.8,3593,3814,221
19177,IA,Van Buren,,2013,5.5,3627,3838,211
19177,IA,Van Buren,,2014,4.5,3738,3915,177
19177,IA,Van Buren,,2015,4,3687,3841,154
19177,IA,Van Buren,,2016,3.6,3739,3880,141
19177,IA,Van Buren,,2017,3,3644,3757,113
19177,IA,Van Buren,,2018,2.7,3666,3766,100
19177,IA,Van Buren,,2019,2.6,3644,3740,96
19177,IA,Van Buren,,2020,4.5,3529,3694,165
19177,IA,Van Buren,,2021,3.8,3489,3626,137
19179,IA,Wapello,,2007,4.3,18047,18867,820
19179,IA,Wapello,,2008,5,17967,18907,940
19179,IA,Wapello,,2009,8.7,17148,18792,1644
19179,IA,Wapello,,2010,8.1,16990,18480,1490
19179,IA,Wapello,,2011,7.3,16877,18209,1332
19179,IA,Wapello,,2012,7,16712,17967,1255
19179,IA,Wapello,,2013,6.3,17009,18158,1149
19179,IA,Wapello,,2014,5.5,17147,18142,995
19179,IA,Wapello,,2015,5.1,17090,18008,918
19179,IA,Wapello,,2016,5.7,16949,17981,1032
19179,IA,Wapello,,2017,4.5,17007,17800,793
19179,IA,Wapello,,2018,3.4,17312,17924,612
19179,IA,Wapello,,2019,3.5,17469,18098,629
19179,IA,Wapello,,2020,5.8,16440,17461,1021
19179,IA,Wapello,,2021,5,16117,16957,840
19181,IA,Warren,,2007,3.3,24662,25497,835
19181,IA,Warren,,2008,3.8,24829,25799,970
19181,IA,Warren,,2009,5.9,24241,25754,1513
19181,IA,Warren,,2010,5.7,24778,26286,1508
19181,IA,Warren,,2011,5.3,24689,26064,1375
19181,IA,Warren,,2012,4.8,24744,25989,1245
19181,IA,Warren,,2013,4.5,25189,26374,1185
19181,IA,Warren,,2014,4,25714,26772,1058
19181,IA,Warren,,2015,3.4,25805,26711,906
19181,IA,Warren,,2016,3.2,26388,27252,864
19181,IA,Warren,,2017,2.7,26710,27454,744
19181,IA,Warren,,2018,2.3,27545,28189,644
19181,IA,Warren,,2019,2.4,28284,28982,698
19181,IA,Warren,,2020,4.4,26685,27926,1241
19181,IA,Warren,,2021,3.7,27235,28292,1057
19183,IA,Washington,,2007,3.4,11545,11954,409
19183,IA,Washington,,2008,4,11553,12039,486
19183,IA,Washington,,2009,5.6,11193,11851,658
19183,IA,Washington,,2010,5.2,11745,12387,642
19183,IA,Washington,,2011,4.8,11775,12365,590
19183,IA,Washington,,2012,4.2,11684,12199,515
19183,IA,Washington,,2013,3.8,11826,12289,463
19183,IA,Washington,,2014,3.6,11881,12323,442
19183,IA,Washington,,2015,3.1,12009,12392,383
19183,IA,Washington,,2016,2.9,12060,12421,361
19183,IA,Washington,,2017,2.9,11992,12348,356
19183,IA,Washington,,2018,2.4,11855,12142,287
19183,IA,Washington,,2019,2.4,11952,12240,288
19183,IA,Washington,,2020,4,11023,11484,461
19183,IA,Washington,,2021,3.8,11016,11446,430
19185,IA,Wayne,,2007,4.5,3065,3211,146
19185,IA,Wayne,,2008,4.2,3116,3251,135
19185,IA,Wayne,,2009,6.3,3013,3216,203
19185,IA,Wayne,,2010,6.3,2689,2869,180
19185,IA,Wayne,,2011,5.6,2676,2836,160
19185,IA,Wayne,,2012,5.5,2651,2804,153
19185,IA,Wayne,,2013,5.2,2706,2854,148
19185,IA,Wayne,,2014,5,2728,2872,144
19185,IA,Wayne,,2015,3.9,2739,2850,111
19185,IA,Wayne,,2016,3.7,2749,2856,107
19185,IA,Wayne,,2017,3,2718,2803,85
19185,IA,Wayne,,2018,2.7,2731,2808,77
19185,IA,Wayne,,2019,2.5,2803,2875,72
19185,IA,Wayne,,2020,4.3,2686,2808,122
19185,IA,Wayne,,2021,3.7,2714,2817,103
19187,IA,Webster,,2007,4,19059,19848,789
19187,IA,Webster,,2008,4.3,19226,20093,867
19187,IA,Webster,,2009,7.4,18238,19699,1461
19187,IA,Webster,,2010,7.1,18678,20100,1422
19187,IA,Webster,,2011,7.1,18458,19871,1413
19187,IA,Webster,,2012,6.4,18129,19360,1231
19187,IA,Webster,,2013,5.3,18730,19784,1054
19187,IA,Webster,,2014,4.8,18870,19827,957
19187,IA,Webster,,2015,4.3,19483,20353,870
19187,IA,Webster,,2016,4,19725,20538,813
19187,IA,Webster,,2017,3.7,18833,19551,718
19187,IA,Webster,,2018,3.2,18802,19433,631
19187,IA,Webster,,2019,3,19228,19813,585
19187,IA,Webster,,2020,5.1,17815,18779,964
19187,IA,Webster,,2021,4.6,17617,18473,856
19189,IA,Winnebago,,2007,3.5,5572,5772,200
19189,IA,Winnebago,,2008,6.4,5553,5931,378
19189,IA,Winnebago,,2009,9.4,5195,5735,540
19189,IA,Winnebago,,2010,6.8,5411,5807,396
19189,IA,Winnebago,,2011,6.1,5133,5469,336
19189,IA,Winnebago,,2012,5.4,4862,5138,276
19189,IA,Winnebago,,2013,4.8,4925,5173,248
19189,IA,Winnebago,,2014,4.2,5005,5225,220
19189,IA,Winnebago,,2015,3.9,4967,5170,203
19189,IA,Winnebago,,2016,3.4,5046,5226,180
19189,IA,Winnebago,,2017,3.1,5049,5211,162
19189,IA,Winnebago,,2018,2.6,4941,5071,130
19189,IA,Winnebago,,2019,2.6,5083,5220,137
19189,IA,Winnebago,,2020,6.2,4761,5077,316
19189,IA,Winnebago,,2021,4.2,4741,4949,208
19191,IA,Winneshiek,,2007,3.6,11982,12435,453
19191,IA,Winneshiek,,2008,4.3,11878,12410,532
19191,IA,Winneshiek,,2009,6.3,11430,12192,762
19191,IA,Winneshiek,,2010,5.6,11573,12262,689
19191,IA,Winneshiek,,2011,5.1,11548,12164,616
19191,IA,Winneshiek,,2012,4.6,11382,11934,552
19191,IA,Winneshiek,,2013,4.6,11355,11906,551
19191,IA,Winneshiek,,2014,4.2,11549,12060,511
19191,IA,Winneshiek,,2015,3.6,11785,12229,444
19191,IA,Winneshiek,,2016,3.5,11702,12125,423
19191,IA,Winneshiek,,2017,3,11596,11957,361
19191,IA,Winneshiek,,2018,2.7,11639,11957,318
19191,IA,Winneshiek,,2019,2.7,11824,12155,331
19191,IA,Winneshiek,,2020,4.8,10666,11200,534
19191,IA,Winneshiek,,2021,4.1,10913,11385,472
19193,IA,Woodbury,,2007,3.9,52787,54925,2138
19193,IA,Woodbury,,2008,3.8,53891,56027,2136
19193,IA,Woodbury,,2009,5.7,52487,55653,3166
19193,IA,Woodbury,,2010,6.7,52119,55861,3742
19193,IA,Woodbury,,2011,5.8,51601,54800,3199
19193,IA,Woodbury,,2012,5.2,51644,54503,2859
19193,IA,Woodbury,,2013,4.8,52641,55288,2647
19193,IA,Woodbury,,2014,4.4,53508,55956,2448
19193,IA,Woodbury,,2015,3.7,54099,56200,2101
19193,IA,Woodbury,,2016,3.5,54065,56044,1979
19193,IA,Woodbury,,2017,3.1,53219,54932,1713
19193,IA,Woodbury,,2018,2.5,54403,55799,1396
19193,IA,Woodbury,,2019,2.6,55538,57005,1467
19193,IA,Woodbury,,2020,5.1,52079,54904,2825
19193,IA,Woodbury,,2021,4.3,52431,54789,2358
19195,IA,Worth,,2007,3.7,4359,4528,169
19195,IA,Worth,,2008,5.2,4346,4583,237
19195,IA,Worth,,2009,7.1,4139,4457,318
19195,IA,Worth,,2010,7.4,4012,4332,320
19195,IA,Worth,,2011,6.5,4027,4307,280
19195,IA,Worth,,2012,5.5,4006,4238,232
19195,IA,Worth,,2013,5.2,3974,4190,216
19195,IA,Worth,,2014,4.5,4014,4204,190
19195,IA,Worth,,2015,3.9,4061,4228,167
19195,IA,Worth,,2016,3.4,4146,4292,146
19195,IA,Worth,,2017,3,4118,4244,126
19195,IA,Worth,,2018,2.7,4112,4227,115
19195,IA,Worth,,2019,2.7,4162,4276,114
19195,IA,Worth,,2020,5.2,3899,4115,216
19195,IA,Worth,,2021,4.2,3846,4016,170
19197,IA,Wright,,2007,3.9,6734,7009,275
19197,IA,Wright,,2008,4.4,6811,7125,314
19197,IA,Wright,,2009,7.4,6488,7004,516
19197,IA,Wright,,2010,7.3,6342,6840,498
19197,IA,Wright,,2011,7,6343,6819,476
19197,IA,Wright,,2012,5.4,6452,6819,367
19197,IA,Wright,,2013,4.5,6547,6854,307
19197,IA,Wright,,2014,4.1,6667,6951,284
19197,IA,Wright,,2015,3.9,6641,6908,267
19197,IA,Wright,,2016,4.1,6452,6726,274
19197,IA,Wright,,2017,3.4,6368,6591,223
19197,IA,Wright,,2018,2.6,6385,6554,169
19197,IA,Wright,,2019,2.4,6934,7107,173
19197,IA,Wright,,2020,3.9,6747,7019,272
19197,IA,Wright,,2021,4.1,6402,6679,277
20000,KS,Kansas,,2007,4.3,1422109,1485414,63305
20000,KS,Kansas,,2008,4.6,1425022,1493365,68343
20000,KS,Kansas,,2009,6.9,1408142,1512572,104430
20000,KS,Kansas,,2010,7,1396172,1500463,104291
20000,KS,Kansas,,2011,6.4,1402198,1498000,95802
20000,KS,Kansas,,2012,5.7,1405638,1490808,85170
20000,KS,Kansas,,2013,5.3,1410470,1489395,78925
20000,KS,Kansas,,2014,4.5,1426892,1494203,67311
20000,KS,Kansas,,2015,4.2,1431533,1493782,62249
20000,KS,Kansas,,2016,4,1431920,1491961,60041
20000,KS,Kansas,,2017,3.6,1434516,1488346,53830
20000,KS,Kansas,,2018,3.3,1439329,1488027,48698
20000,KS,Kansas,,2019,3.1,1450705,1497517,46812
20000,KS,Kansas,,2020,5.7,1408965,1493706,84741
20000,KS,Kansas,,2021,3.2,1447323,1495665,48342
20001,KS,Allen,,2007,4.1,7202,7507,305
20001,KS,Allen,,2008,4.5,7041,7376,335
20001,KS,Allen,,2009,7.9,6919,7509,590
20001,KS,Allen,,2010,8.1,6434,7003,569
20001,KS,Allen,,2011,7.9,6505,7062,557
20001,KS,Allen,,2012,7.1,6397,6888,491
20001,KS,Allen,,2013,6.1,6486,6906,420
20001,KS,Allen,,2014,5,6473,6817,344
20001,KS,Allen,,2015,5.1,6284,6623,339
20001,KS,Allen,,2016,5.6,6108,6467,359
20001,KS,Allen,,2017,4.8,6017,6322,305
20001,KS,Allen,,2018,3.9,6119,6367,248
20001,KS,Allen,,2019,3.5,6260,6486,226
20001,KS,Allen,,2020,5.2,6061,6394,333
20001,KS,Allen,,2021,3,6326,6524,198
20003,KS,Anderson,,2007,4.7,3953,4149,196
20003,KS,Anderson,,2008,4.8,4114,4321,207
20003,KS,Anderson,,2009,7.7,4123,4465,342
20003,KS,Anderson,,2010,7.6,4224,4572,348
20003,KS,Anderson,,2011,7.5,4172,4510,338
20003,KS,Anderson,,2012,6.5,4035,4316,281
20003,KS,Anderson,,2013,5.8,4002,4249,247
20003,KS,Anderson,,2014,5.1,3978,4193,215
20003,KS,Anderson,,2015,4.8,3945,4144,199
20003,KS,Anderson,,2016,4.3,4014,4193,179
20003,KS,Anderson,,2017,3.9,4015,4178,163
20003,KS,Anderson,,2018,3.4,4001,4141,140
20003,KS,Anderson,,2019,3.2,4070,4206,136
20003,KS,Anderson,,2020,3.9,4114,4283,169
20003,KS,Anderson,,2021,2.5,4540,4655,115
20005,KS,Atchison,,2007,4.6,8386,8793,407
20005,KS,Atchison,,2008,4.6,8413,8817,404
20005,KS,Atchison,,2009,9.2,8013,8829,816
20005,KS,Atchison,,2010,9.7,7160,7933,773
20005,KS,Atchison,,2011,8.9,7251,7960,709
20005,KS,Atchison,,2012,7.7,7257,7864,607
20005,KS,Atchison,,2013,8.6,7126,7794,668
20005,KS,Atchison,,2014,6.5,7150,7643,493
20005,KS,Atchison,,2015,6.1,7031,7490,459
20005,KS,Atchison,,2016,6.2,6639,7078,439
20005,KS,Atchison,,2017,5.2,6708,7074,366
20005,KS,Atchison,,2018,4.5,6728,7044,316
20005,KS,Atchison,,2019,5.1,6676,7035,359
20005,KS,Atchison,,2020,6.6,6400,6851,451
20005,KS,Atchison,,2021,3.8,6485,6742,257
20007,KS,Barber,,2007,3.2,2537,2622,85
20007,KS,Barber,,2008,3.3,2654,2744,90
20007,KS,Barber,,2009,4.5,2780,2910,130
20007,KS,Barber,,2010,4.5,2646,2770,124
20007,KS,Barber,,2011,3.9,2682,2792,110
20007,KS,Barber,,2012,3.9,2634,2740,106
20007,KS,Barber,,2013,4,2657,2768,111
20007,KS,Barber,,2014,3.1,2637,2720,83
20007,KS,Barber,,2015,4.2,2556,2669,113
20007,KS,Barber,,2016,3.7,2445,2538,93
20007,KS,Barber,,2017,2.8,2394,2463,69
20007,KS,Barber,,2018,2.5,2335,2394,59
20007,KS,Barber,,2019,2.4,2273,2330,57
20007,KS,Barber,,2020,3.1,2240,2312,72
20007,KS,Barber,,2021,1.9,2257,2301,44
20009,KS,Barton,,2007,3.5,14367,14888,521
20009,KS,Barton,,2008,3.3,15047,15560,513
20009,KS,Barton,,2009,5.7,15082,15987,905
20009,KS,Barton,,2010,5.9,14113,15002,889
20009,KS,Barton,,2011,5.1,14335,15110,775
20009,KS,Barton,,2012,4.5,14345,15020,675
20009,KS,Barton,,2013,4.1,14519,15133,614
20009,KS,Barton,,2014,3.5,14936,15482,546
20009,KS,Barton,,2015,4.2,14013,14629,616
20009,KS,Barton,,2016,4.5,13457,14087,630
20009,KS,Barton,,2017,3.6,13624,14132,508
20009,KS,Barton,,2018,3.2,13173,13602,429
20009,KS,Barton,,2019,3.1,13288,13707,419
20009,KS,Barton,,2020,4.4,13032,13638,606
20009,KS,Barton,,2021,2.9,12983,13371,388
20011,KS,Bourbon,,2007,4.4,8475,8869,394
20011,KS,Bourbon,,2008,4.8,8072,8481,409
20011,KS,Bourbon,,2009,7,8148,8761,613
20011,KS,Bourbon,,2010,8.9,6577,7219,642
20011,KS,Bourbon,,2011,8.8,6296,6906,610
20011,KS,Bourbon,,2012,7.6,6224,6739,515
20011,KS,Bourbon,,2013,6.5,6438,6884,446
20011,KS,Bourbon,,2014,5.2,6734,7105,371
20011,KS,Bourbon,,2015,4.8,6796,7138,342
20011,KS,Bourbon,,2016,4.8,6813,7160,347
20011,KS,Bourbon,,2017,4.4,6750,7060,310
20011,KS,Bourbon,,2018,4.1,6835,7126,291
20011,KS,Bourbon,,2019,4.2,6458,6740,282
20011,KS,Bourbon,,2020,5.5,6319,6690,371
20011,KS,Bourbon,,2021,3.7,6272,6513,241
20013,KS,Brown,,2007,4.1,5288,5516,228
20013,KS,Brown,,2008,4.3,5295,5535,240
20013,KS,Brown,,2009,5.7,5558,5892,334
20013,KS,Brown,,2010,6.6,4922,5267,345
20013,KS,Brown,,2011,5.9,4905,5211,306
20013,KS,Brown,,2012,5.3,4975,5256,281
20013,KS,Brown,,2013,5,5193,5467,274
20013,KS,Brown,,2014,4.1,5196,5416,220
20013,KS,Brown,,2015,4,5156,5370,214
20013,KS,Brown,,2016,3.6,5001,5189,188
20013,KS,Brown,,2017,3.2,5189,5360,171
20013,KS,Brown,,2018,3,5237,5397,160
20013,KS,Brown,,2019,3.1,5217,5384,167
20013,KS,Brown,,2020,4.3,4917,5138,221
20013,KS,Brown,,2021,2.7,5006,5143,137
20015,KS,Butler,,2007,4.1,31111,32457,1346
20015,KS,Butler,,2008,4.4,31174,32603,1429
20015,KS,Butler,,2009,7.4,30188,32594,2406
20015,KS,Butler,,2010,7.7,30473,32998,2525
20015,KS,Butler,,2011,6.9,30346,32591,2245
20015,KS,Butler,,2012,6.2,30120,32114,1994
20015,KS,Butler,,2013,5.5,30132,31897,1765
20015,KS,Butler,,2014,4.8,30448,31996,1548
20015,KS,Butler,,2015,4.3,30752,32119,1367
20015,KS,Butler,,2016,4.2,30994,32340,1346
20015,KS,Butler,,2017,3.7,30680,31875,1195
20015,KS,Butler,,2018,3.4,31054,32131,1077
20015,KS,Butler,,2019,3.2,31713,32755,1042
20015,KS,Butler,,2020,6.4,30314,32383,2069
20015,KS,Butler,,2021,3.5,31315,32456,1141
20017,KS,Chase,,2007,4,1522,1586,64
20017,KS,Chase,,2008,4.1,1402,1462,60
20017,KS,Chase,,2009,5.3,1459,1541,82
20017,KS,Chase,,2010,5.5,1362,1442,80
20017,KS,Chase,,2011,5.4,1272,1344,72
20017,KS,Chase,,2012,5.3,1260,1330,70
20017,KS,Chase,,2013,5.6,1183,1253,70
20017,KS,Chase,,2014,4.1,1184,1234,50
20017,KS,Chase,,2015,3.6,1210,1255,45
20017,KS,Chase,,2016,3.5,1364,1413,49
20017,KS,Chase,,2017,2.6,1398,1435,37
20017,KS,Chase,,2018,2.6,1436,1474,38
20017,KS,Chase,,2019,2.7,1502,1544,42
20017,KS,Chase,,2020,5.3,1375,1452,77
20017,KS,Chase,,2021,2.4,1352,1385,33
20019,KS,Chautauqua,,2007,4.8,1699,1784,85
20019,KS,Chautauqua,,2008,4.5,1768,1852,84
20019,KS,Chautauqua,,2009,8.8,1697,1861,164
20019,KS,Chautauqua,,2010,8.9,1584,1739,155
20019,KS,Chautauqua,,2011,8.1,1568,1706,138
20019,KS,Chautauqua,,2012,6.5,1590,1701,111
20019,KS,Chautauqua,,2013,6.2,1523,1623,100
20019,KS,Chautauqua,,2014,5.4,1494,1579,85
20019,KS,Chautauqua,,2015,5.7,1467,1556,89
20019,KS,Chautauqua,,2016,5.2,1467,1547,80
20019,KS,Chautauqua,,2017,4.7,1385,1453,68
20019,KS,Chautauqua,,2018,3.9,1367,1422,55
20019,KS,Chautauqua,,2019,3.7,1388,1442,54
20019,KS,Chautauqua,,2020,5.9,1391,1479,88
20019,KS,Chautauqua,,2021,4,1399,1458,59
20021,KS,Cherokee,,2007,4.9,10577,11123,546
20021,KS,Cherokee,,2008,5.2,10586,11162,576
20021,KS,Cherokee,,2009,8.4,10587,11564,977
20021,KS,Cherokee,,2010,9,9826,10796,970
20021,KS,Cherokee,,2011,8,9982,10851,869
20021,KS,Cherokee,,2012,7.8,9783,10611,828
20021,KS,Cherokee,,2013,6.4,9851,10523,672
20021,KS,Cherokee,,2014,5,9848,10366,518
20021,KS,Cherokee,,2015,4.4,9978,10441,463
20021,KS,Cherokee,,2016,4.4,9879,10336,457
20021,KS,Cherokee,,2017,3.9,9774,10169,395
20021,KS,Cherokee,,2018,3.6,9720,10087,367
20021,KS,Cherokee,,2019,3.4,9842,10188,346
20021,KS,Cherokee,,2020,5.1,9469,9974,505
20021,KS,Cherokee,,2021,2.9,9617,9907,290
20023,KS,Cheyenne,,2007,3.5,1367,1417,50
20023,KS,Cheyenne,,2008,3.1,1423,1469,46
20023,KS,Cheyenne,,2009,3.5,1470,1524,54
20023,KS,Cheyenne,,2010,4,1349,1405,56
20023,KS,Cheyenne,,2011,4.3,1296,1354,58
20023,KS,Cheyenne,,2012,3.6,1287,1335,48
20023,KS,Cheyenne,,2013,3.4,1267,1312,45
20023,KS,Cheyenne,,2014,3.1,1276,1317,41
20023,KS,Cheyenne,,2015,2.7,1324,1361,37
20023,KS,Cheyenne,,2016,2.8,1313,1351,38
20023,KS,Cheyenne,,2017,2.6,1287,1321,34
20023,KS,Cheyenne,,2018,2.3,1287,1317,30
20023,KS,Cheyenne,,2019,2.4,1282,1313,31
20023,KS,Cheyenne,,2020,2.2,1274,1302,28
20023,KS,Cheyenne,,2021,1.8,1276,1299,23
20025,KS,Clark,,2007,3.1,1171,1208,37
20025,KS,Clark,,2008,3.1,1207,1246,39
20025,KS,Clark,,2009,3.8,1227,1275,48
20025,KS,Clark,,2010,4.4,1170,1224,54
20025,KS,Clark,,2011,3.8,1172,1218,46
20025,KS,Clark,,2012,3.5,1163,1205,42
20025,KS,Clark,,2013,3.1,1154,1191,37
20025,KS,Clark,,2014,2.6,1116,1146,30
20025,KS,Clark,,2015,2.4,1134,1162,28
20025,KS,Clark,,2016,2.8,1090,1121,31
20025,KS,Clark,,2017,2.5,1064,1091,27
20025,KS,Clark,,2018,2.3,1043,1068,25
20025,KS,Clark,,2019,2.3,1049,1074,25
20025,KS,Clark,,2020,1.9,1113,1135,22
20025,KS,Clark,,2021,1.8,1118,1139,21
20027,KS,Clay,,2007,3.4,4903,5074,171
20027,KS,Clay,,2008,3.4,4973,5149,176
20027,KS,Clay,,2009,4.5,5033,5269,236
20027,KS,Clay,,2010,5.5,4378,4632,254
20027,KS,Clay,,2011,5.6,4165,4410,245
20027,KS,Clay,,2012,5.2,4043,4263,220
20027,KS,Clay,,2013,5,3992,4204,212
20027,KS,Clay,,2014,4.4,3993,4176,183
20027,KS,Clay,,2015,4.3,3951,4128,177
20027,KS,Clay,,2016,4.1,3888,4053,165
20027,KS,Clay,,2017,3.7,3692,3834,142
20027,KS,Clay,,2018,3.1,3686,3805,119
20027,KS,Clay,,2019,3.1,3681,3800,119
20027,KS,Clay,,2020,4.3,3644,3808,164
20027,KS,Clay,,2021,2.6,3698,3795,97
20029,KS,Cloud,,2007,3.6,5398,5598,200
20029,KS,Cloud,,2008,3.7,5355,5558,203
20029,KS,Cloud,,2009,4.4,5537,5794,257
20029,KS,Cloud,,2010,5.6,4396,4655,259
20029,KS,Cloud,,2011,5.4,4304,4549,245
20029,KS,Cloud,,2012,5,4362,4590,228
20029,KS,Cloud,,2013,4.3,4268,4462,194
20029,KS,Cloud,,2014,4.2,4213,4397,184
20029,KS,Cloud,,2015,3.8,4159,4323,164
20029,KS,Cloud,,2016,4.1,4100,4275,175
20029,KS,Cloud,,2017,4.3,3740,3907,167
20029,KS,Cloud,,2018,3.4,3677,3805,128
20029,KS,Cloud,,2019,3.2,3686,3808,122
20029,KS,Cloud,,2020,3.9,3690,3841,151
20029,KS,Cloud,,2021,2.8,3794,3902,108
20031,KS,Coffey,,2007,4.5,4877,5108,231
20031,KS,Coffey,,2008,4.7,5098,5350,252
20031,KS,Coffey,,2009,5.8,5232,5555,323
20031,KS,Coffey,,2010,7.5,4483,4846,363
20031,KS,Coffey,,2011,7.7,4309,4670,361
20031,KS,Coffey,,2012,7,4220,4538,318
20031,KS,Coffey,,2013,5.9,4661,4954,293
20031,KS,Coffey,,2014,5.7,4624,4902,278
20031,KS,Coffey,,2015,5.7,4482,4753,271
20031,KS,Coffey,,2016,6.2,4037,4303,266
20031,KS,Coffey,,2017,5.2,3920,4136,216
20031,KS,Coffey,,2018,4.6,3919,4107,188
20031,KS,Coffey,,2019,4.4,3842,4020,178
20031,KS,Coffey,,2020,5,3737,3934,197
20031,KS,Coffey,,2021,3.2,3832,3960,128
20033,KS,Comanche,,2007,3.1,1047,1080,33
20033,KS,Comanche,,2008,3.2,1072,1108,36
20033,KS,Comanche,,2009,3.6,1062,1102,40
20033,KS,Comanche,,2010,4.4,950,994,44
20033,KS,Comanche,,2011,4.3,943,985,42
20033,KS,Comanche,,2012,3.9,964,1003,39
20033,KS,Comanche,,2013,3.5,1000,1036,36
20033,KS,Comanche,,2014,3.1,950,980,30
20033,KS,Comanche,,2015,3.3,961,994,33
20033,KS,Comanche,,2016,3.1,945,975,30
20033,KS,Comanche,,2017,2.9,885,911,26
20033,KS,Comanche,,2018,2.4,868,889,21
20033,KS,Comanche,,2019,2.5,850,872,22
20033,KS,Comanche,,2020,3.2,837,865,28
20033,KS,Comanche,,2021,2.1,872,891,19
20035,KS,Cowley,,2007,4,17507,18235,728
20035,KS,Cowley,,2008,4.4,17265,18066,801
20035,KS,Cowley,,2009,7,17225,18517,1292
20035,KS,Cowley,,2010,7.7,15919,17254,1335
20035,KS,Cowley,,2011,6.9,15989,17176,1187
20035,KS,Cowley,,2012,6.2,16216,17281,1065
20035,KS,Cowley,,2013,5.8,16204,17204,1000
20035,KS,Cowley,,2014,4.6,16493,17288,795
20035,KS,Cowley,,2015,4.6,16307,17088,781
20035,KS,Cowley,,2016,4.4,16236,16985,749
20035,KS,Cowley,,2017,3.8,16397,17041,644
20035,KS,Cowley,,2018,3.3,16323,16885,562
20035,KS,Cowley,,2019,3.3,15868,16410,542
20035,KS,Cowley,,2020,6.3,15711,16774,1063
20035,KS,Cowley,,2021,3.4,16106,16678,572
20037,KS,Crawford,,2007,4.9,19253,20245,992
20037,KS,Crawford,,2008,5.3,18771,19820,1049
20037,KS,Crawford,,2009,8.6,18422,20152,1730
20037,KS,Crawford,,2010,8.6,17687,19343,1656
20037,KS,Crawford,,2011,7.8,17755,19253,1498
20037,KS,Crawford,,2012,6.6,18075,19357,1282
20037,KS,Crawford,,2013,5.9,18186,19327,1141
20037,KS,Crawford,,2014,5.3,18144,19162,1018
20037,KS,Crawford,,2015,5.1,18012,18978,966
20037,KS,Crawford,,2016,4.8,18087,19001,914
20037,KS,Crawford,,2017,4.2,18402,19203,801
20037,KS,Crawford,,2018,3.9,18128,18863,735
20037,KS,Crawford,,2019,3.8,18190,18912,722
20037,KS,Crawford,,2020,5.3,17920,18931,1011
20037,KS,Crawford,,2021,3.2,18334,18935,601
20039,KS,Decatur,,2007,3.1,1614,1666,52
20039,KS,Decatur,,2008,3.1,1722,1777,55
20039,KS,Decatur,,2009,3.7,1741,1808,67
20039,KS,Decatur,,2010,4.9,1385,1457,72
20039,KS,Decatur,,2011,4.8,1355,1423,68
20039,KS,Decatur,,2012,4.4,1344,1406,62
20039,KS,Decatur,,2013,4,1310,1364,54
20039,KS,Decatur,,2014,3.5,1308,1355,47
20039,KS,Decatur,,2015,3.6,1305,1354,49
20039,KS,Decatur,,2016,3.9,1247,1298,51
20039,KS,Decatur,,2017,3.1,1247,1287,40
20039,KS,Decatur,,2018,2.9,1223,1259,36
20039,KS,Decatur,,2019,3,1206,1243,37
20039,KS,Decatur,,2020,3.4,1182,1224,42
20039,KS,Decatur,,2021,2.6,1174,1205,31
20041,KS,Dickinson,,2007,3.9,10211,10625,414
20041,KS,Dickinson,,2008,4,10249,10671,422
20041,KS,Dickinson,,2009,5.2,10308,10877,569
20041,KS,Dickinson,,2010,6.5,9565,10233,668
20041,KS,Dickinson,,2011,6.5,9497,10157,660
20041,KS,Dickinson,,2012,6,9489,10099,610
20041,KS,Dickinson,,2013,5.9,9299,9882,583
20041,KS,Dickinson,,2014,5,9246,9735,489
20041,KS,Dickinson,,2015,5.2,9052,9545,493
20041,KS,Dickinson,,2016,4.4,8803,9209,406
20041,KS,Dickinson,,2017,3.8,8958,9311,353
20041,KS,Dickinson,,2018,3.4,8841,9153,312
20041,KS,Dickinson,,2019,3.5,8605,8915,310
20041,KS,Dickinson,,2020,4.6,8455,8867,412
20041,KS,Dickinson,,2021,3,8828,9097,269
20043,KS,Doniphan,,2007,4.8,4338,4557,219
20043,KS,Doniphan,,2008,5.5,4220,4467,247
20043,KS,Doniphan,,2009,10.5,4135,4618,483
20043,KS,Doniphan,,2010,8.7,4142,4538,396
20043,KS,Doniphan,,2011,7.7,4129,4473,344
20043,KS,Doniphan,,2012,6.3,4134,4410,276
20043,KS,Doniphan,,2013,5.4,4111,4347,236
20043,KS,Doniphan,,2014,4.5,4109,4301,192
20043,KS,Doniphan,,2015,4.3,4143,4330,187
20043,KS,Doniphan,,2016,3.9,4128,4294,166
20043,KS,Doniphan,,2017,3.5,4071,4217,146
20043,KS,Doniphan,,2018,3.5,4027,4172,145
20043,KS,Doniphan,,2019,3.3,4026,4163,137
20043,KS,Doniphan,,2020,4.5,3951,4136,185
20043,KS,Doniphan,,2021,2.7,4011,4124,113
20045,KS,Douglas,,2007,3.9,59763,62192,2429
20045,KS,Douglas,,2008,4.2,58883,61455,2572
20045,KS,Douglas,,2009,5.7,59337,62953,3616
20045,KS,Douglas,,2010,5.8,60627,64384,3757
20045,KS,Douglas,,2011,5.6,60492,64059,3567
20045,KS,Douglas,,2012,5.1,60473,63740,3267
20045,KS,Douglas,,2013,4.8,60620,63686,3066
20045,KS,Douglas,,2014,4.1,62121,64745,2624
20045,KS,Douglas,,2015,3.7,62542,64936,2394
20045,KS,Douglas,,2016,3.5,63255,65567,2312
20045,KS,Douglas,,2017,3.2,63527,65614,2087
20045,KS,Douglas,,2018,3,63604,65570,1966
20045,KS,Douglas,,2019,2.9,63872,65782,1910
20045,KS,Douglas,,2020,5.8,60252,63957,3705
20045,KS,Douglas,,2021,3.1,62581,64611,2030
20047,KS,Edwards,,2007,3.5,1582,1639,57
20047,KS,Edwards,,2008,2.8,1700,1749,49
20047,KS,Edwards,,2009,4.2,1721,1797,76
20047,KS,Edwards,,2010,5.3,1594,1683,89
20047,KS,Edwards,,2011,4.4,1599,1673,74
20047,KS,Edwards,,2012,4,1582,1648,66
20047,KS,Edwards,,2013,3.7,1551,1611,60
20047,KS,Edwards,,2014,3.3,1555,1608,53
20047,KS,Edwards,,2015,3,1701,1754,53
20047,KS,Edwards,,2016,3,1612,1662,50
20047,KS,Edwards,,2017,3.1,1474,1521,47
20047,KS,Edwards,,2018,2.3,1466,1501,35
20047,KS,Edwards,,2019,2.5,1434,1471,37
20047,KS,Edwards,,2020,2.9,1418,1460,42
20047,KS,Edwards,,2021,2.1,1433,1464,31
20049,KS,Elk,,2007,5.8,1343,1425,82
20049,KS,Elk,,2008,5.6,1374,1456,82
20049,KS,Elk,,2009,8.2,1397,1522,125
20049,KS,Elk,,2010,8.3,1297,1414,117
20049,KS,Elk,,2011,7.5,1284,1388,104
20049,KS,Elk,,2012,6.8,1260,1352,92
20049,KS,Elk,,2013,5.7,1251,1326,75
20049,KS,Elk,,2014,5.1,1244,1311,67
20049,KS,Elk,,2015,4.8,1222,1283,61
20049,KS,Elk,,2016,4.9,1135,1194,59
20049,KS,Elk,,2017,4.2,1143,1193,50
20049,KS,Elk,,2018,3.2,1136,1174,38
20049,KS,Elk,,2019,3.7,1117,1160,43
20049,KS,Elk,,2020,4.7,1112,1167,55
20049,KS,Elk,,2021,2.8,1125,1158,33
20051,KS,Ellis,,2007,2.8,16685,17165,480
20051,KS,Ellis,,2008,3,16777,17300,523
20051,KS,Ellis,,2009,3.9,17317,18020,703
20051,KS,Ellis,,2010,3.9,16961,17648,687
20051,KS,Ellis,,2011,3.5,17310,17935,625
20051,KS,Ellis,,2012,3.4,17471,18089,618
20051,KS,Ellis,,2013,3.1,17517,18086,569
20051,KS,Ellis,,2014,2.7,17447,17937,490
20051,KS,Ellis,,2015,3,17044,17569,525
20051,KS,Ellis,,2016,3.1,16564,17090,526
20051,KS,Ellis,,2017,2.5,16637,17063,426
20051,KS,Ellis,,2018,2.3,16609,17002,393
20051,KS,Ellis,,2019,2.2,16737,17121,384
20051,KS,Ellis,,2020,3.3,16477,17036,559
20051,KS,Ellis,,2021,1.9,16826,17158,332
20053,KS,Ellsworth,,2007,3.4,3570,3695,125
20053,KS,Ellsworth,,2008,3.3,3730,3857,127
20053,KS,Ellsworth,,2009,4.2,3697,3859,162
20053,KS,Ellsworth,,2010,4.7,3238,3396,158
20053,KS,Ellsworth,,2011,4,3368,3508,140
20053,KS,Ellsworth,,2012,3.5,3378,3500,122
20053,KS,Ellsworth,,2013,3.3,3339,3454,115
20053,KS,Ellsworth,,2014,2.9,3349,3450,101
20053,KS,Ellsworth,,2015,3.7,2838,2946,108
20053,KS,Ellsworth,,2016,3.8,2737,2846,109
20053,KS,Ellsworth,,2017,3,2644,2727,83
20053,KS,Ellsworth,,2018,2.7,2627,2700,73
20053,KS,Ellsworth,,2019,2.8,2680,2756,76
20053,KS,Ellsworth,,2020,3,2623,2704,81
20053,KS,Ellsworth,,2021,2.2,2641,2701,60
20055,KS,Finney,,2007,3.4,17311,17926,615
20055,KS,Finney,,2008,3.5,18379,19051,672
20055,KS,Finney,,2009,4.4,18798,19666,868
20055,KS,Finney,,2010,4.5,19272,20180,908
20055,KS,Finney,,2011,4.2,19972,20848,876
20055,KS,Finney,,2012,4.5,19330,20232,902
20055,KS,Finney,,2013,4.3,19168,20026,858
20055,KS,Finney,,2014,3.4,19543,20232,689
20055,KS,Finney,,2015,3.5,19473,20184,711
20055,KS,Finney,,2016,3.1,19620,20245,625
20055,KS,Finney,,2017,2.7,19648,20199,551
20055,KS,Finney,,2018,2.4,20095,20593,498
20055,KS,Finney,,2019,2.3,20218,20693,475
20055,KS,Finney,,2020,3.2,19894,20555,661
20055,KS,Finney,,2021,2.1,19877,20305,428
20057,KS,Ford,,2007,3.2,16140,16669,529
20057,KS,Ford,,2008,3,17474,18019,545
20057,KS,Ford,,2009,3.5,18189,18851,662
20057,KS,Ford,,2010,4.1,17376,18120,744
20057,KS,Ford,,2011,4.2,17585,18365,780
20057,KS,Ford,,2012,3.9,18167,18896,729
20057,KS,Ford,,2013,4,17924,18672,748
20057,KS,Ford,,2014,3.8,17519,18206,687
20057,KS,Ford,,2015,3.4,17495,18110,615
20057,KS,Ford,,2016,3.2,17399,17966,567
20057,KS,Ford,,2017,2.8,17397,17901,504
20057,KS,Ford,,2018,2.5,16920,17348,428
20057,KS,Ford,,2019,2.5,16778,17200,422
20057,KS,Ford,,2020,3.2,16706,17256,550
20057,KS,Ford,,2021,2.1,17309,17686,377
20059,KS,Franklin,,2007,5.1,13131,13837,706
20059,KS,Franklin,,2008,5.6,12957,13723,766
20059,KS,Franklin,,2009,9.2,12357,13609,1252
20059,KS,Franklin,,2010,8.8,13081,14347,1266
20059,KS,Franklin,,2011,8.2,12891,14041,1150
20059,KS,Franklin,,2012,7.2,13011,14026,1015
20059,KS,Franklin,,2013,6.1,13139,13997,858
20059,KS,Franklin,,2014,5.1,13358,14072,714
20059,KS,Franklin,,2015,4.6,13493,14139,646
20059,KS,Franklin,,2016,4.2,13693,14291,598
20059,KS,Franklin,,2017,3.7,13713,14243,530
20059,KS,Franklin,,2018,3.5,13603,14096,493
20059,KS,Franklin,,2019,3.3,13659,14118,459
20059,KS,Franklin,,2020,5.2,13477,14217,740
20059,KS,Franklin,,2021,3.1,14069,14521,452
20061,KS,Geary,,2007,4.4,11410,11937,527
20061,KS,Geary,,2008,4.7,12882,13511,629
20061,KS,Geary,,2009,7.4,13024,14065,1041
20061,KS,Geary,,2010,9,12146,13351,1205
20061,KS,Geary,,2011,9,12034,13231,1197
20061,KS,Geary,,2012,8.7,11743,12855,1112
20061,KS,Geary,,2013,8.7,11593,12694,1101
20061,KS,Geary,,2014,7.2,11454,12349,895
20061,KS,Geary,,2015,6.2,11391,12142,751
20061,KS,Geary,,2016,5.6,11431,12112,681
20061,KS,Geary,,2017,4.9,10980,11548,568
20061,KS,Geary,,2018,4.6,10945,11473,528
20061,KS,Geary,,2019,4.3,10877,11361,484
20061,KS,Geary,,2020,6.8,10841,11632,791
20061,KS,Geary,,2021,4.3,10916,11402,486
20063,KS,Gove,,2007,3,1459,1504,45
20063,KS,Gove,,2008,2.8,1468,1510,42
20063,KS,Gove,,2009,3,1569,1617,48
20063,KS,Gove,,2010,3.3,1455,1505,50
20063,KS,Gove,,2011,3.3,1456,1505,49
20063,KS,Gove,,2012,3,1473,1518,45
20063,KS,Gove,,2013,3.4,1442,1492,50
20063,KS,Gove,,2014,2.6,1447,1486,39
20063,KS,Gove,,2015,2.5,1453,1490,37
20063,KS,Gove,,2016,2.4,1423,1458,35
20063,KS,Gove,,2017,2.3,1398,1431,33
20063,KS,Gove,,2018,2.1,1395,1425,30
20063,KS,Gove,,2019,2.1,1454,1485,31
20063,KS,Gove,,2020,2.5,1423,1460,37
20063,KS,Gove,,2021,1.9,1437,1465,28
20065,KS,Graham,,2007,3.1,1436,1482,46
20065,KS,Graham,,2008,3.3,1464,1514,50
20065,KS,Graham,,2009,4.5,1413,1479,66
20065,KS,Graham,,2010,4.7,1324,1389,65
20065,KS,Graham,,2011,4.1,1365,1423,58
20065,KS,Graham,,2012,3.4,1344,1391,47
20065,KS,Graham,,2013,4.2,1298,1355,57
20065,KS,Graham,,2014,3.2,1272,1314,42
20065,KS,Graham,,2015,4,1225,1276,51
20065,KS,Graham,,2016,4.4,1176,1230,54
20065,KS,Graham,,2017,3.6,1079,1119,40
20065,KS,Graham,,2018,3.1,1111,1146,35
20065,KS,Graham,,2019,3,1085,1119,34
20065,KS,Graham,,2020,4.3,1085,1134,49
20065,KS,Graham,,2021,2.9,1099,1132,33
20067,KS,Grant,,2007,2.8,3850,3962,112
20067,KS,Grant,,2008,2.9,3872,3986,114
20067,KS,Grant,,2009,3.9,3978,4140,162
20067,KS,Grant,,2010,4.3,4024,4203,179
20067,KS,Grant,,2011,4.1,3954,4124,170
20067,KS,Grant,,2012,3.9,3847,4003,156
20067,KS,Grant,,2013,3.6,3856,4000,144
20067,KS,Grant,,2014,3.4,3809,3943,134
20067,KS,Grant,,2015,3.6,3773,3913,140
20067,KS,Grant,,2016,3.6,3656,3792,136
20067,KS,Grant,,2017,3.2,3374,3485,111
20067,KS,Grant,,2018,2.7,3267,3358,91
20067,KS,Grant,,2019,2.8,3131,3221,90
20067,KS,Grant,,2020,3.9,2976,3097,121
20067,KS,Grant,,2021,3,2873,2963,90
20069,KS,Gray,,2007,2.7,3075,3159,84
20069,KS,Gray,,2008,2.6,3223,3309,86
20069,KS,Gray,,2009,3,3357,3462,105
20069,KS,Gray,,2010,3.2,3379,3491,112
20069,KS,Gray,,2011,3.2,3486,3603,117
20069,KS,Gray,,2012,3.1,3465,3576,111
20069,KS,Gray,,2013,3,3391,3496,105
20069,KS,Gray,,2014,2.7,3407,3501,94
20069,KS,Gray,,2015,2.3,3527,3610,83
20069,KS,Gray,,2016,2.3,3348,3426,78
20069,KS,Gray,,2017,2,3355,3423,68
20069,KS,Gray,,2018,2,3359,3426,67
20069,KS,Gray,,2019,2,3187,3251,64
20069,KS,Gray,,2020,2.1,3167,3235,68
20069,KS,Gray,,2021,1.7,3174,3229,55
20071,KS,Greeley,,2007,3.3,676,699,23
20071,KS,Greeley,,2008,3.7,700,727,27
20071,KS,Greeley,,2009,3.8,702,730,28
20071,KS,Greeley,,2010,3.4,799,827,28
20071,KS,Greeley,,2011,3.1,821,847,26
20071,KS,Greeley,,2012,3,860,887,27
20071,KS,Greeley,,2013,2.4,888,910,22
20071,KS,Greeley,,2014,2.1,879,898,19
20071,KS,Greeley,,2015,2.1,917,937,20
20071,KS,Greeley,,2016,2.1,897,916,19
20071,KS,Greeley,,2017,1.8,858,874,16
20071,KS,Greeley,,2018,2,844,861,17
20071,KS,Greeley,,2019,2.2,798,816,18
20071,KS,Greeley,,2020,1.6,805,818,13
20071,KS,Greeley,,2021,1.2,812,822,10
20073,KS,Greenwood,,2007,4.7,3408,3575,167
20073,KS,Greenwood,,2008,5.3,3423,3613,190
20073,KS,Greenwood,,2009,6.7,3327,3566,239
20073,KS,Greenwood,,2010,7.4,3184,3440,256
20073,KS,Greenwood,,2011,6.5,3254,3481,227
20073,KS,Greenwood,,2012,5.6,3247,3439,192
20073,KS,Greenwood,,2013,5.3,3186,3366,180
20073,KS,Greenwood,,2014,4.5,3183,3332,149
20073,KS,Greenwood,,2015,4.6,3147,3298,151
20073,KS,Greenwood,,2016,4.9,3175,3337,162
20073,KS,Greenwood,,2017,4.2,3096,3231,135
20073,KS,Greenwood,,2018,3.4,3138,3250,112
20073,KS,Greenwood,,2019,3.1,3145,3246,101
20073,KS,Greenwood,,2020,5.1,2945,3103,158
20073,KS,Greenwood,,2021,2.8,2926,3011,85
20075,KS,Hamilton,,2007,3.4,1209,1252,43
20075,KS,Hamilton,,2008,3.4,1239,1283,44
20075,KS,Hamilton,,2009,4,1286,1339,53
20075,KS,Hamilton,,2010,3.1,1769,1825,56
20075,KS,Hamilton,,2011,2.8,1707,1756,49
20075,KS,Hamilton,,2012,2.7,1783,1832,49
20075,KS,Hamilton,,2013,2.9,1670,1719,49
20075,KS,Hamilton,,2014,2.3,1626,1664,38
20075,KS,Hamilton,,2015,2,1624,1657,33
20075,KS,Hamilton,,2016,2.7,1606,1650,44
20075,KS,Hamilton,,2017,2.4,1600,1639,39
20075,KS,Hamilton,,2018,1.9,1600,1631,31
20075,KS,Hamilton,,2019,1.8,1573,1602,29
20075,KS,Hamilton,,2020,1.5,1590,1615,25
20075,KS,Hamilton,,2021,1.4,1598,1620,22
20077,KS,Harper,,2007,3,3296,3399,103
20077,KS,Harper,,2008,3.2,3315,3424,109
20077,KS,Harper,,2009,5.1,3279,3455,176
20077,KS,Harper,,2010,6.2,2756,2937,181
20077,KS,Harper,,2011,5.6,2747,2909,162
20077,KS,Harper,,2012,4.3,2984,3119,135
20077,KS,Harper,,2013,4,2986,3111,125
20077,KS,Harper,,2014,3.7,2875,2985,110
20077,KS,Harper,,2015,3.9,2752,2863,111
20077,KS,Harper,,2016,3.6,2791,2894,103
20077,KS,Harper,,2017,3.7,2559,2657,98
20077,KS,Harper,,2018,2.8,2674,2750,76
20077,KS,Harper,,2019,2.5,2800,2872,72
20077,KS,Harper,,2020,4.2,2664,2782,118
20077,KS,Harper,,2021,2.6,2701,2774,73
20079,KS,Harvey,,2007,3.7,17321,17992,671
20079,KS,Harvey,,2008,3.9,17308,18011,703
20079,KS,Harvey,,2009,7.1,16907,18194,1287
20079,KS,Harvey,,2010,7.1,16511,17771,1260
20079,KS,Harvey,,2011,6,16425,17468,1043
20079,KS,Harvey,,2012,5.4,16376,17314,938
20079,KS,Harvey,,2013,4.9,16315,17150,835
20079,KS,Harvey,,2014,4.2,16415,17139,724
20079,KS,Harvey,,2015,3.9,16582,17254,672
20079,KS,Harvey,,2016,4.2,16554,17283,729
20079,KS,Harvey,,2017,4.1,16238,16927,689
20079,KS,Harvey,,2018,3.1,16304,16834,530
20079,KS,Harvey,,2019,2.9,16709,17202,493
20079,KS,Harvey,,2020,5.2,15902,16768,866
20079,KS,Harvey,,2021,2.9,16421,16918,497
20081,KS,Haskell,,2007,2.9,2093,2155,62
20081,KS,Haskell,,2008,2.7,2124,2183,59
20081,KS,Haskell,,2009,3.4,2213,2290,77
20081,KS,Haskell,,2010,3.6,2359,2446,87
20081,KS,Haskell,,2011,3.5,2343,2427,84
20081,KS,Haskell,,2012,3.4,2388,2471,83
20081,KS,Haskell,,2013,2.9,2325,2395,70
20081,KS,Haskell,,2014,2.6,2299,2360,61
20081,KS,Haskell,,2015,2.5,2306,2365,59
20081,KS,Haskell,,2016,2.6,2255,2315,60
20081,KS,Haskell,,2017,2.2,2190,2240,50
20081,KS,Haskell,,2018,2.1,2159,2205,46
20081,KS,Haskell,,2019,2.2,2180,2230,50
20081,KS,Haskell,,2020,2.2,2191,2240,49
20081,KS,Haskell,,2021,1.8,2183,2223,40
20083,KS,Hodgeman,,2007,4,868,904,36
20083,KS,Hodgeman,,2008,3.4,908,940,32
20083,KS,Hodgeman,,2009,4,912,950,38
20083,KS,Hodgeman,,2010,3.7,1046,1086,40
20083,KS,Hodgeman,,2011,3.8,1073,1115,42
20083,KS,Hodgeman,,2012,3.4,1077,1115,38
20083,KS,Hodgeman,,2013,3.8,1075,1118,43
20083,KS,Hodgeman,,2014,3.4,1001,1036,35
20083,KS,Hodgeman,,2015,3.1,998,1030,32
20083,KS,Hodgeman,,2016,2.6,1007,1034,27
20083,KS,Hodgeman,,2017,2.5,967,992,25
20083,KS,Hodgeman,,2018,2.4,965,989,24
20083,KS,Hodgeman,,2019,2.4,970,994,24
20083,KS,Hodgeman,,2020,2.5,990,1015,25
20083,KS,Hodgeman,,2021,1.8,1017,1036,19
20085,KS,Jackson,,2007,5.5,6569,6955,386
20085,KS,Jackson,,2008,5.7,6451,6843,392
20085,KS,Jackson,,2009,7,6521,7012,491
20085,KS,Jackson,,2010,6.1,7052,7509,457
20085,KS,Jackson,,2011,5.9,7014,7455,441
20085,KS,Jackson,,2012,5.6,6959,7373,414
20085,KS,Jackson,,2013,5.1,6932,7303,371
20085,KS,Jackson,,2014,4.1,7095,7399,304
20085,KS,Jackson,,2015,3.7,6990,7259,269
20085,KS,Jackson,,2016,3.5,7041,7293,252
20085,KS,Jackson,,2017,3.1,7029,7255,226
20085,KS,Jackson,,2018,2.9,7015,7228,213
20085,KS,Jackson,,2019,2.9,6963,7168,205
20085,KS,Jackson,,2020,5.2,6857,7234,377
20085,KS,Jackson,,2021,2.6,7048,7236,188
20087,KS,Jefferson,,2007,5,9138,9620,482
20087,KS,Jefferson,,2008,5.2,9073,9574,501
20087,KS,Jefferson,,2009,7.6,8950,9687,737
20087,KS,Jefferson,,2010,7.4,9880,10670,790
20087,KS,Jefferson,,2011,7,9763,10498,735
20087,KS,Jefferson,,2012,6,9658,10279,621
20087,KS,Jefferson,,2013,5.7,9626,10211,585
20087,KS,Jefferson,,2014,4.8,9741,10231,490
20087,KS,Jefferson,,2015,4.2,9787,10214,427
20087,KS,Jefferson,,2016,3.9,9864,10262,398
20087,KS,Jefferson,,2017,3.5,9877,10238,361
20087,KS,Jefferson,,2018,3.1,9872,10193,321
20087,KS,Jefferson,,2019,3,9912,10220,308
20087,KS,Jefferson,,2020,4.7,9755,10234,479
20087,KS,Jefferson,,2021,3,10025,10332,307
20089,KS,Jewell,,2007,2.9,1865,1920,55
20089,KS,Jewell,,2008,3.1,1880,1941,61
20089,KS,Jewell,,2009,4.2,1904,1988,84
20089,KS,Jewell,,2010,5.4,1474,1558,84
20089,KS,Jewell,,2011,4.6,1464,1535,71
20089,KS,Jewell,,2012,4.3,1393,1455,62
20089,KS,Jewell,,2013,3.6,1373,1425,52
20089,KS,Jewell,,2014,3.8,1329,1382,53
20089,KS,Jewell,,2015,4.4,1318,1378,60
20089,KS,Jewell,,2016,4.3,1279,1336,57
20089,KS,Jewell,,2017,3.4,1263,1308,45
20089,KS,Jewell,,2018,2.6,1257,1291,34
20089,KS,Jewell,,2019,2.8,1271,1307,36
20089,KS,Jewell,,2020,2.9,1213,1249,36
20089,KS,Jewell,,2021,2.2,1208,1235,27
20091,KS,Johnson,,2007,4.1,287082,299278,12196
20091,KS,Johnson,,2008,4.6,286565,300329,13764
20091,KS,Johnson,,2009,6.6,278997,298579,19582
20091,KS,Johnson,,2010,6,288721,307208,18487
20091,KS,Johnson,,2011,5.3,293473,309822,16349
20091,KS,Johnson,,2012,4.6,297179,311453,14274
20091,KS,Johnson,,2013,4.3,301328,314912,13584
20091,KS,Johnson,,2014,3.8,309249,321300,12051
20091,KS,Johnson,,2015,3.4,314557,325565,11008
20091,KS,Johnson,,2016,3.2,319111,329826,10715
20091,KS,Johnson,,2017,3,325342,335466,10124
20091,KS,Johnson,,2018,2.8,328372,337941,9569
20091,KS,Johnson,,2019,2.7,332426,341751,9325
20091,KS,Johnson,,2020,4.9,324768,341523,16755
20091,KS,Johnson,,2021,2.7,334751,343991,9240
20093,KS,Kearny,,2007,3.3,2061,2131,70
20093,KS,Kearny,,2008,3.4,2096,2169,73
20093,KS,Kearny,,2009,4.4,2069,2165,96
20093,KS,Kearny,,2010,4.4,2060,2155,95
20093,KS,Kearny,,2011,4.3,2095,2190,95
20093,KS,Kearny,,2012,3.9,2092,2178,86
20093,KS,Kearny,,2013,3.6,2027,2103,76
20093,KS,Kearny,,2014,3.1,2056,2121,65
20093,KS,Kearny,,2015,3.2,2086,2154,68
20093,KS,Kearny,,2016,3.1,2002,2067,65
20093,KS,Kearny,,2017,2.5,2020,2071,51
20093,KS,Kearny,,2018,2.2,2046,2093,47
20093,KS,Kearny,,2019,2.3,1998,2045,47
20093,KS,Kearny,,2020,2.5,1975,2025,50
20093,KS,Kearny,,2021,1.6,2015,2048,33
20095,KS,Kingman,,2007,3.4,4145,4291,146
20095,KS,Kingman,,2008,3.3,4323,4472,149
20095,KS,Kingman,,2009,5.6,4355,4615,260
20095,KS,Kingman,,2010,6.9,3597,3862,265
20095,KS,Kingman,,2011,6.3,3600,3842,242
20095,KS,Kingman,,2012,6.1,3551,3783,232
20095,KS,Kingman,,2013,5.4,3522,3725,203
20095,KS,Kingman,,2014,4,3466,3609,143
20095,KS,Kingman,,2015,4.3,3500,3659,159
20095,KS,Kingman,,2016,4.4,3388,3544,156
20095,KS,Kingman,,2017,3.7,3282,3407,125
20095,KS,Kingman,,2018,3.1,3306,3413,107
20095,KS,Kingman,,2019,3.2,3276,3383,107
20095,KS,Kingman,,2020,5.1,3082,3249,167
20095,KS,Kingman,,2021,3.1,3172,3272,100
20097,KS,Kiowa,,2007,4.7,1424,1495,71
20097,KS,Kiowa,,2008,3.4,1379,1427,48
20097,KS,Kiowa,,2009,3.5,1519,1574,55
20097,KS,Kiowa,,2010,5.2,1326,1398,72
20097,KS,Kiowa,,2011,4.2,1294,1351,57
20097,KS,Kiowa,,2012,3.8,1359,1412,53
20097,KS,Kiowa,,2013,3.4,1378,1426,48
20097,KS,Kiowa,,2014,3.3,1308,1352,44
20097,KS,Kiowa,,2015,3,1409,1452,43
20097,KS,Kiowa,,2016,2.7,1387,1426,39
20097,KS,Kiowa,,2017,2.5,1317,1351,34
20097,KS,Kiowa,,2018,2.3,1277,1307,30
20097,KS,Kiowa,,2019,2.2,1263,1292,29
20097,KS,Kiowa,,2020,3.1,1207,1245,38
20097,KS,Kiowa,,2021,2.1,1194,1220,26
20099,KS,Labette,,2007,5,10803,11367,564
20099,KS,Labette,,2008,5.3,10818,11419,601
20099,KS,Labette,,2009,8.6,10615,11616,1001
20099,KS,Labette,,2010,9.4,10212,11270,1058
20099,KS,Labette,,2011,8.9,10097,11081,984
20099,KS,Labette,,2012,7.9,9897,10749,852
20099,KS,Labette,,2013,7.2,9982,10751,769
20099,KS,Labette,,2014,5.8,10164,10788,624
20099,KS,Labette,,2015,5.7,10164,10782,618
20099,KS,Labette,,2016,5.4,10202,10782,580
20099,KS,Labette,,2017,4.5,9920,10387,467
20099,KS,Labette,,2018,3.9,9854,10251,397
20099,KS,Labette,,2019,3.9,9692,10087,395
20099,KS,Labette,,2020,5.5,9122,9648,526
20099,KS,Labette,,2021,3.4,9093,9413,320
20101,KS,Lane,,2007,3.6,1029,1067,38
20101,KS,Lane,,2008,3.7,1052,1092,40
20101,KS,Lane,,2009,3.3,1100,1138,38
20101,KS,Lane,,2010,4.2,945,986,41
20101,KS,Lane,,2011,4.6,920,964,44
20101,KS,Lane,,2012,4.6,862,904,42
20101,KS,Lane,,2013,3.5,854,885,31
20101,KS,Lane,,2014,3.2,837,865,28
20101,KS,Lane,,2015,3.3,851,880,29
20101,KS,Lane,,2016,3.1,789,814,25
20101,KS,Lane,,2017,3.3,763,789,26
20101,KS,Lane,,2018,2.8,772,794,22
20101,KS,Lane,,2019,2.6,756,776,20
20101,KS,Lane,,2020,2.8,734,755,21
20101,KS,Lane,,2021,2,732,747,15
20103,KS,Leavenworth,,2007,5.4,31122,32901,1779
20103,KS,Leavenworth,,2008,5.8,30894,32787,1893
20103,KS,Leavenworth,,2009,8.1,29979,32607,2628
20103,KS,Leavenworth,,2010,7.5,31763,34328,2565
20103,KS,Leavenworth,,2011,7.2,32103,34579,2476
20103,KS,Leavenworth,,2012,6.4,32367,34573,2206
20103,KS,Leavenworth,,2013,6,32604,34677,2073
20103,KS,Leavenworth,,2014,5,33312,35047,1735
20103,KS,Leavenworth,,2015,4.5,33776,35366,1590
20103,KS,Leavenworth,,2016,4.3,34402,35945,1543
20103,KS,Leavenworth,,2017,3.9,35033,36453,1420
20103,KS,Leavenworth,,2018,3.6,35102,36401,1299
20103,KS,Leavenworth,,2019,3.4,35433,36678,1245
20103,KS,Leavenworth,,2020,5.6,34565,36629,2064
20103,KS,Leavenworth,,2021,3.3,35624,36842,1218
20105,KS,Lincoln,,2007,3.9,1759,1831,72
20105,KS,Lincoln,,2008,3.7,1853,1924,71
20105,KS,Lincoln,,2009,5.5,1902,2013,111
20105,KS,Lincoln,,2010,5.9,1771,1882,111
20105,KS,Lincoln,,2011,5.1,1790,1886,96
20105,KS,Lincoln,,2012,4.9,1764,1854,90
20105,KS,Lincoln,,2013,4.6,1699,1781,82
20105,KS,Lincoln,,2014,4.1,1702,1775,73
20105,KS,Lincoln,,2015,3.4,1740,1802,62
20105,KS,Lincoln,,2016,3.4,1686,1746,60
20105,KS,Lincoln,,2017,2.8,1644,1692,48
20105,KS,Lincoln,,2018,2.4,1667,1708,41
20105,KS,Lincoln,,2019,2.3,1638,1676,38
20105,KS,Lincoln,,2020,2.8,1686,1734,48
20105,KS,Lincoln,,2021,2.2,1652,1689,37
20107,KS,Linn,,2007,6.5,4452,4759,307
20107,KS,Linn,,2008,6.7,4312,4620,308
20107,KS,Linn,,2009,11.2,4010,4517,507
20107,KS,Linn,,2010,11,4032,4532,500
20107,KS,Linn,,2011,11,4023,4519,496
20107,KS,Linn,,2012,9.9,3964,4398,434
20107,KS,Linn,,2013,8.7,3968,4345,377
20107,KS,Linn,,2014,7.4,4005,4325,320
20107,KS,Linn,,2015,6.4,4062,4340,278
20107,KS,Linn,,2016,6.4,4083,4362,279
20107,KS,Linn,,2017,5.9,4168,4427,259
20107,KS,Linn,,2018,5.8,4175,4431,256
20107,KS,Linn,,2019,5.9,4162,4425,263
20107,KS,Linn,,2020,7,4028,4329,301
20107,KS,Linn,,2021,4.3,4145,4331,186
20109,KS,Logan,,2007,2.9,1726,1777,51
20109,KS,Logan,,2008,2.8,1607,1653,46
20109,KS,Logan,,2009,3.3,1666,1723,57
20109,KS,Logan,,2010,3.5,1677,1738,61
20109,KS,Logan,,2011,3.2,1726,1783,57
20109,KS,Logan,,2012,3,1708,1761,53
20109,KS,Logan,,2013,2.8,1698,1747,49
20109,KS,Logan,,2014,2.2,1698,1737,39
20109,KS,Logan,,2015,2.4,1717,1760,43
20109,KS,Logan,,2016,2.5,1687,1731,44
20109,KS,Logan,,2017,2.1,1645,1681,36
20109,KS,Logan,,2018,2.1,1657,1692,35
20109,KS,Logan,,2019,2,1596,1629,33
20109,KS,Logan,,2020,2.3,1571,1608,37
20109,KS,Logan,,2021,1.6,1606,1632,26
20111,KS,Lyon,,2007,4.1,18910,19721,811
20111,KS,Lyon,,2008,5.8,17698,18794,1096
20111,KS,Lyon,,2009,6.2,17431,18575,1144
20111,KS,Lyon,,2010,6.6,16331,17482,1151
20111,KS,Lyon,,2011,6.3,16316,17415,1099
20111,KS,Lyon,,2012,5.8,16291,17293,1002
20111,KS,Lyon,,2013,7.2,15283,16466,1183
20111,KS,Lyon,,2014,5.1,15698,16539,841
20111,KS,Lyon,,2015,4.3,15966,16682,716
20111,KS,Lyon,,2016,4.1,16206,16897,691
20111,KS,Lyon,,2017,3.8,16228,16864,636
20111,KS,Lyon,,2018,3.4,16088,16662,574
20111,KS,Lyon,,2019,3.3,16235,16797,562
20111,KS,Lyon,,2020,4.5,15861,16610,749
20111,KS,Lyon,,2021,2.8,16440,16921,481
20113,KS,McPherson,,2007,3.5,16179,16763,584
20113,KS,McPherson,,2008,3.6,15865,16453,588
20113,KS,McPherson,,2009,5,16035,16873,838
20113,KS,McPherson,,2010,5.1,15641,16480,839
20113,KS,McPherson,,2011,4.5,15985,16737,752
20113,KS,McPherson,,2012,4.1,16032,16718,686
20113,KS,McPherson,,2013,3.9,15974,16618,644
20113,KS,McPherson,,2014,3.2,16310,16853,543
20113,KS,McPherson,,2015,3,16714,17228,514
20113,KS,McPherson,,2016,3.1,15897,16413,516
20113,KS,McPherson,,2017,2.7,15930,16380,450
20113,KS,McPherson,,2018,2.5,16172,16582,410
20113,KS,McPherson,,2019,2.2,16909,17289,380
20113,KS,McPherson,,2020,3.3,16596,17161,565
20113,KS,McPherson,,2021,2.1,16802,17164,362
20115,KS,Marion,,2007,3.7,6459,6705,246
20115,KS,Marion,,2008,3.7,6479,6726,247
20115,KS,Marion,,2009,5.5,6608,6996,388
20115,KS,Marion,,2010,5.9,6347,6742,395
20115,KS,Marion,,2011,5.6,6140,6503,363
20115,KS,Marion,,2012,5.1,6043,6369,326
20115,KS,Marion,,2013,4.7,5934,6225,291
20115,KS,Marion,,2014,4,5901,6150,249
20115,KS,Marion,,2015,3.8,5945,6178,233
20115,KS,Marion,,2016,3.9,5907,6148,241
20115,KS,Marion,,2017,3.6,6063,6290,227
20115,KS,Marion,,2018,3,5872,6056,184
20115,KS,Marion,,2019,2.9,5881,6057,176
20115,KS,Marion,,2020,3.9,5717,5950,233
20115,KS,Marion,,2021,2.4,5860,6005,145
20117,KS,Marshall,,2007,3.2,5874,6066,192
20117,KS,Marshall,,2008,3.7,5730,5952,222
20117,KS,Marshall,,2009,5.6,5792,6136,344
20117,KS,Marshall,,2010,5,5613,5910,297
20117,KS,Marshall,,2011,4.6,5746,6022,276
20117,KS,Marshall,,2012,4.2,5853,6107,254
20117,KS,Marshall,,2013,3.8,5823,6056,233
20117,KS,Marshall,,2014,3.2,5697,5886,189
20117,KS,Marshall,,2015,2.9,5583,5751,168
20117,KS,Marshall,,2016,3,5419,5588,169
20117,KS,Marshall,,2017,2.8,5352,5505,153
20117,KS,Marshall,,2018,2.5,5364,5504,140
20117,KS,Marshall,,2019,2.8,5368,5523,155
20117,KS,Marshall,,2020,2.9,5321,5482,161
20117,KS,Marshall,,2021,1.9,5331,5436,105
20119,KS,Meade,,2007,2.9,2239,2306,67
20119,KS,Meade,,2008,2.9,2323,2393,70
20119,KS,Meade,,2009,3.8,2451,2549,98
20119,KS,Meade,,2010,4.2,2461,2568,107
20119,KS,Meade,,2011,3.7,2454,2547,93
20119,KS,Meade,,2012,3.3,2397,2480,83
20119,KS,Meade,,2013,3.1,2282,2356,74
20119,KS,Meade,,2014,2.6,2321,2384,63
20119,KS,Meade,,2015,3,2353,2425,72
20119,KS,Meade,,2016,2.7,2324,2388,64
20119,KS,Meade,,2017,2.4,2231,2287,56
20119,KS,Meade,,2018,2,2241,2287,46
20119,KS,Meade,,2019,2.3,2111,2160,49
20119,KS,Meade,,2020,2.7,2091,2148,57
20119,KS,Meade,,2021,2.2,2139,2187,48
20121,KS,Miami,,2007,4.7,15716,16491,775
20121,KS,Miami,,2008,5.1,15416,16247,831
20121,KS,Miami,,2009,8.2,14760,16085,1325
20121,KS,Miami,,2010,7.5,15829,17109,1280
20121,KS,Miami,,2011,7.1,15788,16993,1205
20121,KS,Miami,,2012,6.3,15756,16816,1060
20121,KS,Miami,,2013,5.6,15884,16822,938
20121,KS,Miami,,2014,4.7,16090,16880,790
20121,KS,Miami,,2015,4.3,16075,16802,727
20121,KS,Miami,,2016,4.1,16389,17098,709
20121,KS,Miami,,2017,3.7,16755,17402,647
20121,KS,Miami,,2018,3.5,16844,17460,616
20121,KS,Miami,,2019,3.3,17193,17772,579
20121,KS,Miami,,2020,4.8,16720,17570,850
20121,KS,Miami,,2021,2.9,17231,17750,519
20123,KS,Mitchell,,2007,3.6,3222,3341,119
20123,KS,Mitchell,,2008,3.3,3438,3555,117
20123,KS,Mitchell,,2009,4.7,3622,3799,177
20123,KS,Mitchell,,2010,4.7,3692,3875,183
20123,KS,Mitchell,,2011,3.6,3774,3913,139
20123,KS,Mitchell,,2012,3,3767,3883,116
20123,KS,Mitchell,,2013,2.9,3772,3885,113
20123,KS,Mitchell,,2014,3.2,3716,3840,124
20123,KS,Mitchell,,2015,3.3,3660,3785,125
20123,KS,Mitchell,,2016,3.3,3590,3712,122
20123,KS,Mitchell,,2017,2.7,3365,3459,94
20123,KS,Mitchell,,2018,2.2,3389,3464,75
20123,KS,Mitchell,,2019,2.3,3305,3383,78
20123,KS,Mitchell,,2020,2.5,3339,3426,87
20123,KS,Mitchell,,2021,2,3367,3434,67
20125,KS,Montgomery,,2007,4.9,16745,17607,862
20125,KS,Montgomery,,2008,5.6,16899,17893,994
20125,KS,Montgomery,,2009,9.9,16821,18665,1844
20125,KS,Montgomery,,2010,10.5,16172,18072,1900
20125,KS,Montgomery,,2011,9.8,16554,18348,1794
20125,KS,Montgomery,,2012,7.7,17050,18474,1424
20125,KS,Montgomery,,2013,6.8,16669,17879,1210
20125,KS,Montgomery,,2014,5.7,16371,17364,993
20125,KS,Montgomery,,2015,6.4,15548,16619,1071
20125,KS,Montgomery,,2016,6.1,15088,16070,982
20125,KS,Montgomery,,2017,5.2,14260,15045,785
20125,KS,Montgomery,,2018,4.2,14205,14826,621
20125,KS,Montgomery,,2019,4,14285,14884,599
20125,KS,Montgomery,,2020,7.1,13800,14859,1059
20125,KS,Montgomery,,2021,3.9,14140,14715,575
20127,KS,Morris,,2007,4.9,2828,2973,145
20127,KS,Morris,,2008,4.8,2753,2892,139
20127,KS,Morris,,2009,7,2859,3074,215
20127,KS,Morris,,2010,6.7,3088,3311,223
20127,KS,Morris,,2011,6.6,3087,3304,217
20127,KS,Morris,,2012,6.1,3019,3215,196
20127,KS,Morris,,2013,5.4,2938,3107,169
20127,KS,Morris,,2014,4.4,2965,3101,136
20127,KS,Morris,,2015,4.3,2979,3112,133
20127,KS,Morris,,2016,3.8,2947,3065,118
20127,KS,Morris,,2017,3.1,2913,3007,94
20127,KS,Morris,,2018,2.7,2934,3014,80
20127,KS,Morris,,2019,2.7,2923,3004,81
20127,KS,Morris,,2020,3.8,2960,3077,117
20127,KS,Morris,,2021,2.4,2981,3053,72
20129,KS,Morton,,2007,2.8,1639,1686,47
20129,KS,Morton,,2008,2.8,1721,1770,49
20129,KS,Morton,,2009,4.2,1702,1776,74
20129,KS,Morton,,2010,4.3,1681,1757,76
20129,KS,Morton,,2011,3.6,1622,1683,61
20129,KS,Morton,,2012,3.7,1601,1663,62
20129,KS,Morton,,2013,3.9,1534,1597,63
20129,KS,Morton,,2014,3.9,1432,1490,58
20129,KS,Morton,,2015,4.2,1379,1439,60
20129,KS,Morton,,2016,3.9,1298,1350,52
20129,KS,Morton,,2017,3.7,1158,1203,45
20129,KS,Morton,,2018,3.2,1137,1174,37
20129,KS,Morton,,2019,2.9,1107,1140,33
20129,KS,Morton,,2020,2.9,1096,1129,33
20129,KS,Morton,,2021,2.6,1106,1135,29
20131,KS,Nemaha,,2007,3.1,5454,5627,173
20131,KS,Nemaha,,2008,3.1,5565,5744,179
20131,KS,Nemaha,,2009,4.1,5656,5898,242
20131,KS,Nemaha,,2010,4.2,5575,5822,247
20131,KS,Nemaha,,2011,3.8,5705,5931,226
20131,KS,Nemaha,,2012,3.6,5803,6020,217
20131,KS,Nemaha,,2013,3.4,5635,5836,201
20131,KS,Nemaha,,2014,2.8,5691,5857,166
20131,KS,Nemaha,,2015,2.6,5803,5955,152
20131,KS,Nemaha,,2016,2.7,5765,5923,158
20131,KS,Nemaha,,2017,2.4,5463,5597,134
20131,KS,Nemaha,,2018,2.3,5374,5498,124
20131,KS,Nemaha,,2019,2.7,5247,5393,146
20131,KS,Nemaha,,2020,2.7,5428,5580,152
20131,KS,Nemaha,,2021,1.8,5455,5553,98
20133,KS,Neosho,,2007,4.1,8919,9303,384
20133,KS,Neosho,,2008,4.9,8728,9177,449
20133,KS,Neosho,,2009,8.5,7964,8700,736
20133,KS,Neosho,,2010,10.1,6657,7408,751
20133,KS,Neosho,,2011,9.2,6752,7435,683
20133,KS,Neosho,,2012,8.8,6313,6922,609
20133,KS,Neosho,,2013,8.5,6174,6749,575
20133,KS,Neosho,,2014,7.5,5923,6402,479
20133,KS,Neosho,,2015,7.4,5818,6285,467
20133,KS,Neosho,,2016,7.2,5648,6083,435
20133,KS,Neosho,,2017,5.2,5753,6071,318
20133,KS,Neosho,,2018,4.7,5732,6017,285
20133,KS,Neosho,,2019,4.6,5870,6150,280
20133,KS,Neosho,,2020,6.2,5833,6217,384
20133,KS,Neosho,,2021,4.3,5834,6093,259
20135,KS,Ness,,2007,3,1685,1737,52
20135,KS,Ness,,2008,3,1759,1814,55
20135,KS,Ness,,2009,3.9,1783,1856,73
20135,KS,Ness,,2010,3.9,1555,1618,63
20135,KS,Ness,,2011,3.3,1577,1631,54
20135,KS,Ness,,2012,3.2,1579,1632,53
20135,KS,Ness,,2013,3.1,1556,1605,49
20135,KS,Ness,,2014,2.7,1572,1615,43
20135,KS,Ness,,2015,3.3,1491,1542,51
20135,KS,Ness,,2016,3.4,1380,1429,49
20135,KS,Ness,,2017,2.9,1324,1363,39
20135,KS,Ness,,2018,2.6,1304,1339,35
20135,KS,Ness,,2019,2.5,1307,1340,33
20135,KS,Ness,,2020,3.3,1304,1348,44
20135,KS,Ness,,2021,2.2,1283,1312,29
20137,KS,Norton,,2007,3.3,2612,2700,88
20137,KS,Norton,,2008,3.2,2717,2807,90
20137,KS,Norton,,2009,4.4,2760,2887,127
20137,KS,Norton,,2010,3.8,2983,3100,117
20137,KS,Norton,,2011,3.5,3045,3154,109
20137,KS,Norton,,2012,3.1,3058,3156,98
20137,KS,Norton,,2013,2.8,3006,3092,86
20137,KS,Norton,,2014,2.4,2972,3044,72
20137,KS,Norton,,2015,2.5,2884,2957,73
20137,KS,Norton,,2016,2.4,2815,2885,70
20137,KS,Norton,,2017,2.2,2761,2824,63
20137,KS,Norton,,2018,2.1,2698,2755,57
20137,KS,Norton,,2019,2.1,2644,2702,58
20137,KS,Norton,,2020,2.5,2578,2644,66
20137,KS,Norton,,2021,1.8,2622,2669,47
20139,KS,Osage,,2007,5.5,8069,8537,468
20139,KS,Osage,,2008,6,7968,8473,505
20139,KS,Osage,,2009,7.8,7843,8506,663
20139,KS,Osage,,2010,8.1,7912,8613,701
20139,KS,Osage,,2011,8.1,7903,8602,699
20139,KS,Osage,,2012,7.2,7769,8371,602
20139,KS,Osage,,2013,6.6,7744,8294,550
20139,KS,Osage,,2014,5.4,7710,8150,440
20139,KS,Osage,,2015,5,7676,8078,402
20139,KS,Osage,,2016,4.4,7738,8094,356
20139,KS,Osage,,2017,3.9,7674,7988,314
20139,KS,Osage,,2018,3.7,7760,8057,297
20139,KS,Osage,,2019,3.5,7761,8044,283
20139,KS,Osage,,2020,5,7556,7950,394
20139,KS,Osage,,2021,3,7764,8001,237
20141,KS,Osborne,,2007,3.8,2127,2211,84
20141,KS,Osborne,,2008,3.4,2165,2241,76
20141,KS,Osborne,,2009,4.5,2187,2289,102
20141,KS,Osborne,,2010,4.8,2118,2224,106
20141,KS,Osborne,,2011,4.4,2172,2272,100
20141,KS,Osborne,,2012,4.3,2087,2180,93
20141,KS,Osborne,,2013,4.2,2036,2126,90
20141,KS,Osborne,,2014,3.7,1984,2060,76
20141,KS,Osborne,,2015,3.5,2023,2096,73
20141,KS,Osborne,,2016,3.4,1998,2068,70
20141,KS,Osborne,,2017,2.7,1967,2022,55
20141,KS,Osborne,,2018,2.5,2000,2051,51
20141,KS,Osborne,,2019,2,2002,2042,40
20141,KS,Osborne,,2020,2.6,1920,1972,52
20141,KS,Osborne,,2021,1.8,1925,1961,36
20143,KS,Ottawa,,2007,3.8,3137,3261,124
20143,KS,Ottawa,,2008,3.6,3249,3372,123
20143,KS,Ottawa,,2009,5.6,3215,3406,191
20143,KS,Ottawa,,2010,5.9,3093,3286,193
20143,KS,Ottawa,,2011,5.7,3100,3286,186
20143,KS,Ottawa,,2012,5.4,3058,3232,174
20143,KS,Ottawa,,2013,4.5,3099,3245,146
20143,KS,Ottawa,,2014,4.1,3114,3247,133
20143,KS,Ottawa,,2015,3.8,3116,3238,122
20143,KS,Ottawa,,2016,3.8,3057,3177,120
20143,KS,Ottawa,,2017,3.1,2974,3069,95
20143,KS,Ottawa,,2018,2.8,2937,3021,84
20143,KS,Ottawa,,2019,2.7,2943,3024,81
20143,KS,Ottawa,,2020,4,2852,2971,119
20143,KS,Ottawa,,2021,2.8,2885,2967,82
20145,KS,Pawnee,,2007,3.1,3871,3996,125
20145,KS,Pawnee,,2008,3.2,3682,3803,121
20145,KS,Pawnee,,2009,3.9,3792,3944,152
20145,KS,Pawnee,,2010,4.6,3442,3609,167
20145,KS,Pawnee,,2011,4.5,3341,3499,158
20145,KS,Pawnee,,2012,4.1,3294,3434,140
20145,KS,Pawnee,,2013,4.4,3273,3422,149
20145,KS,Pawnee,,2014,3.8,3267,3395,128
20145,KS,Pawnee,,2015,3.7,3193,3316,123
20145,KS,Pawnee,,2016,3.3,3118,3224,106
20145,KS,Pawnee,,2017,3.3,2941,3042,101
20145,KS,Pawnee,,2018,3.1,2832,2922,90
20145,KS,Pawnee,,2019,2.8,2780,2860,80
20145,KS,Pawnee,,2020,3.5,2751,2850,99
20145,KS,Pawnee,,2021,2.2,2768,2831,63
20147,KS,Phillips,,2007,3,3136,3233,97
20147,KS,Phillips,,2008,4.3,2922,3052,130
20147,KS,Phillips,,2009,6.2,2988,3186,198
20147,KS,Phillips,,2010,5.1,2883,3037,154
20147,KS,Phillips,,2011,5,2883,3034,151
20147,KS,Phillips,,2012,4.5,2888,3023,135
20147,KS,Phillips,,2013,4.2,2845,2971,126
20147,KS,Phillips,,2014,3.5,2811,2912,101
20147,KS,Phillips,,2015,3.2,2867,2962,95
20147,KS,Phillips,,2016,3.1,2780,2870,90
20147,KS,Phillips,,2017,2.9,2738,2821,83
20147,KS,Phillips,,2018,2.4,2717,2785,68
20147,KS,Phillips,,2019,2.6,2586,2654,68
20147,KS,Phillips,,2020,3.2,2556,2641,85
20147,KS,Phillips,,2021,2.1,2581,2637,56
20149,KS,Pottawatomie,,2007,3.3,11191,11569,378
20149,KS,Pottawatomie,,2008,3.6,10350,10734,384
20149,KS,Pottawatomie,,2009,5.7,10428,11060,632
20149,KS,Pottawatomie,,2010,5.2,11278,11893,615
20149,KS,Pottawatomie,,2011,4.9,11051,11622,571
20149,KS,Pottawatomie,,2012,4.7,11081,11626,545
20149,KS,Pottawatomie,,2013,4.6,11401,11951,550
20149,KS,Pottawatomie,,2014,3.9,11582,12048,466
20149,KS,Pottawatomie,,2015,3.6,11550,11987,437
20149,KS,Pottawatomie,,2016,3.5,11782,12207,425
20149,KS,Pottawatomie,,2017,3.1,11875,12250,375
20149,KS,Pottawatomie,,2018,2.7,12191,12528,337
20149,KS,Pottawatomie,,2019,2.8,12107,12455,348
20149,KS,Pottawatomie,,2020,4,11642,12132,490
20149,KS,Pottawatomie,,2021,2.5,11935,12242,307
20151,KS,Pratt,,2007,3.1,5536,5714,178
20151,KS,Pratt,,2008,3.4,5488,5683,195
20151,KS,Pratt,,2009,5,5665,5962,297
20151,KS,Pratt,,2010,5.5,4998,5290,292
20151,KS,Pratt,,2011,5,5121,5390,269
20151,KS,Pratt,,2012,4.5,5212,5457,245
20151,KS,Pratt,,2013,4,5235,5451,216
20151,KS,Pratt,,2014,3.2,5331,5508,177
20151,KS,Pratt,,2015,4,5091,5305,214
20151,KS,Pratt,,2016,4.1,4920,5128,208
20151,KS,Pratt,,2017,3.2,4811,4972,161
20151,KS,Pratt,,2018,2.7,4840,4972,132
20151,KS,Pratt,,2019,2.5,4805,4928,123
20151,KS,Pratt,,2020,3.5,4751,4921,170
20151,KS,Pratt,,2021,2.2,4803,4913,110
20153,KS,Rawlins,,2007,3.6,1191,1235,44
20153,KS,Rawlins,,2008,3.4,1186,1228,42
20153,KS,Rawlins,,2009,4,1262,1314,52
20153,KS,Rawlins,,2010,3.4,1459,1511,52
20153,KS,Rawlins,,2011,3.5,1474,1527,53
20153,KS,Rawlins,,2012,2.7,1532,1574,42
20153,KS,Rawlins,,2013,2.8,1511,1554,43
20153,KS,Rawlins,,2014,2.4,1481,1518,37
20153,KS,Rawlins,,2015,2.3,1504,1539,35
20153,KS,Rawlins,,2016,2.4,1515,1552,37
20153,KS,Rawlins,,2017,2.3,1429,1462,33
20153,KS,Rawlins,,2018,2,1451,1481,30
20153,KS,Rawlins,,2019,2.2,1467,1500,33
20153,KS,Rawlins,,2020,2.5,1506,1544,38
20153,KS,Rawlins,,2021,1.6,1606,1632,26
20155,KS,Reno,,2007,4.2,31149,32528,1379
20155,KS,Reno,,2008,4.1,32860,34264,1404
20155,KS,Reno,,2009,5.9,32930,34978,2048
20155,KS,Reno,,2010,6.3,30827,32895,2068
20155,KS,Reno,,2011,5.9,30843,32794,1951
20155,KS,Reno,,2012,5.4,30438,32190,1752
20155,KS,Reno,,2013,5.3,30000,31663,1663
20155,KS,Reno,,2014,4.4,29870,31235,1365
20155,KS,Reno,,2015,4.3,29594,30925,1331
20155,KS,Reno,,2016,4.4,28944,30273,1329
20155,KS,Reno,,2017,3.9,28996,30159,1163
20155,KS,Reno,,2018,3.5,28746,29796,1050
20155,KS,Reno,,2019,3.2,28922,29865,943
20155,KS,Reno,,2020,5.3,28164,29731,1567
20155,KS,Reno,,2021,3.2,28825,29772,947
20157,KS,Republic,,2007,3.2,2671,2760,89
20157,KS,Republic,,2008,3.1,2864,2956,92
20157,KS,Republic,,2009,4.2,2768,2890,122
20157,KS,Republic,,2010,4.3,2617,2734,117
20157,KS,Republic,,2011,3.8,2595,2697,102
20157,KS,Republic,,2012,3.8,2521,2621,100
20157,KS,Republic,,2013,3.4,2566,2656,90
20157,KS,Republic,,2014,3,2494,2572,78
20157,KS,Republic,,2015,2.7,2526,2597,71
20157,KS,Republic,,2016,2.7,2485,2555,70
20157,KS,Republic,,2017,2.8,2397,2466,69
20157,KS,Republic,,2018,2.6,2360,2424,64
20157,KS,Republic,,2019,2.5,2230,2287,57
20157,KS,Republic,,2020,3.1,2241,2313,72
20157,KS,Republic,,2021,2.3,2302,2356,54
20159,KS,Rice,,2007,3.9,5396,5613,217
20159,KS,Rice,,2008,3.8,5599,5819,220
20159,KS,Rice,,2009,5,5723,6026,303
20159,KS,Rice,,2010,5.4,5022,5306,284
20159,KS,Rice,,2011,5.1,5139,5415,276
20159,KS,Rice,,2012,4.4,5183,5424,241
20159,KS,Rice,,2013,4.3,5221,5454,233
20159,KS,Rice,,2014,3.5,5265,5456,191
20159,KS,Rice,,2015,3.8,5285,5492,207
20159,KS,Rice,,2016,4,5117,5329,212
20159,KS,Rice,,2017,3.2,5243,5416,173
20159,KS,Rice,,2018,2.8,5157,5308,151
20159,KS,Rice,,2019,2.7,5117,5260,143
20159,KS,Rice,,2020,4,4878,5082,204
20159,KS,Rice,,2021,2.4,5187,5315,128
20161,KS,Riley,,2007,3.1,38284,39525,1241
20161,KS,Riley,,2008,3.5,35875,37174,1299
20161,KS,Riley,,2009,4.5,35742,37414,1672
20161,KS,Riley,,2010,4.9,34319,36098,1779
20161,KS,Riley,,2011,4.7,33921,35606,1685
20161,KS,Riley,,2012,4.4,34803,36386,1583
20161,KS,Riley,,2013,4.2,35111,36657,1546
20161,KS,Riley,,2014,3.7,35292,36635,1343
20161,KS,Riley,,2015,3.4,34508,35727,1219
20161,KS,Riley,,2016,3.4,33861,35046,1185
20161,KS,Riley,,2017,3,34224,35297,1073
20161,KS,Riley,,2018,2.8,34388,35378,990
20161,KS,Riley,,2019,2.8,34271,35258,987
20161,KS,Riley,,2020,4.7,31962,33547,1585
20161,KS,Riley,,2021,2.8,32789,33731,942
20163,KS,Rooks,,2007,3.7,2560,2658,98
20163,KS,Rooks,,2008,4.6,2558,2681,123
20163,KS,Rooks,,2009,6.7,2607,2795,188
20163,KS,Rooks,,2010,6.2,2595,2767,172
20163,KS,Rooks,,2011,5.3,2596,2740,144
20163,KS,Rooks,,2012,4.6,2649,2778,129
20163,KS,Rooks,,2013,4.2,2669,2785,116
20163,KS,Rooks,,2014,3.6,2752,2854,102
20163,KS,Rooks,,2015,4.6,2688,2817,129
20163,KS,Rooks,,2016,4.7,2555,2681,126
20163,KS,Rooks,,2017,3.8,2409,2504,95
20163,KS,Rooks,,2018,3.1,2450,2529,79
20163,KS,Rooks,,2019,3.5,2454,2542,88
20163,KS,Rooks,,2020,3.8,2406,2501,95
20163,KS,Rooks,,2021,2.4,2378,2437,59
20165,KS,Rush,,2007,3.7,1585,1646,61
20165,KS,Rush,,2008,3.9,1637,1703,66
20165,KS,Rush,,2009,5.7,1601,1698,97
20165,KS,Rush,,2010,5.3,1698,1793,95
20165,KS,Rush,,2011,4.3,1770,1850,80
20165,KS,Rush,,2012,4.6,1810,1898,88
20165,KS,Rush,,2013,4.3,1736,1814,78
20165,KS,Rush,,2014,3.5,1747,1811,64
20165,KS,Rush,,2015,3.5,1737,1800,63
20165,KS,Rush,,2016,4,1671,1740,69
20165,KS,Rush,,2017,3.2,1605,1658,53
20165,KS,Rush,,2018,2.7,1615,1659,44
20165,KS,Rush,,2019,2.7,1592,1637,45
20165,KS,Rush,,2020,4.5,1502,1572,70
20165,KS,Rush,,2021,2.4,1545,1583,38
20167,KS,Russell,,2007,3.7,3365,3493,128
20167,KS,Russell,,2008,3.7,3462,3595,133
20167,KS,Russell,,2009,5,3414,3592,178
20167,KS,Russell,,2010,5,3553,3741,188
20167,KS,Russell,,2011,4.6,3628,3803,175
20167,KS,Russell,,2012,4.1,3667,3823,156
20167,KS,Russell,,2013,4,3705,3858,153
20167,KS,Russell,,2014,3.5,3709,3843,134
20167,KS,Russell,,2015,3.7,3604,3744,140
20167,KS,Russell,,2016,4.2,3439,3589,150
20167,KS,Russell,,2017,3.3,3403,3520,117
20167,KS,Russell,,2018,2.9,3284,3381,97
20167,KS,Russell,,2019,2.9,3222,3317,95
20167,KS,Russell,,2020,4,3175,3307,132
20167,KS,Russell,,2021,2.4,3280,3361,81
20169,KS,Saline,,2007,3.6,29230,30310,1080
20169,KS,Saline,,2008,3.8,30206,31406,1200
20169,KS,Saline,,2009,5.5,29991,31745,1754
20169,KS,Saline,,2010,6.1,29052,30935,1883
20169,KS,Saline,,2011,6,29059,30909,1850
20169,KS,Saline,,2012,5.7,29054,30824,1770
20169,KS,Saline,,2013,5,29619,31172,1553
20169,KS,Saline,,2014,4.2,29446,30732,1286
20169,KS,Saline,,2015,3.8,29791,30954,1163
20169,KS,Saline,,2016,3.7,29124,30249,1125
20169,KS,Saline,,2017,3.2,29762,30744,982
20169,KS,Saline,,2018,3,29473,30376,903
20169,KS,Saline,,2019,2.9,29492,30387,895
20169,KS,Saline,,2020,5.3,27928,29482,1554
20169,KS,Saline,,2021,3,28494,29373,879
20171,KS,Scott,,2007,2.8,2519,2591,72
20171,KS,Scott,,2008,2.7,2652,2725,73
20171,KS,Scott,,2009,3,2789,2876,87
20171,KS,Scott,,2010,3.8,2664,2769,105
20171,KS,Scott,,2011,3.7,2638,2739,101
20171,KS,Scott,,2012,3.1,2700,2785,85
20171,KS,Scott,,2013,2.9,2762,2844,82
20171,KS,Scott,,2014,2.7,2778,2855,77
20171,KS,Scott,,2015,2.8,2813,2893,80
20171,KS,Scott,,2016,2.4,2829,2900,71
20171,KS,Scott,,2017,2.2,2800,2862,62
20171,KS,Scott,,2018,1.9,2813,2868,55
20171,KS,Scott,,2019,1.9,2780,2833,53
20171,KS,Scott,,2020,2.3,2758,2824,66
20171,KS,Scott,,2021,1.6,2788,2833,45
20173,KS,Sedgwick,,2007,4.2,240393,251045,10652
20173,KS,Sedgwick,,2008,4.5,242342,253759,11417
20173,KS,Sedgwick,,2009,8.4,236624,258448,21824
20173,KS,Sedgwick,,2010,8.7,230696,252552,21856
20173,KS,Sedgwick,,2011,7.8,230687,250260,19573
20173,KS,Sedgwick,,2012,6.9,230665,247647,16982
20173,KS,Sedgwick,,2013,6.1,231648,246820,15172
20173,KS,Sedgwick,,2014,5.3,234148,247338,13190
20173,KS,Sedgwick,,2015,4.8,235654,247439,11785
20173,KS,Sedgwick,,2016,4.6,236886,248395,11509
20173,KS,Sedgwick,,2017,4.2,236093,246480,10387
20173,KS,Sedgwick,,2018,3.7,239315,248463,9148
20173,KS,Sedgwick,,2019,3.4,245173,253832,8659
20173,KS,Sedgwick,,2020,8.5,235491,257484,21993
20173,KS,Sedgwick,,2021,4.6,243391,255086,11695
20175,KS,Seward,,2007,3.4,10106,10460,354
20175,KS,Seward,,2008,3.1,10731,11077,346
20175,KS,Seward,,2009,4.9,10570,11115,545
20175,KS,Seward,,2010,4.9,10270,10796,526
20175,KS,Seward,,2011,4.5,10381,10875,494
20175,KS,Seward,,2012,4.1,10424,10870,446
20175,KS,Seward,,2013,4.1,10652,11107,455
20175,KS,Seward,,2014,3.5,10785,11173,388
20175,KS,Seward,,2015,4.3,10193,10651,458
20175,KS,Seward,,2016,4.3,9831,10278,447
20175,KS,Seward,,2017,3.5,9526,9870,344
20175,KS,Seward,,2018,3.2,9307,9610,303
20175,KS,Seward,,2019,3,9289,9580,291
20175,KS,Seward,,2020,4.1,9396,9795,399
20175,KS,Seward,,2021,2.8,9588,9863,275
20177,KS,Shawnee,,2007,4.7,87253,91509,4256
20177,KS,Shawnee,,2008,5,87466,92075,4609
20177,KS,Shawnee,,2009,6.6,88063,94258,6195
20177,KS,Shawnee,,2010,6.9,87123,93578,6455
20177,KS,Shawnee,,2011,6.7,87134,93368,6234
20177,KS,Shawnee,,2012,6.2,86629,92329,5700
20177,KS,Shawnee,,2013,5.8,86921,92251,5330
20177,KS,Shawnee,,2014,4.7,87642,92001,4359
20177,KS,Shawnee,,2015,4.2,87603,91478,3875
20177,KS,Shawnee,,2016,4,88415,92101,3686
20177,KS,Shawnee,,2017,3.6,88343,91686,3343
20177,KS,Shawnee,,2018,3.4,88019,91122,3103
20177,KS,Shawnee,,2019,3.3,87860,90849,2989
20177,KS,Shawnee,,2020,5.7,85929,91083,5154
20177,KS,Shawnee,,2021,3.1,88399,91236,2837
20179,KS,Sheridan,,2007,2.8,1512,1555,43
20179,KS,Sheridan,,2008,2.6,1523,1564,41
20179,KS,Sheridan,,2009,2.9,1552,1598,46
20179,KS,Sheridan,,2010,3.3,1464,1514,50
20179,KS,Sheridan,,2011,3.1,1486,1534,48
20179,KS,Sheridan,,2012,2.8,1509,1552,43
20179,KS,Sheridan,,2013,2.7,1460,1501,41
20179,KS,Sheridan,,2014,2.6,1423,1461,38
20179,KS,Sheridan,,2015,2.2,1453,1486,33
20179,KS,Sheridan,,2016,2.4,1421,1456,35
20179,KS,Sheridan,,2017,2.2,1347,1378,31
20179,KS,Sheridan,,2018,2.2,1396,1427,31
20179,KS,Sheridan,,2019,2.2,1387,1418,31
20179,KS,Sheridan,,2020,2.3,1432,1465,33
20179,KS,Sheridan,,2021,1.8,1438,1465,27
20181,KS,Sherman,,2007,2.9,3532,3637,105
20181,KS,Sherman,,2008,3.1,3615,3731,116
20181,KS,Sherman,,2009,4,3632,3784,152
20181,KS,Sherman,,2010,4.7,3006,3154,148
20181,KS,Sherman,,2011,4,3093,3221,128
20181,KS,Sherman,,2012,3.8,3106,3229,123
20181,KS,Sherman,,2013,4,3010,3136,126
20181,KS,Sherman,,2014,3.2,2997,3095,98
20181,KS,Sherman,,2015,2.9,3009,3099,90
20181,KS,Sherman,,2016,3.3,2857,2954,97
20181,KS,Sherman,,2017,2.9,2823,2906,83
20181,KS,Sherman,,2018,2.7,2828,2907,79
20181,KS,Sherman,,2019,2.7,2797,2874,77
20181,KS,Sherman,,2020,3.2,2778,2870,92
20181,KS,Sherman,,2021,2.5,2784,2856,72
20183,KS,Smith,,2007,3.2,2112,2181,69
20183,KS,Smith,,2008,4,2076,2162,86
20183,KS,Smith,,2009,4.8,2137,2244,107
20183,KS,Smith,,2010,4.3,2234,2334,100
20183,KS,Smith,,2011,4,2187,2277,90
20183,KS,Smith,,2012,3.9,2136,2223,87
20183,KS,Smith,,2013,3.6,2085,2162,77
20183,KS,Smith,,2014,3.1,2054,2120,66
20183,KS,Smith,,2015,3.9,2018,2099,81
20183,KS,Smith,,2016,3.2,1978,2043,65
20183,KS,Smith,,2017,2.8,1923,1978,55
20183,KS,Smith,,2018,2.4,1927,1975,48
20183,KS,Smith,,2019,2.5,1944,1993,49
20183,KS,Smith,,2020,2.5,1940,1990,50
20183,KS,Smith,,2021,1.7,1977,2012,35
20185,KS,Stafford,,2007,3.7,2056,2135,79
20185,KS,Stafford,,2008,3.7,2069,2148,79
20185,KS,Stafford,,2009,5.2,2148,2266,118
20185,KS,Stafford,,2010,5,2248,2366,118
20185,KS,Stafford,,2011,5,2211,2328,117
20185,KS,Stafford,,2012,4.6,2123,2226,103
20185,KS,Stafford,,2013,4.4,2124,2222,98
20185,KS,Stafford,,2014,3.7,2085,2166,81
20185,KS,Stafford,,2015,4,2101,2189,88
20185,KS,Stafford,,2016,3.7,2027,2104,77
20185,KS,Stafford,,2017,3.3,1945,2011,66
20185,KS,Stafford,,2018,2.6,1929,1980,51
20185,KS,Stafford,,2019,2.6,1952,2005,53
20185,KS,Stafford,,2020,3.5,1951,2022,71
20185,KS,Stafford,,2021,2.2,1936,1980,44
20187,KS,Stanton,,2007,3,1088,1122,34
20187,KS,Stanton,,2008,3.3,1076,1113,37
20187,KS,Stanton,,2009,3.3,1141,1180,39
20187,KS,Stanton,,2010,4,1049,1093,44
20187,KS,Stanton,,2011,3.9,1027,1069,42
20187,KS,Stanton,,2012,3.5,1015,1052,37
20187,KS,Stanton,,2013,3.7,1009,1048,39
20187,KS,Stanton,,2014,3.3,994,1028,34
20187,KS,Stanton,,2015,3,1032,1064,32
20187,KS,Stanton,,2016,2.8,1045,1075,30
20187,KS,Stanton,,2017,2.8,976,1004,28
20187,KS,Stanton,,2018,2.5,980,1005,25
20187,KS,Stanton,,2019,2.5,970,995,25
20187,KS,Stanton,,2020,2.1,1052,1075,23
20187,KS,Stanton,,2021,1.9,1087,1108,21
20189,KS,Stevens,,2007,3.3,2183,2258,75
20189,KS,Stevens,,2008,3.4,2206,2283,77
20189,KS,Stevens,,2009,4.8,2256,2369,113
20189,KS,Stevens,,2010,4.1,2752,2871,119
20189,KS,Stevens,,2011,4,2669,2780,111
20189,KS,Stevens,,2012,3.5,2795,2897,102
20189,KS,Stevens,,2013,3,3222,3321,99
20189,KS,Stevens,,2014,3,3270,3370,100
20189,KS,Stevens,,2015,3.7,3068,3187,119
20189,KS,Stevens,,2016,3.9,2806,2921,115
20189,KS,Stevens,,2017,3.2,2597,2682,85
20189,KS,Stevens,,2018,2.8,2536,2610,74
20189,KS,Stevens,,2019,2.6,2522,2588,66
20189,KS,Stevens,,2020,2.6,2729,2802,73
20189,KS,Stevens,,2021,2.1,2824,2884,60
20191,KS,Sumner,,2007,4.4,11309,11832,523
20191,KS,Sumner,,2008,4.6,11110,11646,536
20191,KS,Sumner,,2009,8.7,10614,11628,1014
20191,KS,Sumner,,2010,8.8,10905,11953,1048
20191,KS,Sumner,,2011,7.5,10749,11624,875
20191,KS,Sumner,,2012,6.4,10620,11341,721
20191,KS,Sumner,,2013,5.6,10541,11171,630
20191,KS,Sumner,,2014,4.7,10558,11083,525
20191,KS,Sumner,,2015,4.4,10615,11109,494
20191,KS,Sumner,,2016,4.2,10517,10981,464
20191,KS,Sumner,,2017,3.8,10347,10755,408
20191,KS,Sumner,,2018,3.4,10422,10792,370
20191,KS,Sumner,,2019,3.3,10533,10897,364
20191,KS,Sumner,,2020,8,9975,10841,866
20191,KS,Sumner,,2021,4.1,10293,10735,442
20193,KS,Thomas,,2007,3,4019,4145,126
20193,KS,Thomas,,2008,3.1,4086,4216,130
20193,KS,Thomas,,2009,3.7,4133,4294,161
20193,KS,Thomas,,2010,3.9,4367,4544,177
20193,KS,Thomas,,2011,3.6,4457,4624,167
20193,KS,Thomas,,2012,3.4,4402,4559,157
20193,KS,Thomas,,2013,3.5,4319,4475,156
20193,KS,Thomas,,2014,2.9,4260,4386,126
20193,KS,Thomas,,2015,2.6,4310,4427,117
20193,KS,Thomas,,2016,2.7,4252,4372,120
20193,KS,Thomas,,2017,2.6,4163,4273,110
20193,KS,Thomas,,2018,2.5,4181,4287,106
20193,KS,Thomas,,2019,2.2,4235,4331,96
20193,KS,Thomas,,2020,2.6,4121,4233,112
20193,KS,Thomas,,2021,1.8,4181,4259,78
20195,KS,Trego,,2007,3.3,1636,1692,56
20195,KS,Trego,,2008,3,1808,1864,56
20195,KS,Trego,,2009,3.8,1816,1887,71
20195,KS,Trego,,2010,4.6,1440,1510,70
20195,KS,Trego,,2011,4.6,1432,1501,69
20195,KS,Trego,,2012,4.3,1450,1515,65
20195,KS,Trego,,2013,3.7,1439,1494,55
20195,KS,Trego,,2014,3.1,1445,1491,46
20195,KS,Trego,,2015,3.5,1460,1513,53
20195,KS,Trego,,2016,4,1424,1483,59
20195,KS,Trego,,2017,3.3,1394,1442,48
20195,KS,Trego,,2018,3,1343,1385,42
20195,KS,Trego,,2019,2.8,1377,1416,39
20195,KS,Trego,,2020,3.3,1399,1447,48
20195,KS,Trego,,2021,2.1,1389,1419,30
20197,KS,Wabaunsee,,2007,4,3515,3662,147
20197,KS,Wabaunsee,,2008,4.5,3526,3692,166
20197,KS,Wabaunsee,,2009,7.3,3480,3753,273
20197,KS,Wabaunsee,,2010,6.5,3636,3887,251
20197,KS,Wabaunsee,,2011,6.1,3617,3854,237
20197,KS,Wabaunsee,,2012,5.4,3596,3802,206
20197,KS,Wabaunsee,,2013,5,3587,3777,190
20197,KS,Wabaunsee,,2014,4.1,3611,3765,154
20197,KS,Wabaunsee,,2015,3.8,3598,3742,144
20197,KS,Wabaunsee,,2016,3.6,3590,3723,133
20197,KS,Wabaunsee,,2017,3.2,3543,3659,116
20197,KS,Wabaunsee,,2018,3.1,3564,3677,113
20197,KS,Wabaunsee,,2019,3.2,3579,3696,117
20197,KS,Wabaunsee,,2020,4,3529,3676,147
20197,KS,Wabaunsee,,2021,2.5,3620,3711,91
20199,KS,Wallace,,2007,2.9,879,905,26
20199,KS,Wallace,,2008,4.7,806,846,40
20199,KS,Wallace,,2009,6,861,916,55
20199,KS,Wallace,,2010,5.9,841,894,53
20199,KS,Wallace,,2011,5.4,838,886,48
20199,KS,Wallace,,2012,4.2,839,876,37
20199,KS,Wallace,,2013,3.2,827,854,27
20199,KS,Wallace,,2014,2.5,855,877,22
20199,KS,Wallace,,2015,2.7,855,879,24
20199,KS,Wallace,,2016,2.7,840,863,23
20199,KS,Wallace,,2017,2.6,832,854,22
20199,KS,Wallace,,2018,2.4,804,824,20
20199,KS,Wallace,,2019,2.6,799,820,21
20199,KS,Wallace,,2020,1.9,820,836,16
20199,KS,Wallace,,2021,1.7,872,887,15
20201,KS,Washington,,2007,3.4,3225,3338,113
20201,KS,Washington,,2008,3.6,3206,3326,120
20201,KS,Washington,,2009,4.9,3293,3461,168
20201,KS,Washington,,2010,4.8,3187,3347,160
20201,KS,Washington,,2011,4.5,3176,3325,149
20201,KS,Washington,,2012,4.1,3125,3260,135
20201,KS,Washington,,2013,3.7,3017,3134,117
20201,KS,Washington,,2014,3.2,3010,3109,99
20201,KS,Washington,,2015,3.1,3039,3137,98
20201,KS,Washington,,2016,3.3,2996,3097,101
20201,KS,Washington,,2017,3,2878,2966,88
20201,KS,Washington,,2018,2.6,2869,2946,77
20201,KS,Washington,,2019,2.6,2865,2942,77
20201,KS,Washington,,2020,2.3,2993,3064,71
20201,KS,Washington,,2021,1.7,3010,3063,53
20203,KS,Wichita,,2007,3,1202,1239,37
20203,KS,Wichita,,2008,3.1,1221,1260,39
20203,KS,Wichita,,2009,3.4,1233,1276,43
20203,KS,Wichita,,2010,3.4,1291,1336,45
20203,KS,Wichita,,2011,3.8,1285,1336,51
20203,KS,Wichita,,2012,5.2,1267,1337,70
20203,KS,Wichita,,2013,3.5,1246,1291,45
20203,KS,Wichita,,2014,2.8,1202,1237,35
20203,KS,Wichita,,2015,2.9,1221,1258,37
20203,KS,Wichita,,2016,2.3,1183,1211,28
20203,KS,Wichita,,2017,2.5,1147,1176,29
20203,KS,Wichita,,2018,2,1295,1322,27
20203,KS,Wichita,,2019,1.9,1359,1385,26
20203,KS,Wichita,,2020,1.9,1220,1243,23
20203,KS,Wichita,,2021,2,1156,1179,23
20205,KS,Wilson,,2007,3.7,5317,5523,206
20205,KS,Wilson,,2008,5.6,5195,5502,307
20205,KS,Wilson,,2009,10.8,4714,5286,572
20205,KS,Wilson,,2010,11.7,3965,4492,527
20205,KS,Wilson,,2011,11.3,3803,4286,483
20205,KS,Wilson,,2012,9.9,3787,4204,417
20205,KS,Wilson,,2013,8.9,3754,4119,365
20205,KS,Wilson,,2014,6.9,3889,4175,286
20205,KS,Wilson,,2015,6.6,3755,4019,264
20205,KS,Wilson,,2016,6,3886,4133,247
20205,KS,Wilson,,2017,4.7,3819,4007,188
20205,KS,Wilson,,2018,4.2,3856,4027,171
20205,KS,Wilson,,2019,3.9,3801,3954,153
20205,KS,Wilson,,2020,7.6,3607,3903,296
20205,KS,Wilson,,2021,4,3683,3837,154
20207,KS,Woodson,,2007,5.2,1584,1671,87
20207,KS,Woodson,,2008,5.6,1573,1667,94
20207,KS,Woodson,,2009,8.6,1633,1786,153
20207,KS,Woodson,,2010,7.8,1601,1736,135
20207,KS,Woodson,,2011,6.7,1611,1726,115
20207,KS,Woodson,,2012,6.2,1548,1650,102
20207,KS,Woodson,,2013,6.3,1529,1631,102
20207,KS,Woodson,,2014,5.2,1544,1629,85
20207,KS,Woodson,,2015,5,1534,1615,81
20207,KS,Woodson,,2016,5.7,1531,1624,93
20207,KS,Woodson,,2017,4.4,1527,1597,70
20207,KS,Woodson,,2018,4.2,1535,1603,68
20207,KS,Woodson,,2019,4.1,1558,1625,67
20207,KS,Woodson,,2020,5.8,1470,1561,91
20207,KS,Woodson,,2021,3.5,1475,1528,53
20209,KS,Wyandotte,,2007,7.6,66090,71548,5458
20209,KS,Wyandotte,,2008,8,65151,70843,5692
20209,KS,Wyandotte,,2009,10.7,62743,70283,7540
20209,KS,Wyandotte,,2010,9.9,67492,74897,7405
20209,KS,Wyandotte,,2011,9.3,67823,74813,6990
20209,KS,Wyandotte,,2012,8.4,68370,74632,6262
20209,KS,Wyandotte,,2013,7.9,68999,74946,5947
20209,KS,Wyandotte,,2014,6.8,70513,75658,5145
20209,KS,Wyandotte,,2015,6,71773,76349,4576
20209,KS,Wyandotte,,2016,5.5,72523,76774,4251
20209,KS,Wyandotte,,2017,5.2,73714,77746,4032
20209,KS,Wyandotte,,2018,4.7,73640,77310,3670
20209,KS,Wyandotte,,2019,4.3,74027,77351,3324
20209,KS,Wyandotte,,2020,7.7,71699,77663,5964
20209,KS,Wyandotte,,2021,4.7,73905,77532,3627
21000,KY,Kentucky,,2007,5.4,1925716,2035493,109777
21000,KY,Kentucky,,2008,6.5,1906275,2038225,131950
21000,KY,Kentucky,,2009,10.8,1842085,2064847,222762
21000,KY,Kentucky,,2010,10.3,1852302,2065023,212721
21000,KY,Kentucky,,2011,9.4,1868168,2061500,193332
21000,KY,Kentucky,,2012,8.2,1891109,2060084,168975
21000,KY,Kentucky,,2013,7.9,1892777,2055895,163118
21000,KY,Kentucky,,2014,6.4,1877551,2006518,128967
21000,KY,Kentucky,,2015,5.2,1876009,1979641,103632
21000,KY,Kentucky,,2016,5,1914479,2015645,101166
21000,KY,Kentucky,,2017,4.8,1955234,2053398,98164
21000,KY,Kentucky,,2018,4.2,1968398,2054913,86515
21000,KY,Kentucky,,2019,4.1,1986171,2070409,84238
21000,KY,Kentucky,,2020,6.4,1886999,2016802,129803
21000,KY,Kentucky,,2021,4.7,1941737,2036942,95205
21001,KY,Adair,,2007,5.8,8408,8926,518
21001,KY,Adair,,2008,6.9,8272,8885,613
21001,KY,Adair,,2009,11.2,8204,9240,1036
21001,KY,Adair,,2010,12.5,6867,7852,985
21001,KY,Adair,,2011,11.7,6854,7766,912
21001,KY,Adair,,2012,9.5,7082,7829,747
21001,KY,Adair,,2013,10.1,6799,7559,760
21001,KY,Adair,,2014,8.6,6602,7224,622
21001,KY,Adair,,2015,7.1,6707,7219,512
21001,KY,Adair,,2016,6.5,6622,7083,461
21001,KY,Adair,,2017,5.9,6744,7169,425
21001,KY,Adair,,2018,4.8,6844,7192,348
21001,KY,Adair,,2019,5.1,6782,7144,362
21001,KY,Adair,,2020,7,6530,7019,489
21001,KY,Adair,,2021,5,6906,7267,361
21003,KY,Allen,,2007,5.8,7768,8249,481
21003,KY,Allen,,2008,7.1,7801,8399,598
21003,KY,Allen,,2009,15,7462,8778,1316
21003,KY,Allen,,2010,11.8,8089,9175,1086
21003,KY,Allen,,2011,9.8,8238,9133,895
21003,KY,Allen,,2012,8,8302,9028,726
21003,KY,Allen,,2013,7.4,8292,8953,661
21003,KY,Allen,,2014,5.9,8160,8670,510
21003,KY,Allen,,2015,4.8,8250,8668,418
21003,KY,Allen,,2016,4.2,8477,8853,376
21003,KY,Allen,,2017,4,8618,8980,362
21003,KY,Allen,,2018,3.7,8587,8914,327
21003,KY,Allen,,2019,4,8725,9084,359
21003,KY,Allen,,2020,5.4,8200,8664,464
21003,KY,Allen,,2021,4,8534,8894,360
21005,KY,Anderson,,2007,5,10508,11056,548
21005,KY,Anderson,,2008,6.5,10212,10918,706
21005,KY,Anderson,,2009,10.8,9912,11117,1205
21005,KY,Anderson,,2010,9.7,10509,11637,1128
21005,KY,Anderson,,2011,8.3,10633,11596,963
21005,KY,Anderson,,2012,6.9,10743,11543,800
21005,KY,Anderson,,2013,6.4,10799,11536,737
21005,KY,Anderson,,2014,5.2,10839,11432,593
21005,KY,Anderson,,2015,4.1,10877,11339,462
21005,KY,Anderson,,2016,4,11006,11461,455
21005,KY,Anderson,,2017,4,11365,11837,472
21005,KY,Anderson,,2018,3.5,11486,11902,416
21005,KY,Anderson,,2019,3.5,11605,12030,425
21005,KY,Anderson,,2020,5.9,11073,11765,692
21005,KY,Anderson,,2021,4,11508,11983,475
21007,KY,Ballard,,2007,5.5,4003,4236,233
21007,KY,Ballard,,2008,6.3,3889,4150,261
21007,KY,Ballard,,2009,10.4,3680,4106,426
21007,KY,Ballard,,2010,10.4,3460,3860,400
21007,KY,Ballard,,2011,9.9,3507,3894,387
21007,KY,Ballard,,2012,9.2,3527,3883,356
21007,KY,Ballard,,2013,9.1,3477,3825,348
21007,KY,Ballard,,2014,8,3383,3676,293
21007,KY,Ballard,,2015,6.8,3355,3600,245
21007,KY,Ballard,,2016,8.8,3320,3641,321
21007,KY,Ballard,,2017,7.5,3362,3635,273
21007,KY,Ballard,,2018,6.8,3291,3531,240
21007,KY,Ballard,,2019,5.4,3289,3478,189
21007,KY,Ballard,,2020,6.3,3113,3324,211
21007,KY,Ballard,,2021,5,3274,3447,173
21009,KY,Barren,,2007,5.2,18523,19530,1007
21009,KY,Barren,,2008,6.2,18276,19486,1210
21009,KY,Barren,,2009,12.8,16911,19402,2491
21009,KY,Barren,,2010,11.3,17613,19853,2240
21009,KY,Barren,,2011,9.8,17991,19939,1948
21009,KY,Barren,,2012,7.9,18273,19842,1569
21009,KY,Barren,,2013,7.6,18088,19579,1491
21009,KY,Barren,,2014,6.3,17554,18725,1171
21009,KY,Barren,,2015,5.1,17486,18429,943
21009,KY,Barren,,2016,4.6,17985,18859,874
21009,KY,Barren,,2017,4.5,18153,19014,861
21009,KY,Barren,,2018,4.3,18206,19028,822
21009,KY,Barren,,2019,4.3,18028,18832,804
21009,KY,Barren,,2020,7.3,16752,18073,1321
21009,KY,Barren,,2021,5.3,17073,18032,959
21011,KY,Bath,,2007,7.5,4678,5056,378
21011,KY,Bath,,2008,9,4593,5048,455
21011,KY,Bath,,2009,16.1,4315,5141,826
21011,KY,Bath,,2010,14.8,4189,4914,725
21011,KY,Bath,,2011,12.6,4236,4846,610
21011,KY,Bath,,2012,10.5,4382,4894,512
21011,KY,Bath,,2013,10.2,4335,4829,494
21011,KY,Bath,,2014,8.9,4304,4722,418
21011,KY,Bath,,2015,7.6,4327,4684,357
21011,KY,Bath,,2016,7.3,4412,4758,346
21011,KY,Bath,,2017,7.8,4355,4721,366
21011,KY,Bath,,2018,6.6,4302,4606,304
21011,KY,Bath,,2019,5.9,4379,4652,273
21011,KY,Bath,,2020,8,4172,4537,365
21011,KY,Bath,,2021,5.8,4365,4632,267
21013,KY,Bell,,2007,8,8750,9510,760
21013,KY,Bell,,2008,9,8777,9640,863
21013,KY,Bell,,2009,12.5,8582,9807,1225
21013,KY,Bell,,2010,12.3,8996,10252,1256
21013,KY,Bell,,2011,11.9,9001,10214,1213
21013,KY,Bell,,2012,12,9043,10276,1233
21013,KY,Bell,,2013,13.2,8561,9863,1302
21013,KY,Bell,,2014,10.1,8375,9311,936
21013,KY,Bell,,2015,8.5,7979,8719,740
21013,KY,Bell,,2016,9.1,7869,8654,785
21013,KY,Bell,,2017,7.8,7989,8661,672
21013,KY,Bell,,2018,6.1,7956,8473,517
21013,KY,Bell,,2019,6.1,7891,8400,509
21013,KY,Bell,,2020,7.5,7567,8184,617
21013,KY,Bell,,2021,5.7,7756,8225,469
21015,KY,Boone,,2007,4.4,59106,61815,2709
21015,KY,Boone,,2008,5.5,59622,63099,3477
21015,KY,Boone,,2009,9.4,58430,64461,6031
21015,KY,Boone,,2010,8.9,57900,63579,5679
21015,KY,Boone,,2011,7.8,59345,64380,5035
21015,KY,Boone,,2012,6.9,60922,65423,4501
21015,KY,Boone,,2013,6.6,61712,66044,4332
21015,KY,Boone,,2014,5.2,61910,65273,3363
21015,KY,Boone,,2015,4,62983,65619,2636
21015,KY,Boone,,2016,3.8,64755,67283,2528
21015,KY,Boone,,2017,3.8,67247,69892,2645
21015,KY,Boone,,2018,3.3,68301,70616,2315
21015,KY,Boone,,2019,3.2,70102,72415,2313
21015,KY,Boone,,2020,5.2,66874,70556,3682
21015,KY,Boone,,2021,3.8,68781,71482,2701
21017,KY,Bourbon,,2007,4.9,9234,9706,472
21017,KY,Bourbon,,2008,5.9,9022,9585,563
21017,KY,Bourbon,,2009,10.1,8347,9282,935
21017,KY,Bourbon,,2010,9.1,9189,10114,925
21017,KY,Bourbon,,2011,8.4,9224,10071,847
21017,KY,Bourbon,,2012,7.3,9132,9851,719
21017,KY,Bourbon,,2013,6.9,9146,9828,682
21017,KY,Bourbon,,2014,5.6,9109,9649,540
21017,KY,Bourbon,,2015,4.7,9288,9742,454
21017,KY,Bourbon,,2016,4.7,9416,9879,463
21017,KY,Bourbon,,2017,4.5,9446,9890,444
21017,KY,Bourbon,,2018,3.9,9312,9686,374
21017,KY,Bourbon,,2019,3.6,9283,9633,350
21017,KY,Bourbon,,2020,5.7,9025,9568,543
21017,KY,Bourbon,,2021,3.9,9288,9663,375
21019,KY,Boyd,,2007,5.1,21700,22877,1177
21019,KY,Boyd,,2008,5.9,21519,22880,1361
21019,KY,Boyd,,2009,8.8,20781,22778,1997
21019,KY,Boyd,,2010,10.3,18418,20531,2113
21019,KY,Boyd,,2011,10.3,18214,20304,2090
21019,KY,Boyd,,2012,9.4,18210,20096,1886
21019,KY,Boyd,,2013,9.4,17863,19706,1843
21019,KY,Boyd,,2014,7.5,17648,19081,1433
21019,KY,Boyd,,2015,6.8,17058,18300,1242
21019,KY,Boyd,,2016,8,17058,18542,1484
21019,KY,Boyd,,2017,7,17014,18301,1287
21019,KY,Boyd,,2018,5.8,16880,17912,1032
21019,KY,Boyd,,2019,5.4,16869,17823,954
21019,KY,Boyd,,2020,8.1,16052,17463,1411
21019,KY,Boyd,,2021,6.2,16208,17284,1076
21021,KY,Boyle,,2007,6,11959,12726,767
21021,KY,Boyle,,2008,6.8,11920,12792,872
21021,KY,Boyle,,2009,11.8,11450,12985,1535
21021,KY,Boyle,,2010,11.3,11902,13415,1513
21021,KY,Boyle,,2011,10.7,11776,13192,1416
21021,KY,Boyle,,2012,9,11899,13082,1183
21021,KY,Boyle,,2013,8.7,11695,12816,1121
21021,KY,Boyle,,2014,6.9,11447,12292,845
21021,KY,Boyle,,2015,5.5,11358,12015,657
21021,KY,Boyle,,2016,4.9,11711,12312,601
21021,KY,Boyle,,2017,5,11987,12612,625
21021,KY,Boyle,,2018,4.3,12015,12556,541
21021,KY,Boyle,,2019,4.4,12103,12659,556
21021,KY,Boyle,,2020,7.1,11673,12562,889
21021,KY,Boyle,,2021,5,12027,12657,630
21023,KY,Bracken,,2007,6,4012,4266,254
21023,KY,Bracken,,2008,7.3,3947,4258,311
21023,KY,Bracken,,2009,11.7,3797,4301,504
21023,KY,Bracken,,2010,11.5,3543,4002,459
21023,KY,Bracken,,2011,10.7,3563,3990,427
21023,KY,Bracken,,2012,9.5,3577,3952,375
21023,KY,Bracken,,2013,9.7,3550,3932,382
21023,KY,Bracken,,2014,7.9,3501,3800,299
21023,KY,Bracken,,2015,6.2,3492,3723,231
21023,KY,Bracken,,2016,5.9,3604,3831,227
21023,KY,Bracken,,2017,5.7,3614,3833,219
21023,KY,Bracken,,2018,4.8,3626,3808,182
21023,KY,Bracken,,2019,4.6,3689,3867,178
21023,KY,Bracken,,2020,6,3490,3713,223
21023,KY,Bracken,,2021,4.7,3597,3775,178
21025,KY,Breathitt,,2007,7,5256,5650,394
21025,KY,Breathitt,,2008,7.4,5225,5640,415
21025,KY,Breathitt,,2009,10.6,5083,5688,605
21025,KY,Breathitt,,2010,13.6,3933,4554,621
21025,KY,Breathitt,,2011,12.7,3858,4421,563
21025,KY,Breathitt,,2012,14.5,3881,4541,660
21025,KY,Breathitt,,2013,14.8,3820,4482,662
21025,KY,Breathitt,,2014,11.4,3705,4180,475
21025,KY,Breathitt,,2015,9.7,3443,3814,371
21025,KY,Breathitt,,2016,9.7,3381,3745,364
21025,KY,Breathitt,,2017,8.6,3419,3741,322
21025,KY,Breathitt,,2018,7.1,3359,3614,255
21025,KY,Breathitt,,2019,7.1,3223,3469,246
21025,KY,Breathitt,,2020,9.9,2928,3251,323
21025,KY,Breathitt,,2021,8.6,2979,3261,282
21027,KY,Breckinridge,,2007,6,8567,9113,546
21027,KY,Breckinridge,,2008,7.5,8496,9187,691
21027,KY,Breckinridge,,2009,12.3,8252,9406,1154
21027,KY,Breckinridge,,2010,13,7232,8317,1085
21027,KY,Breckinridge,,2011,11.5,7343,8299,956
21027,KY,Breckinridge,,2012,9.7,7482,8286,804
21027,KY,Breckinridge,,2013,9.1,7495,8244,749
21027,KY,Breckinridge,,2014,7.2,7506,8087,581
21027,KY,Breckinridge,,2015,6.1,7185,7651,466
21027,KY,Breckinridge,,2016,6.2,7256,7736,480
21027,KY,Breckinridge,,2017,5.9,7548,8019,471
21027,KY,Breckinridge,,2018,5.3,7524,7941,417
21027,KY,Breckinridge,,2019,5.1,7539,7941,402
21027,KY,Breckinridge,,2020,7,7268,7818,550
21027,KY,Breckinridge,,2021,5.2,7601,8021,420
21029,KY,Bullitt,,2007,5.6,36805,38998,2193
21029,KY,Bullitt,,2008,7,36711,39487,2776
21029,KY,Bullitt,,2009,11.2,35382,39859,4477
21029,KY,Bullitt,,2010,10.8,34815,39018,4203
21029,KY,Bullitt,,2011,9.9,35177,39048,3871
21029,KY,Bullitt,,2012,8.1,36099,39284,3185
21029,KY,Bullitt,,2013,7.3,36777,39682,2905
21029,KY,Bullitt,,2014,5.8,36963,39228,2265
21029,KY,Bullitt,,2015,4.5,37652,39420,1768
21029,KY,Bullitt,,2016,4.1,38873,40534,1661
21029,KY,Bullitt,,2017,4.1,40109,41837,1728
21029,KY,Bullitt,,2018,3.9,41035,42708,1673
21029,KY,Bullitt,,2019,3.9,41592,43282,1690
21029,KY,Bullitt,,2020,6.2,39551,42153,2602
21029,KY,Bullitt,,2021,4.6,40800,42784,1984
21031,KY,Butler,,2007,6.3,5256,5611,355
21031,KY,Butler,,2008,8,5042,5478,436
21031,KY,Butler,,2009,14.9,4700,5522,822
21031,KY,Butler,,2010,12.1,4822,5485,663
21031,KY,Butler,,2011,10.7,4880,5464,584
21031,KY,Butler,,2012,9,4925,5414,489
21031,KY,Butler,,2013,9.1,4888,5375,487
21031,KY,Butler,,2014,7.5,4804,5191,387
21031,KY,Butler,,2015,5.8,4795,5092,297
21031,KY,Butler,,2016,5.4,4884,5161,277
21031,KY,Butler,,2017,5.4,4906,5186,280
21031,KY,Butler,,2018,4.8,4859,5104,245
21031,KY,Butler,,2019,4.6,4906,5142,236
21031,KY,Butler,,2020,6.8,4528,4858,330
21031,KY,Butler,,2021,4.6,4719,4945,226
21033,KY,Caldwell,,2007,5.3,6290,6641,351
21033,KY,Caldwell,,2008,6.6,6244,6686,442
21033,KY,Caldwell,,2009,10.4,6203,6924,721
21033,KY,Caldwell,,2010,10.6,5315,5948,633
21033,KY,Caldwell,,2011,9.6,5164,5712,548
21033,KY,Caldwell,,2012,8.4,5205,5681,476
21033,KY,Caldwell,,2013,8.1,5176,5633,457
21033,KY,Caldwell,,2014,6.5,5099,5453,354
21033,KY,Caldwell,,2015,5.5,5006,5299,293
21033,KY,Caldwell,,2016,5.4,5067,5356,289
21033,KY,Caldwell,,2017,5.2,5062,5341,279
21033,KY,Caldwell,,2018,4.6,5133,5382,249
21033,KY,Caldwell,,2019,4.7,5220,5478,258
21033,KY,Caldwell,,2020,5.9,5253,5585,332
21033,KY,Caldwell,,2021,4.2,5661,5910,249
21035,KY,Calloway,,2007,5.4,16824,17778,954
21035,KY,Calloway,,2008,5.9,16823,17873,1050
21035,KY,Calloway,,2009,8.7,16403,17963,1560
21035,KY,Calloway,,2010,8.1,17463,19008,1545
21035,KY,Calloway,,2011,7.5,17643,19067,1424
21035,KY,Calloway,,2012,7.1,17013,18313,1300
21035,KY,Calloway,,2013,7.2,16842,18147,1305
21035,KY,Calloway,,2014,5.7,17644,18719,1075
21035,KY,Calloway,,2015,4.6,17693,18544,851
21035,KY,Calloway,,2016,4.5,17860,18694,834
21035,KY,Calloway,,2017,4.3,17987,18798,811
21035,KY,Calloway,,2018,3.8,18022,18734,712
21035,KY,Calloway,,2019,3.9,17999,18726,727
21035,KY,Calloway,,2020,6,16707,17775,1068
21035,KY,Calloway,,2021,4.5,16807,17608,801
21037,KY,Campbell,,2007,5,42391,44606,2215
21037,KY,Campbell,,2008,6.1,41819,44544,2725
21037,KY,Campbell,,2009,10.4,40460,45146,4686
21037,KY,Campbell,,2010,9.2,44467,48957,4490
21037,KY,Campbell,,2011,8.3,44884,48928,4044
21037,KY,Campbell,,2012,7,45436,48832,3396
21037,KY,Campbell,,2013,6.5,45596,48769,3173
21037,KY,Campbell,,2014,5.2,45428,47899,2471
21037,KY,Campbell,,2015,4.1,45840,47793,1953
21037,KY,Campbell,,2016,3.8,46893,48731,1838
21037,KY,Campbell,,2017,3.7,48039,49884,1845
21037,KY,Campbell,,2018,3.2,48871,50490,1619
21037,KY,Campbell,,2019,3.3,49586,51272,1686
21037,KY,Campbell,,2020,5.4,46891,49546,2655
21037,KY,Campbell,,2021,4,48242,50276,2034
21039,KY,Carlisle,,2007,6.1,2127,2264,137
21039,KY,Carlisle,,2008,6.6,2128,2278,150
21039,KY,Carlisle,,2009,9.2,2127,2343,216
21039,KY,Carlisle,,2010,9.2,2055,2262,207
21039,KY,Carlisle,,2011,8.9,2107,2312,205
21039,KY,Carlisle,,2012,8,2154,2341,187
21039,KY,Carlisle,,2013,7.1,2208,2377,169
21039,KY,Carlisle,,2014,6,2240,2382,142
21039,KY,Carlisle,,2015,5.8,2096,2226,130
21039,KY,Carlisle,,2016,6.4,2401,2565,164
21039,KY,Carlisle,,2017,6.8,2223,2385,162
21039,KY,Carlisle,,2018,4.8,2146,2255,109
21039,KY,Carlisle,,2019,4,2150,2239,89
21039,KY,Carlisle,,2020,4.5,2065,2162,97
21039,KY,Carlisle,,2021,3.8,2158,2244,86
21041,KY,Carroll,,2007,5.4,5426,5735,309
21041,KY,Carroll,,2008,7.5,5140,5559,419
21041,KY,Carroll,,2009,13.6,4723,5465,742
21041,KY,Carroll,,2010,14.6,4292,5027,735
21041,KY,Carroll,,2011,12.1,4500,5122,622
21041,KY,Carroll,,2012,10.3,4547,5068,521
21041,KY,Carroll,,2013,9.1,4700,5168,468
21041,KY,Carroll,,2014,7.1,4524,4870,346
21041,KY,Carroll,,2015,5.5,4733,5007,274
21041,KY,Carroll,,2016,4.9,4930,5183,253
21041,KY,Carroll,,2017,4.5,4777,5004,227
21041,KY,Carroll,,2018,4,5038,5247,209
21041,KY,Carroll,,2019,3.7,5135,5334,199
21041,KY,Carroll,,2020,5.7,4991,5293,302
21041,KY,Carroll,,2021,4.1,5169,5391,222
21043,KY,Carter,,2007,7.1,12566,13523,957
21043,KY,Carter,,2008,8.2,12255,13355,1100
21043,KY,Carter,,2009,13,11801,13563,1762
21043,KY,Carter,,2010,14.2,10286,11990,1704
21043,KY,Carter,,2011,13.8,10108,11723,1615
21043,KY,Carter,,2012,12.6,10056,11500,1444
21043,KY,Carter,,2013,12.5,9647,11031,1384
21043,KY,Carter,,2014,10.7,9364,10485,1121
21043,KY,Carter,,2015,10,8937,9929,992
21043,KY,Carter,,2016,10.4,8899,9934,1035
21043,KY,Carter,,2017,9.7,8955,9912,957
21043,KY,Carter,,2018,9,8937,9820,883
21043,KY,Carter,,2019,7.9,8957,9724,767
21043,KY,Carter,,2020,9.3,8635,9522,887
21043,KY,Carter,,2021,7.8,8940,9695,755
21045,KY,Casey,,2007,5.5,6928,7332,404
21045,KY,Casey,,2008,6.4,6693,7150,457
21045,KY,Casey,,2009,11,6371,7162,791
21045,KY,Casey,,2010,11.1,6180,6951,771
21045,KY,Casey,,2011,10,6300,6997,697
21045,KY,Casey,,2012,8.4,6287,6865,578
21045,KY,Casey,,2013,8.5,6231,6813,582
21045,KY,Casey,,2014,6.8,6172,6620,448
21045,KY,Casey,,2015,5.7,6133,6504,371
21045,KY,Casey,,2016,4.8,6371,6689,318
21045,KY,Casey,,2017,4.7,6368,6684,316
21045,KY,Casey,,2018,4.6,6405,6711,306
21045,KY,Casey,,2019,4,6468,6737,269
21045,KY,Casey,,2020,6,6255,6655,400
21045,KY,Casey,,2021,4.1,6486,6766,280
21047,KY,Christian,,2007,6.3,27643,29507,1864
21047,KY,Christian,,2008,8.4,26656,29085,2429
21047,KY,Christian,,2009,12.8,25702,29485,3783
21047,KY,Christian,,2010,11.8,24207,27446,3239
21047,KY,Christian,,2011,10.8,23983,26876,2893
21047,KY,Christian,,2012,9.4,24248,26755,2507
21047,KY,Christian,,2013,9.3,24122,26605,2483
21047,KY,Christian,,2014,7.6,23505,25431,1926
21047,KY,Christian,,2015,6.3,23368,24932,1564
21047,KY,Christian,,2016,6.1,23381,24889,1508
21047,KY,Christian,,2017,6,22999,24471,1472
21047,KY,Christian,,2018,5.2,23248,24529,1281
21047,KY,Christian,,2019,5.3,23180,24489,1309
21047,KY,Christian,,2020,7.7,22573,24460,1887
21047,KY,Christian,,2021,5.8,23351,24795,1444
21049,KY,Clark,,2007,4.8,16426,17261,835
21049,KY,Clark,,2008,6.4,16055,17154,1099
21049,KY,Clark,,2009,11.5,15126,17083,1957
21049,KY,Clark,,2010,10.9,15927,17866,1939
21049,KY,Clark,,2011,9.8,15849,17579,1730
21049,KY,Clark,,2012,8.2,15997,17424,1427
21049,KY,Clark,,2013,7.5,15984,17272,1288
21049,KY,Clark,,2014,6.1,15948,16983,1035
21049,KY,Clark,,2015,5.1,16002,16870,868
21049,KY,Clark,,2016,4.7,16215,17023,808
21049,KY,Clark,,2017,4.5,16500,17285,785
21049,KY,Clark,,2018,4,16445,17132,687
21049,KY,Clark,,2019,3.7,16636,17277,641
21049,KY,Clark,,2020,6.3,15887,16960,1073
21049,KY,Clark,,2021,4.4,16304,17054,750
21051,KY,Clay,,2007,10.6,6268,7008,740
21051,KY,Clay,,2008,10.5,6112,6826,714
21051,KY,Clay,,2009,14.2,5995,6990,995
21051,KY,Clay,,2010,14.7,5175,6064,889
21051,KY,Clay,,2011,15,5157,6066,909
21051,KY,Clay,,2012,14.1,5123,5961,838
21051,KY,Clay,,2013,14.2,4934,5748,814
21051,KY,Clay,,2014,11.1,4936,5555,619
21051,KY,Clay,,2015,9.6,4775,5282,507
21051,KY,Clay,,2016,10,4904,5449,545
21051,KY,Clay,,2017,8.6,4894,5357,463
21051,KY,Clay,,2018,6.8,4853,5209,356
21051,KY,Clay,,2019,6.6,4827,5170,343
21051,KY,Clay,,2020,8.2,4742,5168,426
21051,KY,Clay,,2021,6.8,4835,5187,352
21053,KY,Clinton,,2007,5.2,4404,4647,243
21053,KY,Clinton,,2008,6.5,4418,4727,309
21053,KY,Clinton,,2009,9.8,4382,4860,478
21053,KY,Clinton,,2010,11.1,3819,4296,477
21053,KY,Clinton,,2011,11.4,3804,4292,488
21053,KY,Clinton,,2012,11,3788,4254,466
21053,KY,Clinton,,2013,10.4,3687,4113,426
21053,KY,Clinton,,2014,9,3645,4005,360
21053,KY,Clinton,,2015,8.3,3477,3791,314
21053,KY,Clinton,,2016,7.4,3470,3749,279
21053,KY,Clinton,,2017,6.4,3613,3861,248
21053,KY,Clinton,,2018,5.3,3660,3865,205
21053,KY,Clinton,,2019,5.2,3780,3987,207
21053,KY,Clinton,,2020,4.9,3757,3952,195
21053,KY,Clinton,,2021,4.4,3784,3960,176
21055,KY,Crittenden,,2007,6.1,3573,3804,231
21055,KY,Crittenden,,2008,6.6,3774,4041,267
21055,KY,Crittenden,,2009,11,3666,4120,454
21055,KY,Crittenden,,2010,10.1,3675,4086,411
21055,KY,Crittenden,,2011,8.5,3829,4183,354
21055,KY,Crittenden,,2012,7.7,3839,4160,321
21055,KY,Crittenden,,2013,7.3,3799,4100,301
21055,KY,Crittenden,,2014,6.2,3634,3873,239
21055,KY,Crittenden,,2015,5.5,3513,3717,204
21055,KY,Crittenden,,2016,5.2,3814,4022,208
21055,KY,Crittenden,,2017,5.4,3768,3983,215
21055,KY,Crittenden,,2018,5,3668,3862,194
21055,KY,Crittenden,,2019,4.6,3601,3776,175
21055,KY,Crittenden,,2020,5.4,3476,3673,197
21055,KY,Crittenden,,2021,4.3,3644,3809,165
21057,KY,Cumberland,,2007,6.9,2763,2968,205
21057,KY,Cumberland,,2008,7.9,2723,2957,234
21057,KY,Cumberland,,2009,13.4,2663,3074,411
21057,KY,Cumberland,,2010,11.9,2812,3191,379
21057,KY,Cumberland,,2011,11,2783,3126,343
21057,KY,Cumberland,,2012,10.8,2783,3121,338
21057,KY,Cumberland,,2013,10.6,2717,3038,321
21057,KY,Cumberland,,2014,7.5,2728,2950,222
21057,KY,Cumberland,,2015,5.9,2696,2866,170
21057,KY,Cumberland,,2016,5.6,2728,2890,162
21057,KY,Cumberland,,2017,5.2,2787,2940,153
21057,KY,Cumberland,,2018,4.3,2983,3118,135
21057,KY,Cumberland,,2019,3.9,3096,3223,127
21057,KY,Cumberland,,2020,4.7,3101,3255,154
21057,KY,Cumberland,,2021,3.5,3191,3307,116
21059,KY,Daviess,,2007,4.8,44919,47197,2278
21059,KY,Daviess,,2008,5.8,44735,47474,2739
21059,KY,Daviess,,2009,9.7,43699,48386,4687
21059,KY,Daviess,,2010,9.4,42700,47121,4421
21059,KY,Daviess,,2011,8.3,43877,47868,3991
21059,KY,Daviess,,2012,7,44880,48275,3395
21059,KY,Daviess,,2013,6.8,44408,47652,3244
21059,KY,Daviess,,2014,5.6,43358,45952,2594
21059,KY,Daviess,,2015,4.5,43527,45598,2071
21059,KY,Daviess,,2016,4.4,44636,46692,2056
21059,KY,Daviess,,2017,4.3,45896,47947,2051
21059,KY,Daviess,,2018,3.9,45598,47440,1842
21059,KY,Daviess,,2019,3.7,45476,47218,1742
21059,KY,Daviess,,2020,5.9,43163,45857,2694
21059,KY,Daviess,,2021,4.3,44290,46297,2007
21061,KY,Edmonson,,2007,6.3,4994,5330,336
21061,KY,Edmonson,,2008,7.6,4929,5336,407
21061,KY,Edmonson,,2009,14.2,4542,5294,752
21061,KY,Edmonson,,2010,13.4,4458,5150,692
21061,KY,Edmonson,,2011,11.7,4535,5134,599
21061,KY,Edmonson,,2012,10,4532,5036,504
21061,KY,Edmonson,,2013,9.9,4500,4996,496
21061,KY,Edmonson,,2014,8.3,4384,4782,398
21061,KY,Edmonson,,2015,6.9,4355,4680,325
21061,KY,Edmonson,,2016,6.1,4511,4804,293
21061,KY,Edmonson,,2017,5.9,4575,4861,286
21061,KY,Edmonson,,2018,5.2,4559,4809,250
21061,KY,Edmonson,,2019,4.7,4534,4760,226
21061,KY,Edmonson,,2020,7.5,4247,4589,342
21061,KY,Edmonson,,2021,5.1,4418,4655,237
21063,KY,Elliott,,2007,7.5,2818,3046,228
21063,KY,Elliott,,2008,8.4,2890,3156,266
21063,KY,Elliott,,2009,14,2827,3286,459
21063,KY,Elliott,,2010,16,2028,2413,385
21063,KY,Elliott,,2011,15.7,1969,2337,368
21063,KY,Elliott,,2012,14.4,1973,2306,333
21063,KY,Elliott,,2013,14.4,1930,2254,324
21063,KY,Elliott,,2014,11.3,1911,2154,243
21063,KY,Elliott,,2015,10.2,1829,2036,207
21063,KY,Elliott,,2016,11.4,1858,2096,238
21063,KY,Elliott,,2017,10.4,1894,2115,221
21063,KY,Elliott,,2018,9.1,1861,2047,186
21063,KY,Elliott,,2019,7.8,1868,2026,158
21063,KY,Elliott,,2020,9.7,1761,1950,189
21063,KY,Elliott,,2021,8.4,1734,1892,158
21065,KY,Estill,,2007,6.4,5735,6128,393
21065,KY,Estill,,2008,7.8,5703,6188,485
21065,KY,Estill,,2009,13,5598,6433,835
21065,KY,Estill,,2010,13.7,4944,5726,782
21065,KY,Estill,,2011,12.4,4924,5620,696
21065,KY,Estill,,2012,10,5057,5622,565
21065,KY,Estill,,2013,9.6,5002,5536,534
21065,KY,Estill,,2014,7.5,5003,5408,405
21065,KY,Estill,,2015,6.1,4874,5192,318
21065,KY,Estill,,2016,5.8,4936,5241,305
21065,KY,Estill,,2017,5.9,5035,5348,313
21065,KY,Estill,,2018,5.3,5033,5315,282
21065,KY,Estill,,2019,4.7,5119,5372,253
21065,KY,Estill,,2020,7.3,4761,5137,376
21065,KY,Estill,,2021,5.2,4871,5137,266
21067,KY,Fayette,,2007,4,145461,151497,6036
21067,KY,Fayette,,2008,4.9,143168,150541,7373
21067,KY,Fayette,,2009,8.1,139945,152340,12395
21067,KY,Fayette,,2010,7.5,151818,164103,12285
21067,KY,Fayette,,2011,6.8,154034,165355,11321
21067,KY,Fayette,,2012,5.9,156575,166321,9746
21067,KY,Fayette,,2013,5.7,158808,168491,9683
21067,KY,Fayette,,2014,4.8,159106,167074,7968
21067,KY,Fayette,,2015,3.8,161561,167924,6363
21067,KY,Fayette,,2016,3.5,165460,171498,6038
21067,KY,Fayette,,2017,3.6,169153,175398,6245
21067,KY,Fayette,,2018,3.2,168551,174189,5638
21067,KY,Fayette,,2019,3.1,170248,175752,5504
21067,KY,Fayette,,2020,5.6,162258,171813,9555
21067,KY,Fayette,,2021,3.9,166393,173189,6796
21069,KY,Fleming,,2007,6.4,6078,6494,416
21069,KY,Fleming,,2008,7.3,6009,6480,471
21069,KY,Fleming,,2009,12.8,5721,6564,843
21069,KY,Fleming,,2010,11.6,5965,6749,784
21069,KY,Fleming,,2011,10.6,5796,6482,686
21069,KY,Fleming,,2012,9.1,5892,6482,590
21069,KY,Fleming,,2013,9.4,5909,6522,613
21069,KY,Fleming,,2014,7.7,5881,6371,490
21069,KY,Fleming,,2015,6.3,5691,6071,380
21069,KY,Fleming,,2016,6.2,5579,5945,366
21069,KY,Fleming,,2017,6,5701,6063,362
21069,KY,Fleming,,2018,5.3,5753,6076,323
21069,KY,Fleming,,2019,5.1,5902,6222,320
21069,KY,Fleming,,2020,7.1,5675,6108,433
21069,KY,Fleming,,2021,4.9,5750,6049,299
21071,KY,Floyd,,2007,6.5,14129,15107,978
21071,KY,Floyd,,2008,6.8,14288,15323,1035
21071,KY,Floyd,,2009,11.4,13873,15653,1780
21071,KY,Floyd,,2010,13.6,12113,14018,1905
21071,KY,Floyd,,2011,11.1,12217,13750,1533
21071,KY,Floyd,,2012,11.7,12142,13744,1602
21071,KY,Floyd,,2013,13.1,11404,13130,1726
21071,KY,Floyd,,2014,10.2,11135,12404,1269
21071,KY,Floyd,,2015,9.4,10468,11551,1083
21071,KY,Floyd,,2016,11.2,10169,11447,1278
21071,KY,Floyd,,2017,8.2,10349,11272,923
21071,KY,Floyd,,2018,6.4,10213,10907,694
21071,KY,Floyd,,2019,6,10417,11087,670
21071,KY,Floyd,,2020,8.8,9707,10643,936
21071,KY,Floyd,,2021,7.1,10033,10797,764
21073,KY,Franklin,,2007,4.5,24003,25133,1130
21073,KY,Franklin,,2008,5.9,23417,24877,1460
21073,KY,Franklin,,2009,9.3,22322,24607,2285
21073,KY,Franklin,,2010,8.8,22574,24748,2174
21073,KY,Franklin,,2011,7.9,22728,24675,1947
21073,KY,Franklin,,2012,6.7,22913,24565,1652
21073,KY,Franklin,,2013,6.5,22981,24581,1600
21073,KY,Franklin,,2014,5.3,23085,24370,1285
21073,KY,Franklin,,2015,4.2,23294,24316,1022
21073,KY,Franklin,,2016,4,23466,24448,982
21073,KY,Franklin,,2017,4,23786,24783,997
21073,KY,Franklin,,2018,3.6,24072,24974,902
21073,KY,Franklin,,2019,3.5,24306,25198,892
21073,KY,Franklin,,2020,6.3,23168,24731,1563
21073,KY,Franklin,,2021,4.4,24081,25190,1109
21075,KY,Fulton,,2007,7.5,2509,2711,202
21075,KY,Fulton,,2008,7.7,2511,2721,210
21075,KY,Fulton,,2009,13.2,2336,2692,356
21075,KY,Fulton,,2010,11.6,2425,2743,318
21075,KY,Fulton,,2011,12.4,2333,2662,329
21075,KY,Fulton,,2012,11.3,2202,2483,281
21075,KY,Fulton,,2013,10.7,2132,2387,255
21075,KY,Fulton,,2014,8.3,2044,2229,185
21075,KY,Fulton,,2015,7.6,1905,2062,157
21075,KY,Fulton,,2016,6.8,1925,2066,141
21075,KY,Fulton,,2017,7.1,1919,2065,146
21075,KY,Fulton,,2018,5.5,1918,2030,112
21075,KY,Fulton,,2019,5.4,1925,2035,110
21075,KY,Fulton,,2020,6.4,1857,1985,128
21075,KY,Fulton,,2021,5.3,1965,2075,110
21077,KY,Gallatin,,2007,5.4,3690,3899,209
21077,KY,Gallatin,,2008,7.1,3650,3931,281
21077,KY,Gallatin,,2009,12.6,3532,4043,511
21077,KY,Gallatin,,2010,12.4,3588,4098,510
21077,KY,Gallatin,,2011,10.7,3584,4014,430
21077,KY,Gallatin,,2012,9.4,3576,3946,370
21077,KY,Gallatin,,2013,9.2,3588,3953,365
21077,KY,Gallatin,,2014,7,3595,3864,269
21077,KY,Gallatin,,2015,5.1,3646,3842,196
21077,KY,Gallatin,,2016,4.8,3717,3904,187
21077,KY,Gallatin,,2017,4.5,3859,4039,180
21077,KY,Gallatin,,2018,4,3905,4066,161
21077,KY,Gallatin,,2019,3.8,3966,4122,156
21077,KY,Gallatin,,2020,5.8,3718,3948,230
21077,KY,Gallatin,,2021,4.3,3828,4000,172
21079,KY,Garrard,,2007,5.6,7267,7698,431
21079,KY,Garrard,,2008,6.6,7101,7603,502
21079,KY,Garrard,,2009,12.3,6808,7760,952
21079,KY,Garrard,,2010,11.2,7080,7977,897
21079,KY,Garrard,,2011,10,7046,7829,783
21079,KY,Garrard,,2012,8.5,7098,7756,658
21079,KY,Garrard,,2013,8.1,7118,7747,629
21079,KY,Garrard,,2014,6.5,7098,7592,494
21079,KY,Garrard,,2015,5.1,7109,7492,383
21079,KY,Garrard,,2016,4.8,7165,7527,362
21079,KY,Garrard,,2017,4.8,7293,7659,366
21079,KY,Garrard,,2018,4.3,7327,7659,332
21079,KY,Garrard,,2019,4.4,7381,7720,339
21079,KY,Garrard,,2020,6.1,7058,7516,458
21079,KY,Garrard,,2021,4.5,7289,7629,340
21081,KY,Grant,,2007,5.5,11920,12611,691
21081,KY,Grant,,2008,7.1,11916,12820,904
21081,KY,Grant,,2009,12,11345,12894,1549
21081,KY,Grant,,2010,11.9,10351,11747,1396
21081,KY,Grant,,2011,10.6,10415,11652,1237
21081,KY,Grant,,2012,9.1,10462,11508,1046
21081,KY,Grant,,2013,8.2,10559,11506,947
21081,KY,Grant,,2014,6.5,10477,11208,731
21081,KY,Grant,,2015,5.3,10503,11085,582
21081,KY,Grant,,2016,4.8,10806,11350,544
21081,KY,Grant,,2017,4.8,11052,11608,556
21081,KY,Grant,,2018,4.2,11205,11694,489
21081,KY,Grant,,2019,3.9,11295,11755,460
21081,KY,Grant,,2020,6.8,10796,11589,793
21081,KY,Grant,,2021,4.5,11113,11637,524
21083,KY,Graves,,2007,6.2,14978,15975,997
21083,KY,Graves,,2008,7,14761,15865,1104
21083,KY,Graves,,2009,10.4,14683,16383,1700
21083,KY,Graves,,2010,9.6,15294,16914,1620
21083,KY,Graves,,2011,9.1,15410,16945,1535
21083,KY,Graves,,2012,8.3,15292,16674,1382
21083,KY,Graves,,2013,8.4,15100,16482,1382
21083,KY,Graves,,2014,7.4,14685,15867,1182
21083,KY,Graves,,2015,6.1,14184,15113,929
21083,KY,Graves,,2016,6.1,14366,15305,939
21083,KY,Graves,,2017,5.9,14762,15682,920
21083,KY,Graves,,2018,4.9,14703,15456,753
21083,KY,Graves,,2019,4.3,15130,15816,686
21083,KY,Graves,,2020,5.7,14669,15560,891
21083,KY,Graves,,2021,4.4,15186,15892,706
21085,KY,Grayson,,2007,8.1,10359,11269,910
21085,KY,Grayson,,2008,10,10039,11159,1120
21085,KY,Grayson,,2009,15.3,9768,11530,1762
21085,KY,Grayson,,2010,14.4,9945,11613,1668
21085,KY,Grayson,,2011,12.2,10027,11423,1396
21085,KY,Grayson,,2012,10.3,10149,11318,1169
21085,KY,Grayson,,2013,10.2,10095,11241,1146
21085,KY,Grayson,,2014,8.4,9958,10867,909
21085,KY,Grayson,,2015,6.6,9804,10502,698
21085,KY,Grayson,,2016,6.6,10015,10726,711
21085,KY,Grayson,,2017,6,10242,10893,651
21085,KY,Grayson,,2018,4.8,10429,10952,523
21085,KY,Grayson,,2019,4.8,10473,10998,525
21085,KY,Grayson,,2020,7.5,9840,10641,801
21085,KY,Grayson,,2021,5.6,9923,10512,589
21087,KY,Green,,2007,6.1,5294,5640,346
21087,KY,Green,,2008,7.8,5120,5551,431
21087,KY,Green,,2009,12.3,4997,5698,701
21087,KY,Green,,2010,11.9,4959,5626,667
21087,KY,Green,,2011,9.6,4939,5465,526
21087,KY,Green,,2012,8.4,5000,5456,456
21087,KY,Green,,2013,8.2,4885,5320,435
21087,KY,Green,,2014,6.5,4753,5084,331
21087,KY,Green,,2015,5.3,4701,4963,262
21087,KY,Green,,2016,4.4,4780,5002,222
21087,KY,Green,,2017,4.5,4916,5150,234
21087,KY,Green,,2018,4.1,4868,5077,209
21087,KY,Green,,2019,4.1,4921,5132,211
21087,KY,Green,,2020,5.2,4878,5146,268
21087,KY,Green,,2021,3.7,4984,5177,193
21089,KY,Greenup,,2007,5.4,16567,17516,949
21089,KY,Greenup,,2008,6.3,16454,17563,1109
21089,KY,Greenup,,2009,9.7,16170,17906,1736
21089,KY,Greenup,,2010,11.6,13635,15430,1795
21089,KY,Greenup,,2011,11.2,13540,15247,1707
21089,KY,Greenup,,2012,10,13552,15050,1498
21089,KY,Greenup,,2013,10.1,13297,14793,1496
21089,KY,Greenup,,2014,8.5,13080,14295,1215
21089,KY,Greenup,,2015,7.5,12703,13737,1034
21089,KY,Greenup,,2016,8.5,12698,13884,1186
21089,KY,Greenup,,2017,7.5,12567,13593,1026
21089,KY,Greenup,,2018,6.4,12560,13422,862
21089,KY,Greenup,,2019,6.2,12638,13475,837
21089,KY,Greenup,,2020,8.6,12010,13145,1135
21089,KY,Greenup,,2021,6.8,12130,13020,890
21091,KY,Hancock,,2007,5.1,3981,4195,214
21091,KY,Hancock,,2008,5.9,3958,4206,248
21091,KY,Hancock,,2009,12.2,3814,4345,531
21091,KY,Hancock,,2010,10.4,3658,4081,423
21091,KY,Hancock,,2011,8.3,3748,4089,341
21091,KY,Hancock,,2012,7.2,3853,4152,299
21091,KY,Hancock,,2013,7.2,3807,4101,294
21091,KY,Hancock,,2014,6,3743,3982,239
21091,KY,Hancock,,2015,4.9,3697,3888,191
21091,KY,Hancock,,2016,5.3,3826,4040,214
21091,KY,Hancock,,2017,5,3902,4106,204
21091,KY,Hancock,,2018,4.1,3828,3993,165
21091,KY,Hancock,,2019,3.7,3789,3934,145
21091,KY,Hancock,,2020,5.9,3587,3812,225
21091,KY,Hancock,,2021,4.4,3680,3848,168
21093,KY,Hardin,,2007,5.1,45065,47474,2409
21093,KY,Hardin,,2008,6.3,44701,47696,2995
21093,KY,Hardin,,2009,10.7,42826,47976,5150
21093,KY,Hardin,,2010,9.8,42536,47145,4609
21093,KY,Hardin,,2011,9.2,43199,47563,4364
21093,KY,Hardin,,2012,8.2,43681,47599,3918
21093,KY,Hardin,,2013,7.6,44198,47830,3632
21093,KY,Hardin,,2014,6.2,43744,46629,2885
21093,KY,Hardin,,2015,4.9,44310,46591,2281
21093,KY,Hardin,,2016,4.4,45688,47800,2112
21093,KY,Hardin,,2017,4.5,46563,48753,2190
21093,KY,Hardin,,2018,4,46956,48901,1945
21093,KY,Hardin,,2019,3.9,47315,49238,1923
21093,KY,Hardin,,2020,6.9,44370,47658,3288
21093,KY,Hardin,,2021,4.7,44845,47078,2233
21095,KY,Harlan,,2007,9,9267,10178,911
21095,KY,Harlan,,2008,8.9,9189,10090,901
21095,KY,Harlan,,2009,11.3,9415,10619,1204
21095,KY,Harlan,,2010,12,9016,10247,1231
21095,KY,Harlan,,2011,11.1,8929,10049,1120
21095,KY,Harlan,,2012,14.2,8526,9932,1406
21095,KY,Harlan,,2013,17.9,7801,9503,1702
21095,KY,Harlan,,2014,13.9,7233,8400,1167
21095,KY,Harlan,,2015,12.6,6107,6985,878
21095,KY,Harlan,,2016,13,5862,6738,876
21095,KY,Harlan,,2017,9.8,5841,6474,633
21095,KY,Harlan,,2018,7.1,6069,6536,467
21095,KY,Harlan,,2019,9,6124,6727,603
21095,KY,Harlan,,2020,11.4,5764,6506,742
21095,KY,Harlan,,2021,8.6,5908,6466,558
21097,KY,Harrison,,2007,4.9,8798,9247,449
21097,KY,Harrison,,2008,6.4,8705,9296,591
21097,KY,Harrison,,2009,11.9,8300,9417,1117
21097,KY,Harrison,,2010,11.2,8047,9065,1018
21097,KY,Harrison,,2011,10.1,8073,8976,903
21097,KY,Harrison,,2012,7.9,8199,8905,706
21097,KY,Harrison,,2013,7.5,8092,8747,655
21097,KY,Harrison,,2014,6,7924,8426,502
21097,KY,Harrison,,2015,4.6,7939,8321,382
21097,KY,Harrison,,2016,4.7,8099,8494,395
21097,KY,Harrison,,2017,4.5,8294,8687,393
21097,KY,Harrison,,2018,4,8297,8644,347
21097,KY,Harrison,,2019,4.1,8481,8840,359
21097,KY,Harrison,,2020,6,8156,8672,516
21097,KY,Harrison,,2021,3.9,8426,8766,340
21099,KY,Hart,,2007,5.3,7718,8150,432
21099,KY,Hart,,2008,6.6,7719,8268,549
21099,KY,Hart,,2009,10.8,7452,8352,900
21099,KY,Hart,,2010,10.5,7294,8152,858
21099,KY,Hart,,2011,9.8,7408,8217,809
21099,KY,Hart,,2012,8.3,7464,8142,678
21099,KY,Hart,,2013,7.8,7427,8059,632
21099,KY,Hart,,2014,6.3,7329,7821,492
21099,KY,Hart,,2015,5.1,7275,7665,390
21099,KY,Hart,,2016,4.7,7534,7903,369
21099,KY,Hart,,2017,4.4,7749,8102,353
21099,KY,Hart,,2018,3.9,7731,8044,313
21099,KY,Hart,,2019,4.5,7578,7937,359
21099,KY,Hart,,2020,6.3,7157,7638,481
21099,KY,Hart,,2021,4.4,7307,7645,338
21101,KY,Henderson,,2007,5,21590,22727,1137
21101,KY,Henderson,,2008,6.2,21502,22919,1417
21101,KY,Henderson,,2009,11.1,20762,23356,2594
21101,KY,Henderson,,2010,10.4,20588,22968,2380
21101,KY,Henderson,,2011,9,20868,22923,2055
21101,KY,Henderson,,2012,7.6,20931,22644,1713
21101,KY,Henderson,,2013,7.4,20495,22136,1641
21101,KY,Henderson,,2014,6.1,20346,21657,1311
21101,KY,Henderson,,2015,4.8,20394,21415,1021
21101,KY,Henderson,,2016,4.7,20594,21607,1013
21101,KY,Henderson,,2017,4.5,20996,21976,980
21101,KY,Henderson,,2018,3.7,21164,21983,819
21101,KY,Henderson,,2019,3.7,20875,21672,797
21101,KY,Henderson,,2020,6,19427,20663,1236
21101,KY,Henderson,,2021,4.5,19843,20775,932
21103,KY,Henry,,2007,5.3,7419,7832,413
21103,KY,Henry,,2008,6.3,7305,7795,490
21103,KY,Henry,,2009,11,7124,8000,876
21103,KY,Henry,,2010,9.9,7090,7873,783
21103,KY,Henry,,2011,8.8,7090,7770,680
21103,KY,Henry,,2012,7.3,7138,7703,565
21103,KY,Henry,,2013,7.1,7209,7764,555
21103,KY,Henry,,2014,5.7,7206,7643,437
21103,KY,Henry,,2015,4.6,7309,7660,351
21103,KY,Henry,,2016,4,7606,7927,321
21103,KY,Henry,,2017,4,7808,8135,327
21103,KY,Henry,,2018,3.7,7914,8219,305
21103,KY,Henry,,2019,3.5,7980,8267,287
21103,KY,Henry,,2020,5.6,7574,8023,449
21103,KY,Henry,,2021,4,7825,8151,326
21105,KY,Hickman,,2007,6.8,1899,2037,138
21105,KY,Hickman,,2008,7.1,1953,2102,149
21105,KY,Hickman,,2009,9.2,1933,2129,196
21105,KY,Hickman,,2010,8.3,2121,2312,191
21105,KY,Hickman,,2011,8.9,2084,2288,204
21105,KY,Hickman,,2012,8.1,1990,2166,176
21105,KY,Hickman,,2013,7.1,2008,2161,153
21105,KY,Hickman,,2014,6.2,1997,2129,132
21105,KY,Hickman,,2015,6,1810,1926,116
21105,KY,Hickman,,2016,5.9,1807,1920,113
21105,KY,Hickman,,2017,7.4,1685,1819,134
21105,KY,Hickman,,2018,5.5,1693,1792,99
21105,KY,Hickman,,2019,4.6,1684,1765,81
21105,KY,Hickman,,2020,5.1,1630,1718,88
21105,KY,Hickman,,2021,4.5,1642,1719,77
21107,KY,Hopkins,,2007,5.9,21959,23337,1378
21107,KY,Hopkins,,2008,7.4,21485,23196,1711
21107,KY,Hopkins,,2009,9.6,20841,23062,2221
21107,KY,Hopkins,,2010,9.8,19237,21318,2081
21107,KY,Hopkins,,2011,8.4,19775,21594,1819
21107,KY,Hopkins,,2012,7.8,19917,21591,1674
21107,KY,Hopkins,,2013,7.8,19827,21510,1683
21107,KY,Hopkins,,2014,6.4,19113,20422,1309
21107,KY,Hopkins,,2015,5.7,18028,19114,1086
21107,KY,Hopkins,,2016,5.6,18530,19637,1107
21107,KY,Hopkins,,2017,4.9,18525,19477,952
21107,KY,Hopkins,,2018,4.5,17559,18381,822
21107,KY,Hopkins,,2019,4.3,17656,18453,797
21107,KY,Hopkins,,2020,7.2,16728,18021,1293
21107,KY,Hopkins,,2021,5.1,17106,18031,925
21109,KY,Jackson,,2007,13.6,3756,4346,590
21109,KY,Jackson,,2008,11.4,3650,4121,471
21109,KY,Jackson,,2009,17.1,3582,4319,737
21109,KY,Jackson,,2010,14.2,4437,5170,733
21109,KY,Jackson,,2011,13.5,4589,5306,717
21109,KY,Jackson,,2012,11.8,4568,5181,613
21109,KY,Jackson,,2013,11.5,4278,4833,555
21109,KY,Jackson,,2014,11.4,4059,4582,523
21109,KY,Jackson,,2015,8.8,3818,4188,370
21109,KY,Jackson,,2016,7.8,3841,4166,325
21109,KY,Jackson,,2017,8.3,3760,4101,341
21109,KY,Jackson,,2018,6.8,3808,4087,279
21109,KY,Jackson,,2019,6.1,3875,4125,250
21109,KY,Jackson,,2020,8.3,3701,4038,337
21109,KY,Jackson,,2021,6.3,3840,4097,257
21111,KY,Jefferson,,2007,5.3,337896,356684,18788
21111,KY,Jefferson,,2008,6.4,334260,357046,22786
21111,KY,Jefferson,,2009,10.6,322958,361153,38195
21111,KY,Jefferson,,2010,10.1,342218,380641,38423
21111,KY,Jefferson,,2011,9.4,343900,379699,35799
21111,KY,Jefferson,,2012,8,352232,382783,30551
21111,KY,Jefferson,,2013,7.4,356840,385399,28559
21111,KY,Jefferson,,2014,6,354906,377547,22641
21111,KY,Jefferson,,2015,4.7,359625,377461,17836
21111,KY,Jefferson,,2016,4.4,369938,386769,16831
21111,KY,Jefferson,,2017,4.3,379470,396592,17122
21111,KY,Jefferson,,2018,3.9,384200,399913,15713
21111,KY,Jefferson,,2019,3.8,384392,399654,15262
21111,KY,Jefferson,,2020,6.6,363625,389470,25845
21111,KY,Jefferson,,2021,4.8,375210,394151,18941
21113,KY,Jessamine,,2007,4.4,21852,22863,1011
21113,KY,Jessamine,,2008,5.6,21816,23101,1285
21113,KY,Jessamine,,2009,9.5,20666,22829,2163
21113,KY,Jessamine,,2010,8.6,22709,24833,2124
21113,KY,Jessamine,,2011,7.8,22796,24712,1916
21113,KY,Jessamine,,2012,6.7,23151,24822,1671
21113,KY,Jessamine,,2013,6.4,23479,25094,1615
21113,KY,Jessamine,,2014,5.2,23619,24921,1302
21113,KY,Jessamine,,2015,4.1,24218,25263,1045
21113,KY,Jessamine,,2016,3.9,24677,25667,990
21113,KY,Jessamine,,2017,3.7,25450,26433,983
21113,KY,Jessamine,,2018,3.5,25507,26443,936
21113,KY,Jessamine,,2019,3.4,25870,26794,924
21113,KY,Jessamine,,2020,5.4,24522,25934,1412
21113,KY,Jessamine,,2021,4,25165,26219,1054
21115,KY,Johnson,,2007,6.1,9091,9681,590
21115,KY,Johnson,,2008,7,8870,9533,663
21115,KY,Johnson,,2009,10.7,8877,9944,1067
21115,KY,Johnson,,2010,12.7,7836,8973,1137
21115,KY,Johnson,,2011,10.8,7769,8711,942
21115,KY,Johnson,,2012,10.2,7724,8602,878
21115,KY,Johnson,,2013,10.9,7448,8362,914
21115,KY,Johnson,,2014,9.2,7315,8054,739
21115,KY,Johnson,,2015,8.8,6531,7158,627
21115,KY,Johnson,,2016,10.2,6297,7010,713
21115,KY,Johnson,,2017,8.5,6331,6916,585
21115,KY,Johnson,,2018,6.6,6307,6755,448
21115,KY,Johnson,,2019,6.3,6328,6750,422
21115,KY,Johnson,,2020,8.3,6036,6584,548
21115,KY,Johnson,,2021,7.3,6170,6659,489
21117,KY,Kenton,,2007,4.8,79679,83679,4000
21117,KY,Kenton,,2008,6,78919,83972,5053
21117,KY,Kenton,,2009,10.3,75684,84356,8672
21117,KY,Kenton,,2010,9.9,75923,84234,8311
21117,KY,Kenton,,2011,8.8,76588,83991,7403
21117,KY,Kenton,,2012,7.4,78148,84419,6271
21117,KY,Kenton,,2013,6.9,79184,85096,5912
21117,KY,Kenton,,2014,5.5,78569,83160,4591
21117,KY,Kenton,,2015,4.4,79629,83262,3633
21117,KY,Kenton,,2016,4.1,81306,84740,3434
21117,KY,Kenton,,2017,3.9,83259,86621,3362
21117,KY,Kenton,,2018,3.3,84399,87318,2919
21117,KY,Kenton,,2019,3.4,85773,88746,2973
21117,KY,Kenton,,2020,5.6,81166,85978,4812
21117,KY,Kenton,,2021,4.2,83479,87115,3636
21119,KY,Knott,,2007,6.8,5816,6243,427
21119,KY,Knott,,2008,6.8,5873,6302,429
21119,KY,Knott,,2009,11,5854,6578,724
21119,KY,Knott,,2010,13.6,5147,5956,809
21119,KY,Knott,,2011,11.8,5171,5862,691
21119,KY,Knott,,2012,13.9,5024,5832,808
21119,KY,Knott,,2013,15.3,4733,5586,853
21119,KY,Knott,,2014,11.1,4567,5136,569
21119,KY,Knott,,2015,10.1,4232,4709,477
21119,KY,Knott,,2016,11.4,4035,4556,521
21119,KY,Knott,,2017,8.4,4126,4502,376
21119,KY,Knott,,2018,6.7,4109,4402,293
21119,KY,Knott,,2019,6.5,4191,4481,290
21119,KY,Knott,,2020,8.2,3934,4287,353
21119,KY,Knott,,2021,7.2,3966,4275,309
21121,KY,Knox,,2007,6.7,11797,12642,845
21121,KY,Knox,,2008,7.7,11794,12780,986
21121,KY,Knox,,2009,12.1,11342,12899,1557
21121,KY,Knox,,2010,13.6,9247,10708,1461
21121,KY,Knox,,2011,13.3,9246,10659,1413
21121,KY,Knox,,2012,12.9,9200,10561,1361
21121,KY,Knox,,2013,12.9,9171,10524,1353
21121,KY,Knox,,2014,9.9,9120,10122,1002
21121,KY,Knox,,2015,8.1,8940,9730,790
21121,KY,Knox,,2016,7.9,9115,9896,781
21121,KY,Knox,,2017,7.5,9310,10061,751
21121,KY,Knox,,2018,6.1,9380,9993,613
21121,KY,Knox,,2019,5.6,9386,9947,561
21121,KY,Knox,,2020,8,9089,9874,785
21121,KY,Knox,,2021,6.2,9427,10049,622
21123,KY,Larue,,2007,5.1,6593,6944,351
21123,KY,Larue,,2008,6.6,6529,6988,459
21123,KY,Larue,,2009,12.3,6152,7018,866
21123,KY,Larue,,2010,11.4,5401,6095,694
21123,KY,Larue,,2011,10,5456,6062,606
21123,KY,Larue,,2012,8.6,5439,5952,513
21123,KY,Larue,,2013,8.1,5413,5891,478
21123,KY,Larue,,2014,6.6,5389,5768,379
21123,KY,Larue,,2015,5,5563,5858,295
21123,KY,Larue,,2016,4.5,5632,5900,268
21123,KY,Larue,,2017,4.6,5741,6019,278
21123,KY,Larue,,2018,4.3,5713,5972,259
21123,KY,Larue,,2019,4.3,5750,6006,256
21123,KY,Larue,,2020,7,5432,5841,409
21123,KY,Larue,,2021,4.9,5517,5803,286
21125,KY,Laurel,,2007,5.3,25250,26656,1406
21125,KY,Laurel,,2008,6.7,24397,26144,1747
21125,KY,Laurel,,2009,10.6,23761,26586,2825
21125,KY,Laurel,,2010,11.5,22197,25083,2886
21125,KY,Laurel,,2011,11.4,22176,25043,2867
21125,KY,Laurel,,2012,10.2,22360,24912,2552
21125,KY,Laurel,,2013,9.7,22266,24645,2379
21125,KY,Laurel,,2014,7.6,22302,24137,1835
21125,KY,Laurel,,2015,6.2,21933,23379,1446
21125,KY,Laurel,,2016,6.1,22450,23913,1463
21125,KY,Laurel,,2017,5.8,23243,24664,1421
21125,KY,Laurel,,2018,5,23558,24793,1235
21125,KY,Laurel,,2019,4.6,23750,24896,1146
21125,KY,Laurel,,2020,6.7,23247,24918,1671
21125,KY,Laurel,,2021,4.5,24111,25250,1139
21127,KY,Lawrence,,2007,7.8,5372,5824,452
21127,KY,Lawrence,,2008,8.6,5384,5892,508
21127,KY,Lawrence,,2009,12.3,5458,6226,768
21127,KY,Lawrence,,2010,13.7,5003,5800,797
21127,KY,Lawrence,,2011,11.7,5111,5787,676
21127,KY,Lawrence,,2012,10.6,5039,5639,600
21127,KY,Lawrence,,2013,11.1,4957,5578,621
21127,KY,Lawrence,,2014,9.5,4773,5276,503
21127,KY,Lawrence,,2015,9.5,4499,4969,470
21127,KY,Lawrence,,2016,10.8,4496,5039,543
21127,KY,Lawrence,,2017,8.9,4557,5003,446
21127,KY,Lawrence,,2018,7.1,4703,5060,357
21127,KY,Lawrence,,2019,6.6,4848,5192,344
21127,KY,Lawrence,,2020,8,4788,5206,418
21127,KY,Lawrence,,2021,6.4,4998,5340,342
21129,KY,Lee,,2007,6.5,2642,2827,185
21129,KY,Lee,,2008,7.4,2486,2686,200
21129,KY,Lee,,2009,12.2,2453,2794,341
21129,KY,Lee,,2010,12.7,2273,2604,331
21129,KY,Lee,,2011,12.6,2201,2518,317
21129,KY,Lee,,2012,12.7,2123,2432,309
21129,KY,Lee,,2013,12.4,2078,2371,293
21129,KY,Lee,,2014,9.7,2090,2314,224
21129,KY,Lee,,2015,8.6,1804,1974,170
21129,KY,Lee,,2016,9.6,1714,1897,183
21129,KY,Lee,,2017,8.3,1738,1896,158
21129,KY,Lee,,2018,6.2,1952,2082,130
21129,KY,Lee,,2019,5.4,1990,2104,114
21129,KY,Lee,,2020,6.7,1905,2042,137
21129,KY,Lee,,2021,5.6,1896,2009,113
21131,KY,Leslie,,2007,8.7,3256,3565,309
21131,KY,Leslie,,2008,8.3,3261,3558,297
21131,KY,Leslie,,2009,13,3163,3634,471
21131,KY,Leslie,,2010,13,3154,3627,473
21131,KY,Leslie,,2011,12.6,3182,3641,459
21131,KY,Leslie,,2012,14.3,3081,3596,515
21131,KY,Leslie,,2013,17.4,2883,3492,609
21131,KY,Leslie,,2014,12.8,2769,3176,407
21131,KY,Leslie,,2015,11.1,2550,2867,317
21131,KY,Leslie,,2016,13.3,2417,2789,372
21131,KY,Leslie,,2017,9.9,2463,2734,271
21131,KY,Leslie,,2018,6.9,2437,2618,181
21131,KY,Leslie,,2019,7.8,2468,2676,208
21131,KY,Leslie,,2020,10.5,2307,2578,271
21131,KY,Leslie,,2021,8.1,2328,2534,206
21133,KY,Letcher,,2007,7.4,8113,8762,649
21133,KY,Letcher,,2008,6.9,8125,8731,606
21133,KY,Letcher,,2009,11.1,7830,8811,981
21133,KY,Letcher,,2010,11.5,7701,8705,1004
21133,KY,Letcher,,2011,10.2,7997,8906,909
21133,KY,Letcher,,2012,13.5,7424,8586,1162
21133,KY,Letcher,,2013,16.6,6709,8041,1332
21133,KY,Letcher,,2014,12.3,6355,7246,891
21133,KY,Letcher,,2015,11.5,5843,6603,760
21133,KY,Letcher,,2016,12.3,5634,6421,787
21133,KY,Letcher,,2017,9.2,5714,6293,579
21133,KY,Letcher,,2018,6.2,5854,6244,390
21133,KY,Letcher,,2019,7,5845,6284,439
21133,KY,Letcher,,2020,9.8,5468,6062,594
21133,KY,Letcher,,2021,7.6,5579,6038,459
21135,KY,Lewis,,2007,7.5,5188,5611,423
21135,KY,Lewis,,2008,9.6,5006,5539,533
21135,KY,Lewis,,2009,15.8,4736,5624,888
21135,KY,Lewis,,2010,13.9,4839,5621,782
21135,KY,Lewis,,2011,13,4812,5529,717
21135,KY,Lewis,,2012,11.7,4755,5385,630
21135,KY,Lewis,,2013,12.1,4655,5293,638
21135,KY,Lewis,,2014,9.6,4676,5172,496
21135,KY,Lewis,,2015,8.8,4368,4789,421
21135,KY,Lewis,,2016,9.7,4281,4742,461
21135,KY,Lewis,,2017,9.1,4275,4702,427
21135,KY,Lewis,,2018,8.1,4314,4696,382
21135,KY,Lewis,,2019,8.4,4267,4658,391
21135,KY,Lewis,,2020,9.2,4225,4653,428
21135,KY,Lewis,,2021,7.6,4344,4703,359
21137,KY,Lincoln,,2007,6.5,9938,10628,690
21137,KY,Lincoln,,2008,7.5,9746,10541,795
21137,KY,Lincoln,,2009,13.1,9293,10693,1400
21137,KY,Lincoln,,2010,12.9,9299,10681,1382
21137,KY,Lincoln,,2011,12.2,9155,10430,1275
21137,KY,Lincoln,,2012,10.3,9061,10107,1046
21137,KY,Lincoln,,2013,10.6,8869,9918,1049
21137,KY,Lincoln,,2014,8.8,8510,9332,822
21137,KY,Lincoln,,2015,6.7,8428,9031,603
21137,KY,Lincoln,,2016,6,8599,9148,549
21137,KY,Lincoln,,2017,5.6,8855,9376,521
21137,KY,Lincoln,,2018,4.9,8882,9340,458
21137,KY,Lincoln,,2019,4.7,8932,9377,445
21137,KY,Lincoln,,2020,7.7,8502,9211,709
21137,KY,Lincoln,,2021,5.6,8759,9278,519
21139,KY,Livingston,,2007,5.4,4591,4852,261
21139,KY,Livingston,,2008,6.1,4443,4734,291
21139,KY,Livingston,,2009,10.3,4291,4784,493
21139,KY,Livingston,,2010,12.2,3564,4057,493
21139,KY,Livingston,,2011,10.9,3593,4033,440
21139,KY,Livingston,,2012,9.8,3588,3976,388
21139,KY,Livingston,,2013,9.8,3507,3888,381
21139,KY,Livingston,,2014,8.2,3453,3761,308
21139,KY,Livingston,,2015,7.1,3416,3678,262
21139,KY,Livingston,,2016,7.1,3425,3687,262
21139,KY,Livingston,,2017,7.4,3478,3756,278
21139,KY,Livingston,,2018,6.6,3421,3663,242
21139,KY,Livingston,,2019,5.4,3445,3643,198
21139,KY,Livingston,,2020,7.3,3242,3499,257
21139,KY,Livingston,,2021,6.1,3409,3632,223
21141,KY,Logan,,2007,5.3,11757,12417,660
21141,KY,Logan,,2008,6.4,11617,12413,796
21141,KY,Logan,,2009,11.4,11045,12460,1415
21141,KY,Logan,,2010,10,11409,12680,1271
21141,KY,Logan,,2011,8.9,11359,12471,1112
21141,KY,Logan,,2012,7.6,11271,12198,927
21141,KY,Logan,,2013,7,11282,12137,855
21141,KY,Logan,,2014,5.6,11254,11926,672
21141,KY,Logan,,2015,4.8,10903,11448,545
21141,KY,Logan,,2016,4.3,11225,11735,510
21141,KY,Logan,,2017,4.3,11641,12164,523
21141,KY,Logan,,2018,3.8,11946,12413,467
21141,KY,Logan,,2019,3.8,12114,12596,482
21141,KY,Logan,,2020,5.4,11454,12103,649
21141,KY,Logan,,2021,3.8,11829,12296,467
21143,KY,Lyon,,2007,6.4,3075,3284,209
21143,KY,Lyon,,2008,7.7,3036,3290,254
21143,KY,Lyon,,2009,12.8,2941,3373,432
21143,KY,Lyon,,2010,11.7,2648,2999,351
21143,KY,Lyon,,2011,10.3,2767,3086,319
21143,KY,Lyon,,2012,9.2,2817,3104,287
21143,KY,Lyon,,2013,8.1,2841,3093,252
21143,KY,Lyon,,2014,7,2775,2983,208
21143,KY,Lyon,,2015,5.7,2701,2864,163
21143,KY,Lyon,,2016,5.8,2789,2961,172
21143,KY,Lyon,,2017,5.7,2822,2993,171
21143,KY,Lyon,,2018,4.9,2899,3049,150
21143,KY,Lyon,,2019,4.5,2980,3121,141
21143,KY,Lyon,,2020,5.1,2897,3054,157
21143,KY,Lyon,,2021,4.5,2974,3113,139
21145,KY,McCracken,,2007,4.9,30113,31650,1537
21145,KY,McCracken,,2008,5.8,29355,31174,1819
21145,KY,McCracken,,2009,9.1,28668,31554,2886
21145,KY,McCracken,,2010,9.2,27992,30813,2821
21145,KY,McCracken,,2011,8.6,28378,31056,2678
21145,KY,McCracken,,2012,8,28450,30926,2476
21145,KY,McCracken,,2013,7.8,27920,30287,2367
21145,KY,McCracken,,2014,7,27433,29493,2060
21145,KY,McCracken,,2015,5.7,27102,28732,1630
21145,KY,McCracken,,2016,5.7,27354,29006,1652
21145,KY,McCracken,,2017,6,27903,29670,1767
21145,KY,McCracken,,2018,5.4,27569,29158,1589
21145,KY,McCracken,,2019,4.7,27885,29256,1371
21145,KY,McCracken,,2020,6.9,26768,28743,1975
21145,KY,McCracken,,2021,5,28160,29655,1495
21147,KY,McCreary,,2007,9,5325,5850,525
21147,KY,McCreary,,2008,9.7,5176,5732,556
21147,KY,McCreary,,2009,14.6,5026,5884,858
21147,KY,McCreary,,2010,14.6,4917,5755,838
21147,KY,McCreary,,2011,14.6,4872,5704,832
21147,KY,McCreary,,2012,13.3,4753,5479,726
21147,KY,McCreary,,2013,13,4648,5341,693
21147,KY,McCreary,,2014,10.5,4516,5046,530
21147,KY,McCreary,,2015,8.4,4243,4633,390
21147,KY,McCreary,,2016,8,4234,4600,366
21147,KY,McCreary,,2017,6.8,4374,4691,317
21147,KY,McCreary,,2018,6.1,4344,4627,283
21147,KY,McCreary,,2019,5.7,4453,4720,267
21147,KY,McCreary,,2020,7,4485,4822,337
21147,KY,McCreary,,2021,5.7,4606,4886,280
21149,KY,McLean,,2007,5.8,4315,4580,265
21149,KY,McLean,,2008,7.2,4245,4573,328
21149,KY,McLean,,2009,10.9,4073,4572,499
21149,KY,McLean,,2010,10.3,4079,4549,470
21149,KY,McLean,,2011,8.9,4170,4576,406
21149,KY,McLean,,2012,7.7,4212,4562,350
21149,KY,McLean,,2013,7.6,4141,4481,340
21149,KY,McLean,,2014,6.3,4044,4318,274
21149,KY,McLean,,2015,4.8,4049,4255,206
21149,KY,McLean,,2016,4.8,4127,4333,206
21149,KY,McLean,,2017,5.3,4076,4302,226
21149,KY,McLean,,2018,4.8,4025,4230,205
21149,KY,McLean,,2019,4.2,3991,4168,177
21149,KY,McLean,,2020,5.5,3746,3965,219
21149,KY,McLean,,2021,4.3,3849,4021,172
21151,KY,Madison,,2007,4.7,40696,42707,2011
21151,KY,Madison,,2008,5.6,40615,43003,2388
21151,KY,Madison,,2009,9.5,39148,43261,4113
21151,KY,Madison,,2010,8.6,39550,43266,3716
21151,KY,Madison,,2011,7.8,40700,44166,3466
21151,KY,Madison,,2012,6.8,41616,44645,3029
21151,KY,Madison,,2013,6.5,42783,45764,2981
21151,KY,Madison,,2014,5.4,42882,45326,2444
21151,KY,Madison,,2015,4.3,43268,45192,1924
21151,KY,Madison,,2016,4.1,43253,45115,1862
21151,KY,Madison,,2017,4.2,44242,46177,1935
21151,KY,Madison,,2018,3.7,45113,46866,1753
21151,KY,Madison,,2019,3.6,45919,47657,1738
21151,KY,Madison,,2020,5.9,43156,45840,2684
21151,KY,Madison,,2021,4.1,44742,46664,1922
21153,KY,Magoffin,,2007,10.3,3903,4352,449
21153,KY,Magoffin,,2008,10.8,3817,4279,462
21153,KY,Magoffin,,2009,19.1,3640,4501,861
21153,KY,Magoffin,,2010,20.6,3426,4317,891
21153,KY,Magoffin,,2011,17.1,3449,4160,711
21153,KY,Magoffin,,2012,17.3,3343,4040,697
21153,KY,Magoffin,,2013,17.4,3302,3999,697
21153,KY,Magoffin,,2014,13.9,3207,3726,519
21153,KY,Magoffin,,2015,15.6,2803,3322,519
21153,KY,Magoffin,,2016,19.6,2525,3139,614
21153,KY,Magoffin,,2017,16,2509,2986,477
21153,KY,Magoffin,,2018,12.5,2556,2922,366
21153,KY,Magoffin,,2019,10.4,2792,3116,324
21153,KY,Magoffin,,2020,15.5,2685,3179,494
21153,KY,Magoffin,,2021,12.5,2836,3242,406
21155,KY,Marion,,2007,5.1,9761,10289,528
21155,KY,Marion,,2008,6.5,9598,10266,668
21155,KY,Marion,,2009,13.8,8799,10204,1405
21155,KY,Marion,,2010,12.7,7994,9160,1166
21155,KY,Marion,,2011,10.8,8226,9222,996
21155,KY,Marion,,2012,8.9,8363,9179,816
21155,KY,Marion,,2013,8.1,8548,9297,749
21155,KY,Marion,,2014,6.4,8610,9194,584
21155,KY,Marion,,2015,4.9,8674,9118,444
21155,KY,Marion,,2016,4.2,9010,9402,392
21155,KY,Marion,,2017,4.1,9078,9464,386
21155,KY,Marion,,2018,3.6,9281,9632,351
21155,KY,Marion,,2019,3.6,9380,9734,354
21155,KY,Marion,,2020,7.6,8515,9215,700
21155,KY,Marion,,2021,4.4,8880,9285,405
21157,KY,Marshall,,2007,5.7,13970,14820,850
21157,KY,Marshall,,2008,6.4,13831,14771,940
21157,KY,Marshall,,2009,11,13083,14703,1620
21157,KY,Marshall,,2010,10.6,13840,15483,1643
21157,KY,Marshall,,2011,9.2,14051,15480,1429
21157,KY,Marshall,,2012,8.1,14124,15376,1252
21157,KY,Marshall,,2013,8,14093,15326,1233
21157,KY,Marshall,,2014,6.7,13961,14965,1004
21157,KY,Marshall,,2015,5.5,13986,14807,821
21157,KY,Marshall,,2016,5.7,14058,14912,854
21157,KY,Marshall,,2017,5.8,14159,15036,877
21157,KY,Marshall,,2018,5.2,14173,14945,772
21157,KY,Marshall,,2019,4.4,14448,15117,669
21157,KY,Marshall,,2020,6,13915,14798,883
21157,KY,Marshall,,2021,4.7,13774,14446,672
21159,KY,Martin,,2007,7.8,3181,3451,270
21159,KY,Martin,,2008,7.7,3255,3525,270
21159,KY,Martin,,2009,11.8,3377,3829,452
21159,KY,Martin,,2010,10.4,3600,4017,417
21159,KY,Martin,,2011,8.9,3531,3877,346
21159,KY,Martin,,2012,9.2,3424,3769,345
21159,KY,Martin,,2013,9.7,3290,3642,352
21159,KY,Martin,,2014,9.1,3126,3438,312
21159,KY,Martin,,2015,9.9,2779,3085,306
21159,KY,Martin,,2016,10.2,2769,3083,314
21159,KY,Martin,,2017,7.5,2844,3075,231
21159,KY,Martin,,2018,6.2,2620,2793,173
21159,KY,Martin,,2019,6.7,2498,2677,179
21159,KY,Martin,,2020,11.2,2196,2474,278
21159,KY,Martin,,2021,9.3,2132,2350,218
21161,KY,Mason,,2007,4.6,8419,8823,404
21161,KY,Mason,,2008,6,8279,8809,530
21161,KY,Mason,,2009,11.3,7847,8846,999
21161,KY,Mason,,2010,11.4,7033,7937,904
21161,KY,Mason,,2011,10.3,6890,7685,795
21161,KY,Mason,,2012,9.5,6901,7626,725
21161,KY,Mason,,2013,9.9,7020,7793,773
21161,KY,Mason,,2014,7.9,7134,7744,610
21161,KY,Mason,,2015,6.1,6842,7286,444
21161,KY,Mason,,2016,6.3,6687,7137,450
21161,KY,Mason,,2017,6.1,6782,7222,440
21161,KY,Mason,,2018,5.4,6788,7174,386
21161,KY,Mason,,2019,5.4,6730,7116,386
21161,KY,Mason,,2020,7.7,6324,6853,529
21161,KY,Mason,,2021,5.5,6421,6796,375
21163,KY,Meade,,2007,6,10938,11636,698
21163,KY,Meade,,2008,7.8,10661,11563,902
21163,KY,Meade,,2009,13.4,9987,11533,1546
21163,KY,Meade,,2010,11.9,10927,12403,1476
21163,KY,Meade,,2011,11.2,11402,12845,1443
21163,KY,Meade,,2012,9.8,11398,12639,1241
21163,KY,Meade,,2013,8.9,11420,12535,1115
21163,KY,Meade,,2014,7,11274,12126,852
21163,KY,Meade,,2015,5.5,11136,11785,649
21163,KY,Meade,,2016,5.1,11477,12092,615
21163,KY,Meade,,2017,5.1,11617,12236,619
21163,KY,Meade,,2018,4.5,11685,12241,556
21163,KY,Meade,,2019,4.4,11662,12202,540
21163,KY,Meade,,2020,6.9,10939,11749,810
21163,KY,Meade,,2021,5.3,11061,11679,618
21165,KY,Menifee,,2007,8.5,2417,2641,224
21165,KY,Menifee,,2008,10,2334,2593,259
21165,KY,Menifee,,2009,17.1,2168,2615,447
21165,KY,Menifee,,2010,15.7,2172,2575,403
21165,KY,Menifee,,2011,14,2191,2548,357
21165,KY,Menifee,,2012,11.7,2249,2547,298
21165,KY,Menifee,,2013,12,2191,2489,298
21165,KY,Menifee,,2014,9.8,2127,2357,230
21165,KY,Menifee,,2015,8.5,2152,2353,201
21165,KY,Menifee,,2016,8.6,2188,2393,205
21165,KY,Menifee,,2017,8.6,2164,2367,203
21165,KY,Menifee,,2018,7.4,2143,2315,172
21165,KY,Menifee,,2019,6.6,2175,2329,154
21165,KY,Menifee,,2020,8.6,2056,2250,194
21165,KY,Menifee,,2021,6.9,2150,2309,159
21167,KY,Mercer,,2007,5.1,10091,10637,546
21167,KY,Mercer,,2008,6.3,9825,10491,666
21167,KY,Mercer,,2009,11.8,9241,10479,1238
21167,KY,Mercer,,2010,11.3,9391,10587,1196
21167,KY,Mercer,,2011,10.3,9199,10257,1058
21167,KY,Mercer,,2012,8.3,9400,10249,849
21167,KY,Mercer,,2013,7.8,9399,10192,793
21167,KY,Mercer,,2014,6.1,9294,9903,609
21167,KY,Mercer,,2015,5,9192,9675,483
21167,KY,Mercer,,2016,4.8,9418,9891,473
21167,KY,Mercer,,2017,4.8,9498,9979,481
21167,KY,Mercer,,2018,4.3,9470,9895,425
21167,KY,Mercer,,2019,4.4,9629,10071,442
21167,KY,Mercer,,2020,7,9168,9863,695
21167,KY,Mercer,,2021,4.6,9480,9932,452
21169,KY,Metcalfe,,2007,5.6,4186,4432,246
21169,KY,Metcalfe,,2008,7.1,4100,4412,312
21169,KY,Metcalfe,,2009,16.3,3694,4411,717
21169,KY,Metcalfe,,2010,13.4,4068,4700,632
21169,KY,Metcalfe,,2011,11.2,4104,4621,517
21169,KY,Metcalfe,,2012,8,4074,4428,354
21169,KY,Metcalfe,,2013,7.7,3999,4334,335
21169,KY,Metcalfe,,2014,6.1,3882,4133,251
21169,KY,Metcalfe,,2015,5.1,3813,4020,207
21169,KY,Metcalfe,,2016,4.5,3934,4120,186
21169,KY,Metcalfe,,2017,4,4014,4182,168
21169,KY,Metcalfe,,2018,4.1,3946,4114,168
21169,KY,Metcalfe,,2019,4.5,3925,4112,187
21169,KY,Metcalfe,,2020,7.6,3680,3982,302
21169,KY,Metcalfe,,2021,5.4,3764,3980,216
21171,KY,Monroe,,2007,6.8,4537,4866,329
21171,KY,Monroe,,2008,8.4,4362,4760,398
21171,KY,Monroe,,2009,14.4,4081,4770,689
21171,KY,Monroe,,2010,10.8,4349,4875,526
21171,KY,Monroe,,2011,9,4411,4846,435
21171,KY,Monroe,,2012,7.3,4453,4802,349
21171,KY,Monroe,,2013,7.1,4409,4745,336
21171,KY,Monroe,,2014,5.5,4350,4603,253
21171,KY,Monroe,,2015,4.4,4295,4491,196
21171,KY,Monroe,,2016,4.2,4411,4603,192
21171,KY,Monroe,,2017,3.8,4547,4729,182
21171,KY,Monroe,,2018,4.1,4504,4695,191
21171,KY,Monroe,,2019,3.7,4497,4671,174
21171,KY,Monroe,,2020,5.2,4321,4558,237
21171,KY,Monroe,,2021,4,4452,4637,185
21173,KY,Montgomery,,2007,5.8,11553,12261,708
21173,KY,Montgomery,,2008,7.4,11364,12277,913
21173,KY,Montgomery,,2009,12.9,10888,12504,1616
21173,KY,Montgomery,,2010,12.3,10647,12141,1494
21173,KY,Montgomery,,2011,11.2,10757,12108,1351
21173,KY,Montgomery,,2012,8.9,11237,12332,1095
21173,KY,Montgomery,,2013,8.4,11121,12140,1019
21173,KY,Montgomery,,2014,7.4,10885,11760,875
21173,KY,Montgomery,,2015,6.5,10943,11705,762
21173,KY,Montgomery,,2016,6.4,11101,11854,753
21173,KY,Montgomery,,2017,6.5,10970,11731,761
21173,KY,Montgomery,,2018,5.8,10983,11659,676
21173,KY,Montgomery,,2019,5.1,11053,11643,590
21173,KY,Montgomery,,2020,7.7,10450,11324,874
21173,KY,Montgomery,,2021,5.3,10928,11543,615
21175,KY,Morgan,,2007,8.7,4545,4976,431
21175,KY,Morgan,,2008,9.8,4440,4922,482
21175,KY,Morgan,,2009,14.2,4393,5119,726
21175,KY,Morgan,,2010,13.1,4465,5141,676
21175,KY,Morgan,,2011,11,4669,5244,575
21175,KY,Morgan,,2012,10.7,4666,5224,558
21175,KY,Morgan,,2013,10.5,4524,5056,532
21175,KY,Morgan,,2014,9.4,4346,4795,449
21175,KY,Morgan,,2015,8.2,4042,4405,363
21175,KY,Morgan,,2016,7.9,4130,4485,355
21175,KY,Morgan,,2017,7.3,4181,4508,327
21175,KY,Morgan,,2018,6.2,4193,4470,277
21175,KY,Morgan,,2019,5.1,4349,4582,233
21175,KY,Morgan,,2020,6.6,4106,4395,289
21175,KY,Morgan,,2021,5.8,4077,4326,249
21177,KY,Muhlenberg,,2007,7.9,12494,13570,1076
21177,KY,Muhlenberg,,2008,8.6,12014,13148,1134
21177,KY,Muhlenberg,,2009,11.2,12317,13877,1560
21177,KY,Muhlenberg,,2010,11.1,11663,13112,1449
21177,KY,Muhlenberg,,2011,10.3,11647,12979,1332
21177,KY,Muhlenberg,,2012,9.9,11197,12421,1224
21177,KY,Muhlenberg,,2013,9.3,11760,12966,1206
21177,KY,Muhlenberg,,2014,7.6,11429,12369,940
21177,KY,Muhlenberg,,2015,7.2,10677,11503,826
21177,KY,Muhlenberg,,2016,7.2,10540,11361,821
21177,KY,Muhlenberg,,2017,6.8,10480,11245,765
21177,KY,Muhlenberg,,2018,6.5,9847,10536,689
21177,KY,Muhlenberg,,2019,5.8,9893,10504,611
21177,KY,Muhlenberg,,2020,8.4,9080,9913,833
21177,KY,Muhlenberg,,2021,6.6,9171,9822,651
21179,KY,Nelson,,2007,5.7,20102,21328,1226
21179,KY,Nelson,,2008,7.4,20035,21630,1595
21179,KY,Nelson,,2009,12.9,19345,22206,2861
21179,KY,Nelson,,2010,11.3,19595,22087,2492
21179,KY,Nelson,,2011,10.6,19543,21859,2316
21179,KY,Nelson,,2012,8.3,20086,21909,1823
21179,KY,Nelson,,2013,7.5,20066,21688,1622
21179,KY,Nelson,,2014,6.1,20016,21313,1297
21179,KY,Nelson,,2015,5,19963,21016,1053
21179,KY,Nelson,,2016,4.5,20731,21706,975
21179,KY,Nelson,,2017,4.3,21322,22285,963
21179,KY,Nelson,,2018,4.2,21740,22692,952
21179,KY,Nelson,,2019,4.3,22249,23252,1003
21179,KY,Nelson,,2020,6.8,21163,22696,1533
21179,KY,Nelson,,2021,4.3,22213,23223,1010
21181,KY,Nicholas,,2007,6.3,2833,3022,189
21181,KY,Nicholas,,2008,7.3,2862,3089,227
21181,KY,Nicholas,,2009,12.7,2765,3166,401
21181,KY,Nicholas,,2010,10.2,3278,3650,372
21181,KY,Nicholas,,2011,9,3269,3591,322
21181,KY,Nicholas,,2012,8.3,3244,3537,293
21181,KY,Nicholas,,2013,8.6,3229,3531,302
21181,KY,Nicholas,,2014,7.7,3187,3453,266
21181,KY,Nicholas,,2015,6.2,2978,3175,197
21181,KY,Nicholas,,2016,5.7,3036,3219,183
21181,KY,Nicholas,,2017,5.5,3133,3315,182
21181,KY,Nicholas,,2018,4.5,3134,3281,147
21181,KY,Nicholas,,2019,4.2,3176,3315,139
21181,KY,Nicholas,,2020,6.7,3051,3271,220
21181,KY,Nicholas,,2021,4.3,3171,3314,143
21183,KY,Ohio,,2007,5.2,11402,12030,628
21183,KY,Ohio,,2008,6.4,11740,12549,809
21183,KY,Ohio,,2009,10.1,11411,12698,1287
21183,KY,Ohio,,2010,11.3,9197,10371,1174
21183,KY,Ohio,,2011,9.8,9358,10380,1022
21183,KY,Ohio,,2012,8.7,9482,10390,908
21183,KY,Ohio,,2013,9.2,8991,9902,911
21183,KY,Ohio,,2014,7.7,8794,9523,729
21183,KY,Ohio,,2015,6.3,8720,9307,587
21183,KY,Ohio,,2016,6.6,8894,9524,630
21183,KY,Ohio,,2017,6.2,9179,9788,609
21183,KY,Ohio,,2018,5.5,9313,9860,547
21183,KY,Ohio,,2019,4.8,9285,9758,473
21183,KY,Ohio,,2020,7,8626,9273,647
21183,KY,Ohio,,2021,5.5,8512,9010,498
21185,KY,Oldham,,2007,4.7,26294,27602,1308
21185,KY,Oldham,,2008,5.7,26276,27852,1576
21185,KY,Oldham,,2009,8.7,25655,28104,2449
21185,KY,Oldham,,2010,7.6,27155,29391,2236
21185,KY,Oldham,,2011,6.9,27302,29331,2029
21185,KY,Oldham,,2012,5.9,28045,29802,1757
21185,KY,Oldham,,2013,5.6,28611,30321,1710
21185,KY,Oldham,,2014,4.7,28852,30282,1430
21185,KY,Oldham,,2015,3.8,29747,30938,1191
21185,KY,Oldham,,2016,3.4,30862,31932,1070
21185,KY,Oldham,,2017,3.4,31805,32937,1132
21185,KY,Oldham,,2018,3.2,32214,33276,1062
21185,KY,Oldham,,2019,3.1,32557,33597,1040
21185,KY,Oldham,,2020,4.7,30919,32443,1524
21185,KY,Oldham,,2021,3.6,31915,33100,1185
21187,KY,Owen,,2007,5,5010,5275,265
21187,KY,Owen,,2008,6.5,4969,5317,348
21187,KY,Owen,,2009,10.2,4982,5548,566
21187,KY,Owen,,2010,8.5,5440,5944,504
21187,KY,Owen,,2011,7.6,5281,5713,432
21187,KY,Owen,,2012,6.6,5373,5751,378
21187,KY,Owen,,2013,6.3,5327,5683,356
21187,KY,Owen,,2014,5,5251,5527,276
21187,KY,Owen,,2015,4.1,5150,5370,220
21187,KY,Owen,,2016,4.2,5257,5490,233
21187,KY,Owen,,2017,4.3,5217,5453,236
21187,KY,Owen,,2018,4.8,4954,5204,250
21187,KY,Owen,,2019,4.3,4919,5142,223
21187,KY,Owen,,2020,6.2,4770,5085,315
21187,KY,Owen,,2021,4.3,4875,5092,217
21189,KY,Owsley,,2007,9.1,1435,1579,144
21189,KY,Owsley,,2008,8.1,1409,1533,124
21189,KY,Owsley,,2009,10.9,1407,1580,173
21189,KY,Owsley,,2010,13.4,1186,1370,184
21189,KY,Owsley,,2011,13.3,1209,1394,185
21189,KY,Owsley,,2012,12.9,1157,1328,171
21189,KY,Owsley,,2013,12.5,1129,1290,161
21189,KY,Owsley,,2014,10.4,1056,1179,123
21189,KY,Owsley,,2015,10,1023,1137,114
21189,KY,Owsley,,2016,9.6,1012,1120,108
21189,KY,Owsley,,2017,8.2,1010,1100,90
21189,KY,Owsley,,2018,7.1,1055,1136,81
21189,KY,Owsley,,2019,6.9,1016,1091,75
21189,KY,Owsley,,2020,9.3,978,1078,100
21189,KY,Owsley,,2021,7,980,1054,74
21191,KY,Pendleton,,2007,5.8,6893,7319,426
21191,KY,Pendleton,,2008,7.8,6756,7324,568
21191,KY,Pendleton,,2009,12.9,6389,7332,943
21191,KY,Pendleton,,2010,12.4,6507,7427,920
21191,KY,Pendleton,,2011,10.8,6439,7218,779
21191,KY,Pendleton,,2012,8.9,6440,7068,628
21191,KY,Pendleton,,2013,8.3,6434,7017,583
21191,KY,Pendleton,,2014,6.6,6314,6763,449
21191,KY,Pendleton,,2015,5.3,6321,6672,351
21191,KY,Pendleton,,2016,4.7,6526,6851,325
21191,KY,Pendleton,,2017,4.6,6664,6987,323
21191,KY,Pendleton,,2018,4,6701,6982,281
21191,KY,Pendleton,,2019,3.6,6790,7043,253
21191,KY,Pendleton,,2020,5.1,6417,6759,342
21191,KY,Pendleton,,2021,4.1,6612,6897,285
21193,KY,Perry,,2007,7,10637,11433,796
21193,KY,Perry,,2008,6.9,10451,11225,774
21193,KY,Perry,,2009,11.1,10368,11669,1301
21193,KY,Perry,,2010,11.8,9806,11122,1316
21193,KY,Perry,,2011,10.4,9903,11047,1144
21193,KY,Perry,,2012,12.6,9580,10961,1381
21193,KY,Perry,,2013,13.8,8966,10400,1434
21193,KY,Perry,,2014,10.3,8560,9540,980
21193,KY,Perry,,2015,9,8007,8799,792
21193,KY,Perry,,2016,10.7,7634,8549,915
21193,KY,Perry,,2017,8.1,7717,8401,684
21193,KY,Perry,,2018,6.1,7654,8153,499
21193,KY,Perry,,2019,5.7,7864,8338,474
21193,KY,Perry,,2020,8.6,7432,8132,700
21193,KY,Perry,,2021,6.3,7491,7994,503
21195,KY,Pike,,2007,5.9,23711,25188,1477
21195,KY,Pike,,2008,5.9,24257,25779,1522
21195,KY,Pike,,2009,10,23747,26397,2650
21195,KY,Pike,,2010,10.6,22039,24639,2600
21195,KY,Pike,,2011,9.1,22156,24385,2229
21195,KY,Pike,,2012,9.7,21853,24209,2356
21195,KY,Pike,,2013,11.8,20548,23290,2742
21195,KY,Pike,,2014,10.5,19696,22000,2304
21195,KY,Pike,,2015,9.2,18924,20842,1918
21195,KY,Pike,,2016,10.7,18052,20225,2173
21195,KY,Pike,,2017,7.6,18804,20353,1549
21195,KY,Pike,,2018,5.7,18825,19966,1141
21195,KY,Pike,,2019,5.4,18967,20053,1086
21195,KY,Pike,,2020,8.1,17552,19098,1546
21195,KY,Pike,,2021,6.4,17891,19105,1214
21197,KY,Powell,,2007,6.6,5304,5677,373
21197,KY,Powell,,2008,8.7,4989,5462,473
21197,KY,Powell,,2009,16.2,4843,5777,934
21197,KY,Powell,,2010,15.7,4487,5321,834
21197,KY,Powell,,2011,12.9,4499,5164,665
21197,KY,Powell,,2012,11,4516,5073,557
21197,KY,Powell,,2013,10.7,4517,5056,539
21197,KY,Powell,,2014,8.4,4553,4973,420
21197,KY,Powell,,2015,7,4516,4857,341
21197,KY,Powell,,2016,7.1,4607,4958,351
21197,KY,Powell,,2017,6.5,4699,5027,328
21197,KY,Powell,,2018,5.8,4722,5012,290
21197,KY,Powell,,2019,5.1,4788,5043,255
21197,KY,Powell,,2020,7.2,4684,5045,361
21197,KY,Powell,,2021,4.8,4888,5135,247
21199,KY,Pulaski,,2007,5.9,25611,27210,1599
21199,KY,Pulaski,,2008,6.8,25340,27188,1848
21199,KY,Pulaski,,2009,10.8,24862,27870,3008
21199,KY,Pulaski,,2010,10.7,24934,27921,2987
21199,KY,Pulaski,,2011,10.6,24661,27597,2936
21199,KY,Pulaski,,2012,9.5,24724,27322,2598
21199,KY,Pulaski,,2013,9.1,24766,27246,2480
21199,KY,Pulaski,,2014,7.3,24365,26290,1925
21199,KY,Pulaski,,2015,5.8,23956,25444,1488
21199,KY,Pulaski,,2016,5.4,24021,25388,1367
21199,KY,Pulaski,,2017,5.5,23990,25393,1403
21199,KY,Pulaski,,2018,4.9,24724,25995,1271
21199,KY,Pulaski,,2019,4.5,25487,26677,1190
21199,KY,Pulaski,,2020,7.1,23893,25723,1830
21199,KY,Pulaski,,2021,4.9,24692,25971,1279
21201,KY,Robertson,,2007,4.7,1016,1066,50
21201,KY,Robertson,,2008,6.2,926,987,61
21201,KY,Robertson,,2009,10.4,959,1070,111
21201,KY,Robertson,,2010,11.7,771,873,102
21201,KY,Robertson,,2011,11.1,766,862,96
21201,KY,Robertson,,2012,10.5,762,851,89
21201,KY,Robertson,,2013,10.8,756,848,92
21201,KY,Robertson,,2014,7.8,747,810,63
21201,KY,Robertson,,2015,6.5,730,781,51
21201,KY,Robertson,,2016,6.1,756,805,49
21201,KY,Robertson,,2017,6.1,768,818,50
21201,KY,Robertson,,2018,4.7,763,801,38
21201,KY,Robertson,,2019,5.2,770,812,42
21201,KY,Robertson,,2020,5.8,741,787,46
21201,KY,Robertson,,2021,4.2,767,801,34
21203,KY,Rockcastle,,2007,6.6,6775,7252,477
21203,KY,Rockcastle,,2008,7.4,6712,7249,537
21203,KY,Rockcastle,,2009,13.8,6279,7283,1004
21203,KY,Rockcastle,,2010,11.3,6266,7065,799
21203,KY,Rockcastle,,2011,11.4,6387,7210,823
21203,KY,Rockcastle,,2012,10.3,6457,7195,738
21203,KY,Rockcastle,,2013,9.2,6434,7085,651
21203,KY,Rockcastle,,2014,7.5,6371,6889,518
21203,KY,Rockcastle,,2015,6.3,6438,6872,434
21203,KY,Rockcastle,,2016,6,6280,6683,403
21203,KY,Rockcastle,,2017,5.7,6247,6625,378
21203,KY,Rockcastle,,2018,4.9,6309,6631,322
21203,KY,Rockcastle,,2019,4.6,6358,6662,304
21203,KY,Rockcastle,,2020,7.1,5918,6371,453
21203,KY,Rockcastle,,2021,5,6137,6457,320
21205,KY,Rowan,,2007,5.3,11553,12204,651
21205,KY,Rowan,,2008,6.1,11626,12376,750
21205,KY,Rowan,,2009,9.5,11313,12503,1190
21205,KY,Rowan,,2010,10.2,9848,10969,1121
21205,KY,Rowan,,2011,9.5,10196,11266,1070
21205,KY,Rowan,,2012,8.4,10257,11195,938
21205,KY,Rowan,,2013,8.2,10031,10931,900
21205,KY,Rowan,,2014,6.9,9824,10557,733
21205,KY,Rowan,,2015,5.9,9685,10290,605
21205,KY,Rowan,,2016,5.9,9955,10574,619
21205,KY,Rowan,,2017,5.7,10050,10656,606
21205,KY,Rowan,,2018,5,9989,10519,530
21205,KY,Rowan,,2019,5,9885,10406,521
21205,KY,Rowan,,2020,7.2,9246,9966,720
21205,KY,Rowan,,2021,5.3,9417,9943,526
21207,KY,Russell,,2007,6.1,7650,8148,498
21207,KY,Russell,,2008,7.4,7657,8270,613
21207,KY,Russell,,2009,12.5,7383,8437,1054
21207,KY,Russell,,2010,13,6387,7338,951
21207,KY,Russell,,2011,11.7,6506,7368,862
21207,KY,Russell,,2012,10.4,6478,7229,751
21207,KY,Russell,,2013,11.5,6223,7028,805
21207,KY,Russell,,2014,10.2,5914,6586,672
21207,KY,Russell,,2015,11.6,5425,6140,715
21207,KY,Russell,,2016,8.3,5626,6135,509
21207,KY,Russell,,2017,7,5819,6257,438
21207,KY,Russell,,2018,5.6,5919,6273,354
21207,KY,Russell,,2019,5.4,5925,6264,339
21207,KY,Russell,,2020,8,5582,6068,486
21207,KY,Russell,,2021,5.4,5785,6118,333
21209,KY,Scott,,2007,4.3,21399,22371,972
21209,KY,Scott,,2008,5.5,21605,22860,1255
21209,KY,Scott,,2009,10.1,20674,22988,2314
21209,KY,Scott,,2010,8.8,23312,25556,2244
21209,KY,Scott,,2011,7.9,23577,25605,2028
21209,KY,Scott,,2012,6.6,24123,25820,1697
21209,KY,Scott,,2013,6,24692,26275,1583
21209,KY,Scott,,2014,4.9,25211,26500,1289
21209,KY,Scott,,2015,3.9,25868,26918,1050
21209,KY,Scott,,2016,3.7,26943,27992,1049
21209,KY,Scott,,2017,3.6,27691,28725,1034
21209,KY,Scott,,2018,3.2,28003,28937,934
21209,KY,Scott,,2019,3.3,28840,29819,979
21209,KY,Scott,,2020,6,28069,29874,1805
21209,KY,Scott,,2021,3.7,28785,29876,1091
21211,KY,Shelby,,2007,4.7,20297,21293,996
21211,KY,Shelby,,2008,5.8,20294,21542,1248
21211,KY,Shelby,,2009,9.8,19832,21982,2150
21211,KY,Shelby,,2010,9,19982,21961,1979
21211,KY,Shelby,,2011,7.9,20279,22024,1745
21211,KY,Shelby,,2012,6.3,20887,22285,1398
21211,KY,Shelby,,2013,6,21271,22632,1361
21211,KY,Shelby,,2014,4.9,21400,22509,1109
21211,KY,Shelby,,2015,4,21987,22897,910
21211,KY,Shelby,,2016,3.5,22972,23811,839
21211,KY,Shelby,,2017,3.5,23841,24715,874
21211,KY,Shelby,,2018,3.4,24612,25466,854
21211,KY,Shelby,,2019,3.2,25036,25869,833
21211,KY,Shelby,,2020,5.3,24072,25410,1338
21211,KY,Shelby,,2021,3.8,24857,25837,980
21213,KY,Simpson,,2007,5,8889,9361,472
21213,KY,Simpson,,2008,6.5,8790,9399,609
21213,KY,Simpson,,2009,13.5,8021,9268,1247
21213,KY,Simpson,,2010,13.1,7552,8689,1137
21213,KY,Simpson,,2011,11,7683,8632,949
21213,KY,Simpson,,2012,8.6,8199,8968,769
21213,KY,Simpson,,2013,7.4,8197,8856,659
21213,KY,Simpson,,2014,5.9,7994,8493,499
21213,KY,Simpson,,2015,4.7,7928,8322,394
21213,KY,Simpson,,2016,4.4,8021,8391,370
21213,KY,Simpson,,2017,4.5,8343,8732,389
21213,KY,Simpson,,2018,3.8,8511,8849,338
21213,KY,Simpson,,2019,4.3,8537,8919,382
21213,KY,Simpson,,2020,7,7917,8516,599
21213,KY,Simpson,,2021,4.2,8479,8850,371
21215,KY,Spencer,,2007,6,8402,8934,532
21215,KY,Spencer,,2008,7.4,8526,9207,681
21215,KY,Spencer,,2009,10.8,8316,9318,1002
21215,KY,Spencer,,2010,10,8326,9248,922
21215,KY,Spencer,,2011,9,8434,9267,833
21215,KY,Spencer,,2012,7.1,8611,9267,656
21215,KY,Spencer,,2013,6.4,8749,9344,595
21215,KY,Spencer,,2014,5.2,8679,9159,480
21215,KY,Spencer,,2015,4.2,8867,9258,391
21215,KY,Spencer,,2016,3.7,9294,9656,362
21215,KY,Spencer,,2017,3.8,9578,9953,375
21215,KY,Spencer,,2018,3.5,9849,10207,358
21215,KY,Spencer,,2019,3.3,10193,10542,349
21215,KY,Spencer,,2020,5.6,9766,10342,576
21215,KY,Spencer,,2021,4.2,10082,10529,447
21217,KY,Taylor,,2007,5.3,13017,13751,734
21217,KY,Taylor,,2008,6.1,12760,13591,831
21217,KY,Taylor,,2009,10.9,12292,13795,1503
21217,KY,Taylor,,2010,12.4,10398,11868,1470
21217,KY,Taylor,,2011,10.8,10664,11958,1294
21217,KY,Taylor,,2012,9.6,10565,11693,1128
21217,KY,Taylor,,2013,9.4,10323,11390,1067
21217,KY,Taylor,,2014,7.7,10413,11281,868
21217,KY,Taylor,,2015,6,11072,11773,701
21217,KY,Taylor,,2016,4.9,11622,12218,596
21217,KY,Taylor,,2017,4.3,12323,12875,552
21217,KY,Taylor,,2018,4.1,12028,12541,513
21217,KY,Taylor,,2019,4,12308,12821,513
21217,KY,Taylor,,2020,5.8,12220,12971,751
21217,KY,Taylor,,2021,3.9,11879,12363,484
21219,KY,Todd,,2007,6.5,4701,5028,327
21219,KY,Todd,,2008,7.2,4871,5248,377
21219,KY,Todd,,2009,12.5,4681,5347,666
21219,KY,Todd,,2010,10.1,5127,5704,577
21219,KY,Todd,,2011,8.7,5224,5721,497
21219,KY,Todd,,2012,7.6,5242,5676,434
21219,KY,Todd,,2013,7.4,5220,5635,415
21219,KY,Todd,,2014,5.4,5168,5463,295
21219,KY,Todd,,2015,4.8,4980,5230,250
21219,KY,Todd,,2016,4.4,5070,5303,233
21219,KY,Todd,,2017,4.1,5108,5328,220
21219,KY,Todd,,2018,3.9,5090,5296,206
21219,KY,Todd,,2019,3.8,5231,5435,204
21219,KY,Todd,,2020,4.7,5141,5392,251
21219,KY,Todd,,2021,3.6,5320,5521,201
21221,KY,Trigg,,2007,5.8,5911,6276,365
21221,KY,Trigg,,2008,7.8,5781,6272,491
21221,KY,Trigg,,2009,16.1,5445,6487,1042
21221,KY,Trigg,,2010,14.2,5554,6476,922
21221,KY,Trigg,,2011,11.3,5502,6204,702
21221,KY,Trigg,,2012,9.4,5469,6037,568
21221,KY,Trigg,,2013,9,5506,6048,542
21221,KY,Trigg,,2014,7,5316,5718,402
21221,KY,Trigg,,2015,5.6,5401,5724,323
21221,KY,Trigg,,2016,5.5,5497,5819,322
21221,KY,Trigg,,2017,5.6,5613,5945,332
21221,KY,Trigg,,2018,4.7,5626,5904,278
21221,KY,Trigg,,2019,4.5,5720,5989,269
21221,KY,Trigg,,2020,6.8,5562,5965,403
21221,KY,Trigg,,2021,5.1,5755,6062,307
21223,KY,Trimble,,2007,6.1,4092,4359,267
21223,KY,Trimble,,2008,7.3,4036,4356,320
21223,KY,Trimble,,2009,12.2,3834,4367,533
21223,KY,Trimble,,2010,13,3576,4110,534
21223,KY,Trimble,,2011,11.3,3569,4025,456
21223,KY,Trimble,,2012,9.1,3628,3990,362
21223,KY,Trimble,,2013,8.2,3640,3967,327
21223,KY,Trimble,,2014,7.2,3597,3878,281
21223,KY,Trimble,,2015,5.6,3627,3841,214
21223,KY,Trimble,,2016,5.3,3663,3869,206
21223,KY,Trimble,,2017,4.9,3694,3883,189
21223,KY,Trimble,,2018,4.1,3706,3866,160
21223,KY,Trimble,,2019,4.2,3713,3874,161
21223,KY,Trimble,,2020,6.6,3533,3782,249
21223,KY,Trimble,,2021,4.8,3649,3834,185
21225,KY,Union,,2007,5.5,6703,7096,393
21225,KY,Union,,2008,6.6,7174,7684,510
21225,KY,Union,,2009,11.8,6948,7881,933
21225,KY,Union,,2010,9.8,6971,7728,757
21225,KY,Union,,2011,9,6933,7617,684
21225,KY,Union,,2012,7.8,6475,7026,551
21225,KY,Union,,2013,7.6,6334,6858,524
21225,KY,Union,,2014,6.4,6329,6761,432
21225,KY,Union,,2015,6.7,5716,6126,410
21225,KY,Union,,2016,6.7,5749,6163,414
21225,KY,Union,,2017,5.9,5745,6105,360
21225,KY,Union,,2018,4.8,5716,6006,290
21225,KY,Union,,2019,4.3,5830,6090,260
21225,KY,Union,,2020,6.2,5558,5924,366
21225,KY,Union,,2021,4.4,5759,6021,262
21227,KY,Warren,,2007,4.3,55142,57637,2495
21227,KY,Warren,,2008,5.4,54902,58049,3147
21227,KY,Warren,,2009,10.3,52622,58693,6071
21227,KY,Warren,,2010,9.3,53080,58510,5430
21227,KY,Warren,,2011,8.2,54246,59109,4863
21227,KY,Warren,,2012,7,55793,59982,4189
21227,KY,Warren,,2013,6.8,56378,60493,4115
21227,KY,Warren,,2014,5.5,56106,59395,3289
21227,KY,Warren,,2015,4.4,56834,59464,2630
21227,KY,Warren,,2016,3.9,59600,61992,2392
21227,KY,Warren,,2017,4,61488,64035,2547
21227,KY,Warren,,2018,3.6,62227,64546,2319
21227,KY,Warren,,2019,3.7,63314,65754,2440
21227,KY,Warren,,2020,6.4,59408,63444,4036
21227,KY,Warren,,2021,4.3,61768,64517,2749
21229,KY,Washington,,2007,5.5,5114,5414,300
21229,KY,Washington,,2008,7.3,5024,5421,397
21229,KY,Washington,,2009,13.5,4697,5431,734
21229,KY,Washington,,2010,10.2,5494,6120,626
21229,KY,Washington,,2011,9.2,5572,6138,566
21229,KY,Washington,,2012,7.5,5746,6214,468
21229,KY,Washington,,2013,6.8,5722,6141,419
21229,KY,Washington,,2014,5.4,5795,6126,331
21229,KY,Washington,,2015,4.4,5691,5954,263
21229,KY,Washington,,2016,4.2,5825,6083,258
21229,KY,Washington,,2017,4.1,5927,6180,253
21229,KY,Washington,,2018,3.6,5917,6136,219
21229,KY,Washington,,2019,3.7,6020,6252,232
21229,KY,Washington,,2020,6.1,5710,6081,371
21229,KY,Washington,,2021,3.9,5937,6177,240
21231,KY,Wayne,,2007,6.5,8028,8588,560
21231,KY,Wayne,,2008,8.4,7718,8423,705
21231,KY,Wayne,,2009,14.3,7344,8572,1228
21231,KY,Wayne,,2010,14.2,7088,8257,1169
21231,KY,Wayne,,2011,14.2,6782,7905,1123
21231,KY,Wayne,,2012,13,6730,7739,1009
21231,KY,Wayne,,2013,11.8,6579,7460,881
21231,KY,Wayne,,2014,9.6,6559,7259,700
21231,KY,Wayne,,2015,8.1,6461,7028,567
21231,KY,Wayne,,2016,7.6,6708,7259,551
21231,KY,Wayne,,2017,7.6,6842,7407,565
21231,KY,Wayne,,2018,6.8,7058,7571,513
21231,KY,Wayne,,2019,5.5,7044,7451,407
21231,KY,Wayne,,2020,6.3,6883,7344,461
21231,KY,Wayne,,2021,5.1,7035,7410,375
21233,KY,Webster,,2007,5.8,6159,6540,381
21233,KY,Webster,,2008,6.4,6015,6427,412
21233,KY,Webster,,2009,10,5819,6467,648
21233,KY,Webster,,2010,9.5,5565,6152,587
21233,KY,Webster,,2011,8,5728,6227,499
21233,KY,Webster,,2012,7.1,5808,6255,447
21233,KY,Webster,,2013,7.1,5748,6185,437
21233,KY,Webster,,2014,5.4,5950,6291,341
21233,KY,Webster,,2015,5.2,5650,5958,308
21233,KY,Webster,,2016,5.9,5487,5834,347
21233,KY,Webster,,2017,5.1,5512,5809,297
21233,KY,Webster,,2018,4.1,5537,5774,237
21233,KY,Webster,,2019,3.8,5532,5751,219
21233,KY,Webster,,2020,6.2,5073,5410,337
21233,KY,Webster,,2021,4.5,5103,5344,241
21235,KY,Whitley,,2007,6.3,14083,15037,954
21235,KY,Whitley,,2008,7.4,14283,15429,1146
21235,KY,Whitley,,2009,11.8,13856,15703,1847
21235,KY,Whitley,,2010,12.7,12397,14200,1803
21235,KY,Whitley,,2011,12,12262,13933,1671
21235,KY,Whitley,,2012,10.7,12400,13887,1487
21235,KY,Whitley,,2013,10.5,12395,13848,1453
21235,KY,Whitley,,2014,8.7,12241,13406,1165
21235,KY,Whitley,,2015,6.7,12235,13117,882
21235,KY,Whitley,,2016,6.5,12480,13349,869
21235,KY,Whitley,,2017,5.7,12984,13763,779
21235,KY,Whitley,,2018,4.9,13058,13731,673
21235,KY,Whitley,,2019,4.9,13156,13828,672
21235,KY,Whitley,,2020,6.9,12841,13791,950
21235,KY,Whitley,,2021,5,13309,14007,698
21237,KY,Wolfe,,2007,9.7,2094,2318,224
21237,KY,Wolfe,,2008,9.9,2093,2322,229
21237,KY,Wolfe,,2009,14,2062,2398,336
21237,KY,Wolfe,,2010,16.5,1807,2164,357
21237,KY,Wolfe,,2011,14.8,1796,2109,313
21237,KY,Wolfe,,2012,14.3,1803,2104,301
21237,KY,Wolfe,,2013,14.1,1813,2110,297
21237,KY,Wolfe,,2014,11.2,1825,2056,231
21237,KY,Wolfe,,2015,10.1,1716,1908,192
21237,KY,Wolfe,,2016,10,1725,1917,192
21237,KY,Wolfe,,2017,9,1753,1926,173
21237,KY,Wolfe,,2018,7.4,1756,1897,141
21237,KY,Wolfe,,2019,6.7,1833,1965,132
21237,KY,Wolfe,,2020,7.4,1925,2079,154
21237,KY,Wolfe,,2021,5.9,2092,2222,130
21239,KY,Woodford,,2007,3.9,12775,13288,513
21239,KY,Woodford,,2008,4.8,12545,13181,636
21239,KY,Woodford,,2009,8.6,11884,13001,1117
21239,KY,Woodford,,2010,7.3,13449,14511,1062
21239,KY,Woodford,,2011,6.5,13430,14360,930
21239,KY,Woodford,,2012,5.4,13369,14129,760
21239,KY,Woodford,,2013,5.2,13508,14256,748
21239,KY,Woodford,,2014,4.5,13611,14245,634
21239,KY,Woodford,,2015,3.5,13876,14375,499
21239,KY,Woodford,,2016,3.2,14294,14762,468
21239,KY,Woodford,,2017,3.2,14494,14972,478
21239,KY,Woodford,,2018,3,14308,14753,445
21239,KY,Woodford,,2019,3,14633,15080,447
21239,KY,Woodford,,2020,4.8,14132,14851,719
21239,KY,Woodford,,2021,3.4,14543,15053,510
22000,LA,Louisiana,,2007,4.1,1943648,2026793,83145
22000,LA,Louisiana,,2008,4.7,1968676,2064692,96016
22000,LA,Louisiana,,2009,6.8,1927200,2067873,140673
22000,LA,Louisiana,,2010,7.5,1927720,2084462,156742
22000,LA,Louisiana,,2011,7.4,1926038,2080525,154487
22000,LA,Louisiana,,2012,6.7,1948630,2089644,141014
22000,LA,Louisiana,,2013,6.4,1966755,2101974,135219
22000,LA,Louisiana,,2014,6.3,2007668,2141519,133851
22000,LA,Louisiana,,2015,6.3,2015081,2150050,134969
22000,LA,Louisiana,,2016,6.1,1994639,2123690,129051
22000,LA,Louisiana,,2017,5.1,2000487,2108485,107998
22000,LA,Louisiana,,2018,4.8,2010719,2112495,101776
22000,LA,Louisiana,,2019,4.6,2010405,2108410,98005
22000,LA,Louisiana,,2020,8.7,1882665,2062175,179510
22000,LA,Louisiana,,2021,5.5,1949403,2062492,113089
22001,LA,Acadia,,2007,3.6,25310,26261,951
22001,LA,Acadia,,2008,4,25791,26855,1064
22001,LA,Acadia,,2009,6.4,24527,26214,1687
22001,LA,Acadia,,2010,6.8,24332,26121,1789
22001,LA,Acadia,,2011,6.3,24257,25897,1640
22001,LA,Acadia,,2012,5.7,24767,26267,1500
22001,LA,Acadia,,2013,5.7,24838,26346,1508
22001,LA,Acadia,,2014,5.6,25045,26543,1498
22001,LA,Acadia,,2015,6.8,23962,25710,1748
22001,LA,Acadia,,2016,7.4,22724,24540,1816
22001,LA,Acadia,,2017,5.9,22647,24068,1421
22001,LA,Acadia,,2018,5.3,22713,23987,1274
22001,LA,Acadia,,2019,5.1,22748,23980,1232
22001,LA,Acadia,,2020,7.8,21493,23311,1818
22001,LA,Acadia,,2021,4.9,22355,23518,1163
22003,LA,Allen,,2007,5.5,8307,8790,483
22003,LA,Allen,,2008,5.9,8258,8777,519
22003,LA,Allen,,2009,9.4,8254,9106,852
22003,LA,Allen,,2010,9.3,8506,9380,874
22003,LA,Allen,,2011,8.7,8440,9242,802
22003,LA,Allen,,2012,7.6,8439,9136,697
22003,LA,Allen,,2013,7.2,8111,8743,632
22003,LA,Allen,,2014,7.1,8234,8859,625
22003,LA,Allen,,2015,6.9,8181,8788,607
22003,LA,Allen,,2016,6.4,8337,8910,573
22003,LA,Allen,,2017,5.3,8515,8988,473
22003,LA,Allen,,2018,5.6,8301,8794,493
22003,LA,Allen,,2019,5.4,8357,8837,480
22003,LA,Allen,,2020,9.7,7574,8392,818
22003,LA,Allen,,2021,5.5,7687,8137,450
22005,LA,Ascension,,2007,3.8,47001,48869,1868
22005,LA,Ascension,,2008,4.1,48367,50461,2094
22005,LA,Ascension,,2009,5.9,48546,51599,3053
22005,LA,Ascension,,2010,7,49616,53365,3749
22005,LA,Ascension,,2011,6.7,50536,54154,3618
22005,LA,Ascension,,2012,5.8,51915,55119,3204
22005,LA,Ascension,,2013,5.4,53778,56822,3044
22005,LA,Ascension,,2014,5.2,56324,59431,3107
22005,LA,Ascension,,2015,5,58319,61401,3082
22005,LA,Ascension,,2016,4.9,59019,62060,3041
22005,LA,Ascension,,2017,4.3,60202,62884,2682
22005,LA,Ascension,,2018,4.1,61833,64446,2613
22005,LA,Ascension,,2019,4,62617,65203,2586
22005,LA,Ascension,,2020,7.1,59710,64283,4573
22005,LA,Ascension,,2021,4.2,62050,64756,2706
22007,LA,Assumption,,2007,4.5,9970,10439,469
22007,LA,Assumption,,2008,5.5,9980,10563,583
22007,LA,Assumption,,2009,8,9615,10452,837
22007,LA,Assumption,,2010,11,8938,10038,1100
22007,LA,Assumption,,2011,11.5,8839,9991,1152
22007,LA,Assumption,,2012,9.3,9059,9984,925
22007,LA,Assumption,,2013,8,9119,9910,791
22007,LA,Assumption,,2014,7.6,9259,10016,757
22007,LA,Assumption,,2015,7.8,8997,9760,763
22007,LA,Assumption,,2016,8.4,8443,9218,775
22007,LA,Assumption,,2017,7.3,8297,8954,657
22007,LA,Assumption,,2018,6.6,8401,8992,591
22007,LA,Assumption,,2019,5.8,8402,8921,519
22007,LA,Assumption,,2020,10.7,7834,8772,938
22007,LA,Assumption,,2021,7.2,8088,8713,625
22009,LA,Avoyelles,,2007,5,15165,15959,794
22009,LA,Avoyelles,,2008,5.7,15378,16309,931
22009,LA,Avoyelles,,2009,7.5,15214,16443,1229
22009,LA,Avoyelles,,2010,7.9,15516,16852,1336
22009,LA,Avoyelles,,2011,8,15360,16691,1331
22009,LA,Avoyelles,,2012,7.2,15250,16437,1187
22009,LA,Avoyelles,,2013,7.2,14855,16000,1145
22009,LA,Avoyelles,,2014,7.1,14921,16059,1138
22009,LA,Avoyelles,,2015,7.5,14710,15896,1186
22009,LA,Avoyelles,,2016,7.1,14591,15702,1111
22009,LA,Avoyelles,,2017,6.1,14681,15638,957
22009,LA,Avoyelles,,2018,5.6,14496,15359,863
22009,LA,Avoyelles,,2019,5.6,14376,15228,852
22009,LA,Avoyelles,,2020,8.5,13656,14925,1269
22009,LA,Avoyelles,,2021,5.2,13982,14753,771
22011,LA,Beauregard,,2007,4.7,13565,14239,674
22011,LA,Beauregard,,2008,5.2,13747,14497,750
22011,LA,Beauregard,,2009,7.9,13262,14396,1134
22011,LA,Beauregard,,2010,7.5,13484,14574,1090
22011,LA,Beauregard,,2011,7.8,13201,14314,1113
22011,LA,Beauregard,,2012,7.2,13434,14475,1041
22011,LA,Beauregard,,2013,7.1,13423,14444,1021
22011,LA,Beauregard,,2014,6.7,13752,14733,981
22011,LA,Beauregard,,2015,6.3,14179,15132,953
22011,LA,Beauregard,,2016,6.1,14169,15083,914
22011,LA,Beauregard,,2017,5.3,13906,14691,785
22011,LA,Beauregard,,2018,5.3,13860,14629,769
22011,LA,Beauregard,,2019,5,13948,14686,738
22011,LA,Beauregard,,2020,7.2,13355,14387,1032
22011,LA,Beauregard,,2021,4.1,14030,14628,598
22013,LA,Bienville,,2007,5.3,6214,6560,346
22013,LA,Bienville,,2008,6.1,5747,6121,374
22013,LA,Bienville,,2009,9.6,5673,6272,599
22013,LA,Bienville,,2010,9.5,5345,5906,561
22013,LA,Bienville,,2011,9.7,5307,5875,568
22013,LA,Bienville,,2012,8.6,5460,5974,514
22013,LA,Bienville,,2013,8.3,5448,5942,494
22013,LA,Bienville,,2014,7.8,5445,5904,459
22013,LA,Bienville,,2015,8.3,5302,5779,477
22013,LA,Bienville,,2016,7.6,5239,5671,432
22013,LA,Bienville,,2017,6,5304,5641,337
22013,LA,Bienville,,2018,5.8,5332,5658,326
22013,LA,Bienville,,2019,5.7,5218,5532,314
22013,LA,Bienville,,2020,8.2,4933,5374,441
22013,LA,Bienville,,2021,5.7,4945,5244,299
22015,LA,Bossier,,2007,3.9,50836,52925,2089
22015,LA,Bossier,,2008,4.2,51976,54281,2305
22015,LA,Bossier,,2009,6,50786,54029,3243
22015,LA,Bossier,,2010,5.7,53369,56595,3226
22015,LA,Bossier,,2011,5.6,53981,57162,3181
22015,LA,Bossier,,2012,5.5,54441,57612,3171
22015,LA,Bossier,,2013,5.8,53608,56900,3292
22015,LA,Bossier,,2014,5.6,54652,57910,3258
22015,LA,Bossier,,2015,5.6,54695,57945,3250
22015,LA,Bossier,,2016,5.3,54581,57649,3068
22015,LA,Bossier,,2017,4.5,55141,57713,2572
22015,LA,Bossier,,2018,4.2,55729,58178,2449
22015,LA,Bossier,,2019,4.1,55768,58180,2412
22015,LA,Bossier,,2020,6.7,52939,56751,3812
22015,LA,Bossier,,2021,3.9,54867,57066,2199
22017,LA,Caddo,,2007,5,112421,118356,5935
22017,LA,Caddo,,2008,5.4,113460,119929,6469
22017,LA,Caddo,,2009,7.7,109941,119083,9142
22017,LA,Caddo,,2010,7.7,107724,116713,8989
22017,LA,Caddo,,2011,7.5,107261,116019,8758
22017,LA,Caddo,,2012,7.4,105631,114019,8388
22017,LA,Caddo,,2013,7.6,102502,110892,8390
22017,LA,Caddo,,2014,7.3,102525,110589,8064
22017,LA,Caddo,,2015,7.1,102042,109831,7789
22017,LA,Caddo,,2016,6.6,100070,107169,7099
22017,LA,Caddo,,2017,5.8,98953,105028,6075
22017,LA,Caddo,,2018,5.4,98917,104596,5679
22017,LA,Caddo,,2019,5.2,97997,103335,5338
22017,LA,Caddo,,2020,9.5,91806,101444,9638
22017,LA,Caddo,,2021,6.2,95172,101475,6303
22019,LA,Calcasieu,,2007,3.9,88138,91732,3594
22019,LA,Calcasieu,,2008,4.2,89620,93583,3963
22019,LA,Calcasieu,,2009,6.3,86370,92159,5789
22019,LA,Calcasieu,,2010,7.6,81183,87825,6642
22019,LA,Calcasieu,,2011,7.3,80948,87313,6365
22019,LA,Calcasieu,,2012,6.6,82494,88306,5812
22019,LA,Calcasieu,,2013,6.2,83855,89392,5537
22019,LA,Calcasieu,,2014,5.8,88684,94139,5455
22019,LA,Calcasieu,,2015,5.3,93523,98809,5286
22019,LA,Calcasieu,,2016,4.8,98072,103001,4929
22019,LA,Calcasieu,,2017,4,104315,108614,4299
22019,LA,Calcasieu,,2018,3.8,106015,110186,4171
22019,LA,Calcasieu,,2019,3.9,102706,106918,4212
22019,LA,Calcasieu,,2020,9.6,88018,97332,9314
22019,LA,Calcasieu,,2021,5.6,90541,95934,5393
22021,LA,Caldwell,,2007,4.6,4327,4536,209
22021,LA,Caldwell,,2008,4.9,4312,4536,224
22021,LA,Caldwell,,2009,9.5,4169,4608,439
22021,LA,Caldwell,,2010,10.3,3742,4171,429
22021,LA,Caldwell,,2011,9.6,3722,4115,393
22021,LA,Caldwell,,2012,8.3,3682,4017,335
22021,LA,Caldwell,,2013,7.9,3647,3959,312
22021,LA,Caldwell,,2014,7.6,3750,4059,309
22021,LA,Caldwell,,2015,8.3,3679,4010,331
22021,LA,Caldwell,,2016,7.6,3682,3987,305
22021,LA,Caldwell,,2017,5.7,3644,3864,220
22021,LA,Caldwell,,2018,5.7,3627,3846,219
22021,LA,Caldwell,,2019,5.9,3567,3790,223
22021,LA,Caldwell,,2020,7.9,3361,3649,288
22021,LA,Caldwell,,2021,4.6,3500,3670,170
22023,LA,Cameron,,2007,3.5,3429,3554,125
22023,LA,Cameron,,2008,4.2,3383,3531,148
22023,LA,Cameron,,2009,5.9,2935,3118,183
22023,LA,Cameron,,2010,5.9,3105,3300,195
22023,LA,Cameron,,2011,5.5,3087,3265,178
22023,LA,Cameron,,2012,5,3081,3243,162
22023,LA,Cameron,,2013,5.1,3146,3316,170
22023,LA,Cameron,,2014,4.8,3263,3429,166
22023,LA,Cameron,,2015,4.6,3484,3653,169
22023,LA,Cameron,,2016,4.4,3654,3822,168
22023,LA,Cameron,,2017,3.6,3867,4011,144
22023,LA,Cameron,,2018,3.5,3946,4089,143
22023,LA,Cameron,,2019,3.6,3819,3961,142
22023,LA,Cameron,,2020,6.2,3288,3504,216
22023,LA,Cameron,,2021,3.5,3381,3503,122
22025,LA,Catahoula,,2007,5.6,3921,4153,232
22025,LA,Catahoula,,2008,6.4,3922,4190,268
22025,LA,Catahoula,,2009,10.1,3835,4268,433
22025,LA,Catahoula,,2010,9.8,3807,4220,413
22025,LA,Catahoula,,2011,9.8,3669,4069,400
22025,LA,Catahoula,,2012,8.5,3596,3931,335
22025,LA,Catahoula,,2013,8.1,3582,3897,315
22025,LA,Catahoula,,2014,7.9,3523,3826,303
22025,LA,Catahoula,,2015,9.6,3255,3599,344
22025,LA,Catahoula,,2016,9.3,3109,3428,319
22025,LA,Catahoula,,2017,7,3197,3439,242
22025,LA,Catahoula,,2018,6.7,3145,3370,225
22025,LA,Catahoula,,2019,6.2,3190,3400,210
22025,LA,Catahoula,,2020,7.6,3185,3447,262
22025,LA,Catahoula,,2021,5.1,3304,3483,179
22027,LA,Claiborne,,2007,5.3,6339,6695,356
22027,LA,Claiborne,,2008,5.9,6180,6568,388
22027,LA,Claiborne,,2009,9.3,6031,6653,622
22027,LA,Claiborne,,2010,8.3,6315,6887,572
22027,LA,Claiborne,,2011,8,6345,6893,548
22027,LA,Claiborne,,2012,7.1,6550,7054,504
22027,LA,Claiborne,,2013,7.2,6056,6524,468
22027,LA,Claiborne,,2014,7.3,5868,6329,461
22027,LA,Claiborne,,2015,7.3,5713,6161,448
22027,LA,Claiborne,,2016,6.7,5560,5958,398
22027,LA,Claiborne,,2017,5.3,5554,5867,313
22027,LA,Claiborne,,2018,5.1,5529,5828,299
22027,LA,Claiborne,,2019,5.4,5530,5845,315
22027,LA,Claiborne,,2020,7.1,5069,5458,389
22027,LA,Claiborne,,2021,4.9,5190,5456,266
22029,LA,Concordia,,2007,5.8,6888,7315,427
22029,LA,Concordia,,2008,7,7018,7550,532
22029,LA,Concordia,,2009,11.1,6665,7493,828
22029,LA,Concordia,,2010,9.4,7122,7860,738
22029,LA,Concordia,,2011,9.1,7118,7832,714
22029,LA,Concordia,,2012,8.4,7194,7856,662
22029,LA,Concordia,,2013,8.2,7166,7802,636
22029,LA,Concordia,,2014,8.4,7064,7716,652
22029,LA,Concordia,,2015,8.6,6863,7511,648
22029,LA,Concordia,,2016,8.3,6659,7260,601
22029,LA,Concordia,,2017,7.8,6603,7165,562
22029,LA,Concordia,,2018,6.9,6541,7024,483
22029,LA,Concordia,,2019,6.2,6575,7011,436
22029,LA,Concordia,,2020,8.8,6289,6894,605
22029,LA,Concordia,,2021,5.9,6500,6906,406
22031,LA,De Soto,,2007,5.6,10726,11357,631
22031,LA,De Soto,,2008,6.8,10861,11654,793
22031,LA,De Soto,,2009,8.5,10500,11470,970
22031,LA,De Soto,,2010,8.3,10434,11379,945
22031,LA,De Soto,,2011,8,10359,11265,906
22031,LA,De Soto,,2012,8.6,10270,11235,965
22031,LA,De Soto,,2013,8.5,10071,11005,934
22031,LA,De Soto,,2014,7.9,10190,11070,880
22031,LA,De Soto,,2015,7.9,10158,11030,872
22031,LA,De Soto,,2016,7.4,10100,10902,802
22031,LA,De Soto,,2017,6.1,10146,10800,654
22031,LA,De Soto,,2018,5.7,10313,10931,618
22031,LA,De Soto,,2019,5.8,10341,10973,632
22031,LA,De Soto,,2020,7.7,9864,10688,824
22031,LA,De Soto,,2021,4.8,10218,10738,520
22033,LA,East Baton Rouge,,2007,3.9,207767,216274,8507
22033,LA,East Baton Rouge,,2008,4.4,207120,216740,9620
22033,LA,East Baton Rouge,,2009,6.2,204829,218317,13488
22033,LA,East Baton Rouge,,2010,7.2,205954,221852,15898
22033,LA,East Baton Rouge,,2011,7.2,205945,221868,15923
22033,LA,East Baton Rouge,,2012,6.4,208946,223279,14333
22033,LA,East Baton Rouge,,2013,6,212613,226071,13458
22033,LA,East Baton Rouge,,2014,5.6,218054,231088,13034
22033,LA,East Baton Rouge,,2015,5.4,221537,234153,12616
22033,LA,East Baton Rouge,,2016,5.2,220408,232408,12000
22033,LA,East Baton Rouge,,2017,4.4,221966,232155,10189
22033,LA,East Baton Rouge,,2018,4.3,222184,232097,9913
22033,LA,East Baton Rouge,,2019,4.3,221116,230956,9840
22033,LA,East Baton Rouge,,2020,8.3,207325,225973,18648
22033,LA,East Baton Rouge,,2021,5.3,215464,227407,11943
22035,LA,East Carroll,,2007,9.4,2770,3058,288
22035,LA,East Carroll,,2008,10,2738,3042,304
22035,LA,East Carroll,,2009,13,2593,2980,387
22035,LA,East Carroll,,2010,16.8,2047,2461,414
22035,LA,East Carroll,,2011,17.3,1933,2337,404
22035,LA,East Carroll,,2012,19.3,1765,2186,421
22035,LA,East Carroll,,2013,16.3,1894,2263,369
22035,LA,East Carroll,,2014,14.4,1890,2207,317
22035,LA,East Carroll,,2015,14,1897,2206,309
22035,LA,East Carroll,,2016,11.6,1893,2141,248
22035,LA,East Carroll,,2017,11.1,1830,2059,229
22035,LA,East Carroll,,2018,10.2,1760,1959,199
22035,LA,East Carroll,,2019,10.2,1702,1895,193
22035,LA,East Carroll,,2020,12.7,1583,1813,230
22035,LA,East Carroll,,2021,9.9,1573,1745,172
22037,LA,East Feliciana,,2007,4.6,7668,8037,369
22037,LA,East Feliciana,,2008,5.1,7694,8108,414
22037,LA,East Feliciana,,2009,7.2,7534,8117,583
22037,LA,East Feliciana,,2010,7.9,7457,8095,638
22037,LA,East Feliciana,,2011,8.1,7424,8074,650
22037,LA,East Feliciana,,2012,7.2,7420,7994,574
22037,LA,East Feliciana,,2013,6.6,7430,7954,524
22037,LA,East Feliciana,,2014,6.3,7638,8152,514
22037,LA,East Feliciana,,2015,5.9,7695,8178,483
22037,LA,East Feliciana,,2016,5.8,7645,8114,469
22037,LA,East Feliciana,,2017,4.8,7609,7992,383
22037,LA,East Feliciana,,2018,4.6,7668,8037,369
22037,LA,East Feliciana,,2019,4.5,7582,7937,355
22037,LA,East Feliciana,,2020,7.2,7024,7566,542
22037,LA,East Feliciana,,2021,4.5,7306,7654,348
22039,LA,Evangeline,,2007,4.9,11705,12308,603
22039,LA,Evangeline,,2008,5.1,11828,12463,635
22039,LA,Evangeline,,2009,7.9,11731,12734,1003
22039,LA,Evangeline,,2010,8.1,12064,13127,1063
22039,LA,Evangeline,,2011,8,12024,13070,1046
22039,LA,Evangeline,,2012,7.1,11977,12889,912
22039,LA,Evangeline,,2013,6.5,12029,12866,837
22039,LA,Evangeline,,2014,6.6,12210,13077,867
22039,LA,Evangeline,,2015,7.5,11967,12934,967
22039,LA,Evangeline,,2016,7.4,11745,12686,941
22039,LA,Evangeline,,2017,5.9,11819,12561,742
22039,LA,Evangeline,,2018,5.7,11447,12134,687
22039,LA,Evangeline,,2019,5.7,11274,11953,679
22039,LA,Evangeline,,2020,8.3,10953,11940,987
22039,LA,Evangeline,,2021,5.4,11333,11985,652
22041,LA,Franklin,,2007,6.5,7266,7767,501
22041,LA,Franklin,,2008,7.2,7214,7774,560
22041,LA,Franklin,,2009,10.7,6965,7802,837
22041,LA,Franklin,,2010,10.5,7439,8310,871
22041,LA,Franklin,,2011,11.1,7088,7973,885
22041,LA,Franklin,,2012,9.9,6951,7719,768
22041,LA,Franklin,,2013,9.7,6949,7694,745
22041,LA,Franklin,,2014,9.3,6860,7561,701
22041,LA,Franklin,,2015,9.6,6768,7489,721
22041,LA,Franklin,,2016,9.1,6627,7288,661
22041,LA,Franklin,,2017,7.5,6772,7318,546
22041,LA,Franklin,,2018,7.1,6778,7295,517
22041,LA,Franklin,,2019,6.9,6884,7398,514
22041,LA,Franklin,,2020,8.7,6678,7317,639
22041,LA,Franklin,,2021,5.8,6989,7420,431
22043,LA,Grant,,2007,4.5,8274,8663,389
22043,LA,Grant,,2008,5,8404,8848,444
22043,LA,Grant,,2009,7.8,8149,8837,688
22043,LA,Grant,,2010,8,7896,8581,685
22043,LA,Grant,,2011,8,7715,8385,670
22043,LA,Grant,,2012,7.6,7635,8259,624
22043,LA,Grant,,2013,7,7574,8147,573
22043,LA,Grant,,2014,7,7788,8371,583
22043,LA,Grant,,2015,7.3,7825,8438,613
22043,LA,Grant,,2016,7,7752,8334,582
22043,LA,Grant,,2017,6.3,7682,8198,516
22043,LA,Grant,,2018,5.7,7762,8234,472
22043,LA,Grant,,2019,5.6,7762,8222,460
22043,LA,Grant,,2020,7,7547,8118,571
22043,LA,Grant,,2021,4,7877,8207,330
22045,LA,Iberia,,2007,3.6,33147,34374,1227
22045,LA,Iberia,,2008,4.1,33495,34911,1416
22045,LA,Iberia,,2009,6.9,31943,34295,2352
22045,LA,Iberia,,2010,8.2,29584,32211,2627
22045,LA,Iberia,,2011,7.5,29588,31993,2405
22045,LA,Iberia,,2012,6.5,30297,32388,2091
22045,LA,Iberia,,2013,6.2,30296,32297,2001
22045,LA,Iberia,,2014,6.2,30419,32429,2010
22045,LA,Iberia,,2015,8.1,29138,31693,2555
22045,LA,Iberia,,2016,9.4,27315,30150,2835
22045,LA,Iberia,,2017,7.3,26871,28987,2116
22045,LA,Iberia,,2018,5.8,26728,28374,1646
22045,LA,Iberia,,2019,5.2,26421,27883,1462
22045,LA,Iberia,,2020,10.1,24724,27493,2769
22045,LA,Iberia,,2021,6.9,25757,27669,1912
22047,LA,Iberville,,2007,5.7,11545,12240,695
22047,LA,Iberville,,2008,6.5,11577,12387,810
22047,LA,Iberville,,2009,9.4,11270,12446,1176
22047,LA,Iberville,,2010,9.5,12674,14002,1328
22047,LA,Iberville,,2011,9.9,12627,14008,1381
22047,LA,Iberville,,2012,9,12690,13938,1248
22047,LA,Iberville,,2013,8,12909,14031,1122
22047,LA,Iberville,,2014,7.7,13205,14303,1098
22047,LA,Iberville,,2015,7.3,13305,14347,1042
22047,LA,Iberville,,2016,6.9,13157,14126,969
22047,LA,Iberville,,2017,6.2,13306,14179,873
22047,LA,Iberville,,2018,6.1,13322,14190,868
22047,LA,Iberville,,2019,5.7,13197,14001,804
22047,LA,Iberville,,2020,10.5,12212,13642,1430
22047,LA,Iberville,,2021,7.2,12679,13659,980
22049,LA,Jackson,,2007,4.2,6187,6458,271
22049,LA,Jackson,,2008,4.7,6295,6602,307
22049,LA,Jackson,,2009,7.6,6025,6524,499
22049,LA,Jackson,,2010,6.9,6595,7082,487
22049,LA,Jackson,,2011,7,6482,6972,490
22049,LA,Jackson,,2012,6.5,6417,6863,446
22049,LA,Jackson,,2013,6.2,6588,7027,439
22049,LA,Jackson,,2014,5.8,6794,7209,415
22049,LA,Jackson,,2015,6,6796,7226,430
22049,LA,Jackson,,2016,5.6,6696,7092,396
22049,LA,Jackson,,2017,4.5,6679,6995,316
22049,LA,Jackson,,2018,4.6,6585,6900,315
22049,LA,Jackson,,2019,4.6,6527,6840,313
22049,LA,Jackson,,2020,5.8,6333,6720,387
22049,LA,Jackson,,2021,3.8,6492,6745,253
22051,LA,Jefferson,,2007,3.5,213404,221067,7663
22051,LA,Jefferson,,2008,4.2,206047,215107,9060
22051,LA,Jefferson,,2009,6.3,198168,211466,13298
22051,LA,Jefferson,,2010,7,201126,216160,15034
22051,LA,Jefferson,,2011,6.8,199220,213834,14614
22051,LA,Jefferson,,2012,6.4,199607,213213,13606
22051,LA,Jefferson,,2013,6,200869,213738,12869
22051,LA,Jefferson,,2014,5.9,204407,217170,12763
22051,LA,Jefferson,,2015,5.7,206102,218574,12472
22051,LA,Jefferson,,2016,5.3,205292,216748,11456
22051,LA,Jefferson,,2017,4.5,205590,215341,9751
22051,LA,Jefferson,,2018,4.3,204826,214103,9277
22051,LA,Jefferson,,2019,4,205922,214566,8644
22051,LA,Jefferson,,2020,9.7,189241,209463,20222
22051,LA,Jefferson,,2021,6,196000,208446,12446
22053,LA,Jefferson Davis,,2007,3.3,14090,14578,488
22053,LA,Jefferson Davis,,2008,3.8,14319,14884,565
22053,LA,Jefferson Davis,,2009,5.8,13856,14708,852
22053,LA,Jefferson Davis,,2010,7.1,12173,13106,933
22053,LA,Jefferson Davis,,2011,6.8,12070,12957,887
22053,LA,Jefferson Davis,,2012,6.2,12228,13037,809
22053,LA,Jefferson Davis,,2013,6,12385,13169,784
22053,LA,Jefferson Davis,,2014,5.8,12735,13514,779
22053,LA,Jefferson Davis,,2015,6.2,12709,13543,834
22053,LA,Jefferson Davis,,2016,6,12773,13592,819
22053,LA,Jefferson Davis,,2017,4.9,12979,13643,664
22053,LA,Jefferson Davis,,2018,4.7,12916,13551,635
22053,LA,Jefferson Davis,,2019,4.5,12739,13343,604
22053,LA,Jefferson Davis,,2020,8.1,11702,12728,1026
22053,LA,Jefferson Davis,,2021,4.7,12057,12658,601
22055,LA,Lafayette,,2007,2.9,106850,110014,3164
22055,LA,Lafayette,,2008,3.2,108523,112131,3608
22055,LA,Lafayette,,2009,5.1,106478,112171,5693
22055,LA,Lafayette,,2010,5.9,106923,113598,6675
22055,LA,Lafayette,,2011,5.6,107958,114387,6429
22055,LA,Lafayette,,2012,4.8,111620,117238,5618
22055,LA,Lafayette,,2013,4.7,113366,119001,5635
22055,LA,Lafayette,,2014,4.8,116068,121951,5883
22055,LA,Lafayette,,2015,5.6,112863,119603,6740
22055,LA,Lafayette,,2016,6.1,107456,114488,7032
22055,LA,Lafayette,,2017,4.9,107757,113287,5530
22055,LA,Lafayette,,2018,4.4,109324,114366,5042
22055,LA,Lafayette,,2019,4.2,110504,115299,4795
22055,LA,Lafayette,,2020,7.5,105578,114141,8563
22055,LA,Lafayette,,2021,4.5,109956,115123,5167
22057,LA,Lafourche,,2007,2.8,47386,48759,1373
22057,LA,Lafourche,,2008,3.3,48051,49703,1652
22057,LA,Lafourche,,2009,4.5,46326,48533,2207
22057,LA,Lafourche,,2010,5.8,42477,45083,2606
22057,LA,Lafourche,,2011,5.8,41990,44577,2587
22057,LA,Lafourche,,2012,5,43369,45668,2299
22057,LA,Lafourche,,2013,4.7,44662,46873,2211
22057,LA,Lafourche,,2014,4.7,46020,48292,2272
22057,LA,Lafourche,,2015,5.4,43950,46446,2496
22057,LA,Lafourche,,2016,6.3,40617,43345,2728
22057,LA,Lafourche,,2017,5.2,39813,41994,2181
22057,LA,Lafourche,,2018,4.6,40273,42236,1963
22057,LA,Lafourche,,2019,4.3,40323,42151,1828
22057,LA,Lafourche,,2020,6.9,38299,41152,2853
22057,LA,Lafourche,,2021,4.6,38805,40657,1852
22059,LA,La Salle,,2007,3.7,6010,6240,230
22059,LA,La Salle,,2008,3.8,6108,6351,243
22059,LA,La Salle,,2009,6.8,5990,6429,439
22059,LA,La Salle,,2010,6.1,6049,6445,396
22059,LA,La Salle,,2011,5.4,6355,6720,365
22059,LA,La Salle,,2012,4.8,6447,6775,328
22059,LA,La Salle,,2013,4.8,6648,6982,334
22059,LA,La Salle,,2014,5.1,6264,6602,338
22059,LA,La Salle,,2015,6.9,6128,6580,452
22059,LA,La Salle,,2016,6.6,5862,6278,416
22059,LA,La Salle,,2017,4.7,5864,6152,288
22059,LA,La Salle,,2018,4.3,6100,6374,274
22059,LA,La Salle,,2019,4.1,6474,6752,278
22059,LA,La Salle,,2020,5.2,6475,6827,352
22059,LA,La Salle,,2021,3.3,6458,6677,219
22061,LA,Lincoln,,2007,4.8,17981,18880,899
22061,LA,Lincoln,,2008,5.2,18230,19224,994
22061,LA,Lincoln,,2009,7.4,17894,19330,1436
22061,LA,Lincoln,,2010,8.3,18609,20284,1675
22061,LA,Lincoln,,2011,8.8,18372,20142,1770
22061,LA,Lincoln,,2012,8.2,17948,19558,1610
22061,LA,Lincoln,,2013,7.5,18997,20544,1547
22061,LA,Lincoln,,2014,7.4,19061,20580,1519
22061,LA,Lincoln,,2015,6.9,19518,20974,1456
22061,LA,Lincoln,,2016,6.2,20153,21490,1337
22061,LA,Lincoln,,2017,5.2,20480,21597,1117
22061,LA,Lincoln,,2018,5.1,20935,22063,1128
22061,LA,Lincoln,,2019,5.2,20876,22017,1141
22061,LA,Lincoln,,2020,6.7,19584,20987,1403
22061,LA,Lincoln,,2021,4.3,20215,21118,903
22063,LA,Livingston,,2007,3.7,53703,55789,2086
22063,LA,Livingston,,2008,4.1,55477,57870,2393
22063,LA,Livingston,,2009,6.1,55451,59041,3590
22063,LA,Livingston,,2010,7.1,56907,61247,4340
22063,LA,Livingston,,2011,6.9,57415,61688,4273
22063,LA,Livingston,,2012,6.1,58633,62446,3813
22063,LA,Livingston,,2013,5.6,60514,64110,3596
22063,LA,Livingston,,2014,5.4,62728,66303,3575
22063,LA,Livingston,,2015,5.1,64556,68016,3460
22063,LA,Livingston,,2016,5.1,65272,68759,3487
22063,LA,Livingston,,2017,4.2,64965,67824,2859
22063,LA,Livingston,,2018,4,66455,69211,2756
22063,LA,Livingston,,2019,3.9,66865,69607,2742
22063,LA,Livingston,,2020,6.8,64067,68727,4660
22063,LA,Livingston,,2021,3.8,66611,69221,2610
22065,LA,Madison,,2007,6.5,4152,4441,289
22065,LA,Madison,,2008,7.5,4283,4631,348
22065,LA,Madison,,2009,9.4,4244,4686,442
22065,LA,Madison,,2010,11.4,3683,4157,474
22065,LA,Madison,,2011,12.1,3503,3984,481
22065,LA,Madison,,2012,11.5,3449,3899,450
22065,LA,Madison,,2013,10.6,3533,3953,420
22065,LA,Madison,,2014,10.9,3479,3903,424
22065,LA,Madison,,2015,9.2,3528,3887,359
22065,LA,Madison,,2016,9,3495,3840,345
22065,LA,Madison,,2017,8.1,3479,3785,306
22065,LA,Madison,,2018,8.2,3324,3621,297
22065,LA,Madison,,2019,7.7,3272,3545,273
22065,LA,Madison,,2020,9.1,3211,3532,321
22065,LA,Madison,,2021,6.7,3244,3478,234
22067,LA,Morehouse,,2007,7.8,10726,11636,910
22067,LA,Morehouse,,2008,8.5,10740,11742,1002
22067,LA,Morehouse,,2009,14.5,9903,11576,1673
22067,LA,Morehouse,,2010,14.6,9423,11036,1613
22067,LA,Morehouse,,2011,13.7,9540,11059,1519
22067,LA,Morehouse,,2012,12.5,9856,11260,1404
22067,LA,Morehouse,,2013,11.9,9769,11093,1324
22067,LA,Morehouse,,2014,11,9880,11106,1226
22067,LA,Morehouse,,2015,10.9,9597,10773,1176
22067,LA,Morehouse,,2016,9.7,9603,10635,1032
22067,LA,Morehouse,,2017,8,9550,10377,827
22067,LA,Morehouse,,2018,8.1,9367,10192,825
22067,LA,Morehouse,,2019,8,9201,10001,800
22067,LA,Morehouse,,2020,10.4,8971,10017,1046
22067,LA,Morehouse,,2021,7.3,9214,9942,728
22069,LA,Natchitoches,,2007,5,16555,17419,864
22069,LA,Natchitoches,,2008,5.8,16174,17168,994
22069,LA,Natchitoches,,2009,8.1,15971,17372,1401
22069,LA,Natchitoches,,2010,8.5,15163,16567,1404
22069,LA,Natchitoches,,2011,8.8,14766,16188,1422
22069,LA,Natchitoches,,2012,8.5,14718,16092,1374
22069,LA,Natchitoches,,2013,8,15474,16816,1342
22069,LA,Natchitoches,,2014,7.6,15539,16818,1279
22069,LA,Natchitoches,,2015,7.5,15256,16501,1245
22069,LA,Natchitoches,,2016,6.7,15606,16733,1127
22069,LA,Natchitoches,,2017,6,15390,16368,978
22069,LA,Natchitoches,,2018,5.8,15530,16480,950
22069,LA,Natchitoches,,2019,5.8,15456,16413,957
22069,LA,Natchitoches,,2020,7.3,14903,16083,1180
22069,LA,Natchitoches,,2021,4.7,15575,16341,766
22071,LA,Orleans,,2007,4.9,102178,107432,5254
22071,LA,Orleans,,2008,5.7,124926,132498,7572
22071,LA,Orleans,,2009,7.9,134507,146041,11534
22071,LA,Orleans,,2010,8.2,149075,162385,13310
22071,LA,Orleans,,2011,8.2,152605,166238,13633
22071,LA,Orleans,,2012,7.5,156736,169480,12744
22071,LA,Orleans,,2013,7,161251,173459,12208
22071,LA,Orleans,,2014,6.8,166143,178265,12122
22071,LA,Orleans,,2015,6.5,169564,181288,11724
22071,LA,Orleans,,2016,5.9,169604,180187,10583
22071,LA,Orleans,,2017,5.1,169724,178923,9199
22071,LA,Orleans,,2018,5,170148,179026,8878
22071,LA,Orleans,,2019,4.7,171311,179756,8445
22071,LA,Orleans,,2020,12.5,157276,179774,22498
22071,LA,Orleans,,2021,8.3,162980,177776,14796
22073,LA,Ouachita,,2007,4.9,68056,71533,3477
22073,LA,Ouachita,,2008,4.9,67661,71150,3489
22073,LA,Ouachita,,2009,6.9,66269,71206,4937
22073,LA,Ouachita,,2010,7.8,65154,70667,5513
22073,LA,Ouachita,,2011,7.9,64533,70080,5547
22073,LA,Ouachita,,2012,7.4,65785,71006,5221
22073,LA,Ouachita,,2013,6.9,66065,70976,4911
22073,LA,Ouachita,,2014,6.8,66761,71668,4907
22073,LA,Ouachita,,2015,6.6,67230,71983,4753
22073,LA,Ouachita,,2016,6.1,67279,71640,4361
22073,LA,Ouachita,,2017,5.3,67017,70733,3716
22073,LA,Ouachita,,2018,5.1,67486,71103,3617
22073,LA,Ouachita,,2019,5.1,66849,70446,3597
22073,LA,Ouachita,,2020,7.9,63914,69374,5460
22073,LA,Ouachita,,2021,5,65924,69404,3480
22075,LA,Plaquemines,,2007,3.8,8660,8999,339
22075,LA,Plaquemines,,2008,4.5,8020,8395,375
22075,LA,Plaquemines,,2009,6.5,7469,7986,517
22075,LA,Plaquemines,,2010,5.7,9458,10031,573
22075,LA,Plaquemines,,2011,6,9522,10130,608
22075,LA,Plaquemines,,2012,5.7,9602,10179,577
22075,LA,Plaquemines,,2013,5.5,9516,10065,549
22075,LA,Plaquemines,,2014,5.6,9626,10195,569
22075,LA,Plaquemines,,2015,5.6,9714,10286,572
22075,LA,Plaquemines,,2016,5.4,9651,10197,546
22075,LA,Plaquemines,,2017,4.7,9560,10027,467
22075,LA,Plaquemines,,2018,4.6,9626,10088,462
22075,LA,Plaquemines,,2019,4.2,9621,10041,420
22075,LA,Plaquemines,,2020,7.5,8817,9528,711
22075,LA,Plaquemines,,2021,4.3,9126,9539,413
22077,LA,Pointe Coupee,,2007,4.5,9067,9498,431
22077,LA,Pointe Coupee,,2008,5,9084,9565,481
22077,LA,Pointe Coupee,,2009,6.9,8871,9529,658
22077,LA,Pointe Coupee,,2010,8.2,9171,9988,817
22077,LA,Pointe Coupee,,2011,8.7,9139,10008,869
22077,LA,Pointe Coupee,,2012,7.8,9146,9921,775
22077,LA,Pointe Coupee,,2013,7.3,9187,9909,722
22077,LA,Pointe Coupee,,2014,6.9,9366,10061,695
22077,LA,Pointe Coupee,,2015,6.6,9423,10085,662
22077,LA,Pointe Coupee,,2016,6.5,9325,9972,647
22077,LA,Pointe Coupee,,2017,5.6,9455,10014,559
22077,LA,Pointe Coupee,,2018,5.3,9415,9943,528
22077,LA,Pointe Coupee,,2019,5.2,9304,9812,508
22077,LA,Pointe Coupee,,2020,8.4,8653,9446,793
22077,LA,Pointe Coupee,,2021,5.7,8997,9544,547
22079,LA,Rapides,,2007,4.1,57334,59757,2423
22079,LA,Rapides,,2008,4.4,58962,61659,2697
22079,LA,Rapides,,2009,6.4,56962,60831,3869
22079,LA,Rapides,,2010,7.2,54571,58785,4214
22079,LA,Rapides,,2011,7.3,54175,58413,4238
22079,LA,Rapides,,2012,6.7,53634,57491,3857
22079,LA,Rapides,,2013,6.6,53455,57222,3767
22079,LA,Rapides,,2014,6.6,53998,57784,3786
22079,LA,Rapides,,2015,6.4,54240,57958,3718
22079,LA,Rapides,,2016,6.2,53805,57346,3541
22079,LA,Rapides,,2017,5.6,53019,56169,3150
22079,LA,Rapides,,2018,5.2,52729,55629,2900
22079,LA,Rapides,,2019,4.9,52558,55257,2699
22079,LA,Rapides,,2020,6.7,51015,54677,3662
22079,LA,Rapides,,2021,4,53197,55425,2228
22081,LA,Red River,,2007,6.4,3240,3460,220
22081,LA,Red River,,2008,7.4,3209,3466,257
22081,LA,Red River,,2009,9.5,3188,3523,335
22081,LA,Red River,,2010,8,3695,4016,321
22081,LA,Red River,,2011,7.3,3766,4063,297
22081,LA,Red River,,2012,7,3686,3963,277
22081,LA,Red River,,2013,7.3,3578,3858,280
22081,LA,Red River,,2014,7.1,3693,3974,281
22081,LA,Red River,,2015,6.9,3632,3900,268
22081,LA,Red River,,2016,6,3583,3813,230
22081,LA,Red River,,2017,5.2,3664,3865,201
22081,LA,Red River,,2018,4.4,3883,4062,179
22081,LA,Red River,,2019,4.9,3577,3762,185
22081,LA,Red River,,2020,6.7,3345,3584,239
22081,LA,Red River,,2021,4.3,3509,3668,159
22083,LA,Richland,,2007,6.1,8161,8689,528
22083,LA,Richland,,2008,6.2,8259,8805,546
22083,LA,Richland,,2009,9.7,8052,8919,867
22083,LA,Richland,,2010,10.4,7866,8782,916
22083,LA,Richland,,2011,10.4,7900,8819,919
22083,LA,Richland,,2012,9.3,7886,8698,812
22083,LA,Richland,,2013,9.3,7853,8654,801
22083,LA,Richland,,2014,8.5,7938,8680,742
22083,LA,Richland,,2015,8.7,7879,8628,749
22083,LA,Richland,,2016,7.4,7827,8455,628
22083,LA,Richland,,2017,6.1,7818,8328,510
22083,LA,Richland,,2018,6.2,7827,8340,513
22083,LA,Richland,,2019,6,7761,8258,497
22083,LA,Richland,,2020,8.2,7436,8098,662
22083,LA,Richland,,2021,5.2,7695,8117,422
22085,LA,Sabine,,2007,4.3,9016,9423,407
22085,LA,Sabine,,2008,4.7,9106,9559,453
22085,LA,Sabine,,2009,8.1,8698,9467,769
22085,LA,Sabine,,2010,6.9,9006,9669,663
22085,LA,Sabine,,2011,6.8,8854,9498,644
22085,LA,Sabine,,2012,6.6,8641,9255,614
22085,LA,Sabine,,2013,6.5,8596,9192,596
22085,LA,Sabine,,2014,6.4,8582,9171,589
22085,LA,Sabine,,2015,7.1,8769,9439,670
22085,LA,Sabine,,2016,6.9,8516,9150,634
22085,LA,Sabine,,2017,5.5,8355,8841,486
22085,LA,Sabine,,2018,5.1,8599,9062,463
22085,LA,Sabine,,2019,4.9,8806,9259,453
22085,LA,Sabine,,2020,6,8652,9201,549
22085,LA,Sabine,,2021,3.7,8929,9271,342
22087,LA,St. Bernard,,2007,4.2,9335,9741,406
22087,LA,St. Bernard,,2008,4.3,16649,17390,741
22087,LA,St. Bernard,,2009,6.2,16979,18102,1123
22087,LA,St. Bernard,,2010,7.9,14681,15934,1253
22087,LA,St. Bernard,,2011,8.1,15545,16908,1363
22087,LA,St. Bernard,,2012,7.6,16365,17712,1347
22087,LA,St. Bernard,,2013,7.1,17202,18513,1311
22087,LA,St. Bernard,,2014,6.8,17840,19140,1300
22087,LA,St. Bernard,,2015,6.6,18354,19641,1287
22087,LA,St. Bernard,,2016,6.1,18379,19571,1192
22087,LA,St. Bernard,,2017,5.2,18523,19546,1023
22087,LA,St. Bernard,,2018,4.9,18887,19869,982
22087,LA,St. Bernard,,2019,4.7,19273,20223,950
22087,LA,St. Bernard,,2020,10.5,17889,19995,2106
22087,LA,St. Bernard,,2021,6.8,18549,19908,1359
22089,LA,St. Charles,,2007,3.7,25270,26231,961
22089,LA,St. Charles,,2008,4.5,23464,24558,1094
22089,LA,St. Charles,,2009,6.5,22231,23776,1545
22089,LA,St. Charles,,2010,7,23691,25470,1779
22089,LA,St. Charles,,2011,6.8,23225,24932,1707
22089,LA,St. Charles,,2012,6.3,23279,24833,1554
22089,LA,St. Charles,,2013,6,23442,24943,1501
22089,LA,St. Charles,,2014,6,23863,25378,1515
22089,LA,St. Charles,,2015,5.7,24062,25511,1449
22089,LA,St. Charles,,2016,5.3,24004,25351,1347
22089,LA,St. Charles,,2017,4.5,23820,24942,1122
22089,LA,St. Charles,,2018,4.3,24056,25141,1085
22089,LA,St. Charles,,2019,4.1,24373,25428,1055
22089,LA,St. Charles,,2020,8.2,22356,24358,2002
22089,LA,St. Charles,,2021,5,23150,24370,1220
22091,LA,St. Helena,,2007,7.3,3898,4203,305
22091,LA,St. Helena,,2008,8.4,3876,4233,357
22091,LA,St. Helena,,2009,10.8,3780,4238,458
22091,LA,St. Helena,,2010,12.4,4114,4697,583
22091,LA,St. Helena,,2011,13,4034,4639,605
22091,LA,St. Helena,,2012,11.5,4078,4610,532
22091,LA,St. Helena,,2013,10.9,4069,4567,498
22091,LA,St. Helena,,2014,9.8,4067,4511,444
22091,LA,St. Helena,,2015,9,4104,4511,407
22091,LA,St. Helena,,2016,7.7,4058,4395,337
22091,LA,St. Helena,,2017,6.6,4036,4323,287
22091,LA,St. Helena,,2018,6.5,4046,4326,280
22091,LA,St. Helena,,2019,5.9,3984,4235,251
22091,LA,St. Helena,,2020,12.2,3720,4239,519
22091,LA,St. Helena,,2021,9.2,3867,4257,390
22093,LA,St. James,,2007,6.7,8036,8610,574
22093,LA,St. James,,2008,7.1,8446,9089,643
22093,LA,St. James,,2009,9.2,8485,9349,864
22093,LA,St. James,,2010,11.1,8985,10102,1117
22093,LA,St. James,,2011,11.6,8807,9960,1153
22093,LA,St. James,,2012,9.7,8753,9691,938
22093,LA,St. James,,2013,8.9,8809,9671,862
22093,LA,St. James,,2014,8.4,8902,9721,819
22093,LA,St. James,,2015,8.4,8942,9763,821
22093,LA,St. James,,2016,7.5,8898,9618,720
22093,LA,St. James,,2017,6.6,8771,9395,624
22093,LA,St. James,,2018,6.2,8680,9249,569
22093,LA,St. James,,2019,5.8,8780,9316,536
22093,LA,St. James,,2020,10.4,7924,8842,918
22093,LA,St. James,,2021,7.4,8193,8845,652
22095,LA,St. John the Baptist,,2007,4.8,21376,22458,1082
22095,LA,St. John the Baptist,,2008,5.8,19749,20957,1208
22095,LA,St. John the Baptist,,2009,8.6,18723,20483,1760
22095,LA,St. John the Baptist,,2010,10,19331,21478,2147
22095,LA,St. John the Baptist,,2011,10,18883,20989,2106
22095,LA,St. John the Baptist,,2012,8.8,18761,20580,1819
22095,LA,St. John the Baptist,,2013,8.3,18419,20087,1668
22095,LA,St. John the Baptist,,2014,7.8,18698,20286,1588
22095,LA,St. John the Baptist,,2015,7.4,18786,20293,1507
22095,LA,St. John the Baptist,,2016,6.8,18706,20080,1374
22095,LA,St. John the Baptist,,2017,6.1,18533,19745,1212
22095,LA,St. John the Baptist,,2018,5.6,18552,19657,1105
22095,LA,St. John the Baptist,,2019,5.4,18566,19627,1061
22095,LA,St. John the Baptist,,2020,11.7,16930,19184,2254
22095,LA,St. John the Baptist,,2021,8.5,17521,19155,1634
22097,LA,St. Landry,,2007,4.4,35757,37420,1663
22097,LA,St. Landry,,2008,5.1,35840,37749,1909
22097,LA,St. Landry,,2009,7.4,35328,38145,2817
22097,LA,St. Landry,,2010,9.1,31142,34256,3114
22097,LA,St. Landry,,2011,9,30710,33736,3026
22097,LA,St. Landry,,2012,7.9,30872,33532,2660
22097,LA,St. Landry,,2013,7.5,31175,33700,2525
22097,LA,St. Landry,,2014,7.5,31489,34039,2550
22097,LA,St. Landry,,2015,8,30959,33642,2683
22097,LA,St. Landry,,2016,8.1,30194,32850,2656
22097,LA,St. Landry,,2017,6.7,29970,32111,2141
22097,LA,St. Landry,,2018,6.2,30060,32035,1975
22097,LA,St. Landry,,2019,6,30121,32058,1937
22097,LA,St. Landry,,2020,9.2,29202,32177,2975
22097,LA,St. Landry,,2021,6.3,30008,32024,2016
22099,LA,St. Martin,,2007,3.6,22787,23628,841
22099,LA,St. Martin,,2008,4,23102,24060,958
22099,LA,St. Martin,,2009,6.6,22291,23857,1566
22099,LA,St. Martin,,2010,7.5,22227,24030,1803
22099,LA,St. Martin,,2011,7,22484,24172,1688
22099,LA,St. Martin,,2012,5.9,22897,24341,1444
22099,LA,St. Martin,,2013,5.6,22945,24319,1374
22099,LA,St. Martin,,2014,5.6,23185,24569,1384
22099,LA,St. Martin,,2015,6.8,22343,23980,1637
22099,LA,St. Martin,,2016,7.8,21208,22992,1784
22099,LA,St. Martin,,2017,6.1,21202,22572,1370
22099,LA,St. Martin,,2018,5.2,21192,22351,1159
22099,LA,St. Martin,,2019,4.9,21193,22291,1098
22099,LA,St. Martin,,2020,8.7,19886,21773,1887
22099,LA,St. Martin,,2021,5.6,20668,21901,1233
22101,LA,St. Mary,,2007,4.1,22355,23316,961
22101,LA,St. Mary,,2008,4.6,22417,23505,1088
22101,LA,St. Mary,,2009,7.5,21362,23102,1740
22101,LA,St. Mary,,2010,8.9,22908,25141,2233
22101,LA,St. Mary,,2011,8.4,23077,25206,2129
22101,LA,St. Mary,,2012,7.1,23697,25521,1824
22101,LA,St. Mary,,2013,6.3,23417,24991,1574
22101,LA,St. Mary,,2014,6.2,23671,25224,1553
22101,LA,St. Mary,,2015,7.6,22338,24165,1827
22101,LA,St. Mary,,2016,9.4,19903,21967,2064
22101,LA,St. Mary,,2017,7.9,18793,20396,1603
22101,LA,St. Mary,,2018,6.5,18829,20129,1300
22101,LA,St. Mary,,2019,5.7,18728,19854,1126
22101,LA,St. Mary,,2020,9.7,17494,19379,1885
22101,LA,St. Mary,,2021,6.7,17897,19192,1295
22103,LA,St. Tammany,,2007,3.1,112677,116272,3595
22103,LA,St. Tammany,,2008,3.8,106488,110671,4183
22103,LA,St. Tammany,,2009,5.4,102102,107945,5843
22103,LA,St. Tammany,,2010,5.9,102325,108779,6454
22103,LA,St. Tammany,,2011,6,101971,108436,6465
22103,LA,St. Tammany,,2012,5.6,103152,109310,6158
22103,LA,St. Tammany,,2013,5.5,105012,111147,6135
22103,LA,St. Tammany,,2014,5.5,108152,114505,6353
22103,LA,St. Tammany,,2015,5.3,110740,116999,6259
22103,LA,St. Tammany,,2016,5,111775,117626,5851
22103,LA,St. Tammany,,2017,4.3,112576,117603,5027
22103,LA,St. Tammany,,2018,4.1,114348,119274,4926
22103,LA,St. Tammany,,2019,4,116422,121285,4863
22103,LA,St. Tammany,,2020,7.1,108347,116652,8305
22103,LA,St. Tammany,,2021,3.8,112322,116814,4492
22105,LA,Tangipahoa,,2007,4.4,49949,52269,2320
22105,LA,Tangipahoa,,2008,5.4,49955,52781,2826
22105,LA,Tangipahoa,,2009,7.6,48764,52784,4020
22105,LA,Tangipahoa,,2010,9.2,48649,53565,4916
22105,LA,Tangipahoa,,2011,9.1,48547,53422,4875
22105,LA,Tangipahoa,,2012,8.1,48894,53222,4328
22105,LA,Tangipahoa,,2013,7.7,48836,52908,4072
22105,LA,Tangipahoa,,2014,7.5,49512,53508,3996
22105,LA,Tangipahoa,,2015,7.2,50124,53997,3873
22105,LA,Tangipahoa,,2016,6.8,50567,54229,3662
22105,LA,Tangipahoa,,2017,5.7,51769,54897,3128
22105,LA,Tangipahoa,,2018,5.4,51725,54700,2975
22105,LA,Tangipahoa,,2019,5.3,52036,54958,2922
22105,LA,Tangipahoa,,2020,10.1,50450,56126,5676
22105,LA,Tangipahoa,,2021,6.4,52524,56131,3607
22107,LA,Tensas,,2007,7.3,2046,2206,160
22107,LA,Tensas,,2008,8.1,1938,2109,171
22107,LA,Tensas,,2009,12,1807,2053,246
22107,LA,Tensas,,2010,13.1,1836,2112,276
22107,LA,Tensas,,2011,12.3,1736,1980,244
22107,LA,Tensas,,2012,10.3,1631,1819,188
22107,LA,Tensas,,2013,9,1606,1765,159
22107,LA,Tensas,,2014,9.3,1612,1777,165
22107,LA,Tensas,,2015,9.7,1544,1710,166
22107,LA,Tensas,,2016,9.8,1468,1628,160
22107,LA,Tensas,,2017,8.4,1423,1554,131
22107,LA,Tensas,,2018,7.6,1339,1449,110
22107,LA,Tensas,,2019,8.1,1284,1397,113
22107,LA,Tensas,,2020,9,1221,1342,121
22107,LA,Tensas,,2021,5.9,1240,1318,78
22109,LA,Terrebonne,,2007,2.9,53097,54685,1588
22109,LA,Terrebonne,,2008,3.6,53999,55989,1990
22109,LA,Terrebonne,,2009,4.8,51783,54398,2615
22109,LA,Terrebonne,,2010,6.1,47811,50914,3103
22109,LA,Terrebonne,,2011,5.9,47165,50120,2955
22109,LA,Terrebonne,,2012,5.1,48690,51289,2599
22109,LA,Terrebonne,,2013,4.8,50521,53086,2565
22109,LA,Terrebonne,,2014,4.8,51868,54458,2590
22109,LA,Terrebonne,,2015,5.9,49667,52800,3133
22109,LA,Terrebonne,,2016,7,45592,49011,3419
22109,LA,Terrebonne,,2017,5.7,44157,46818,2661
22109,LA,Terrebonne,,2018,4.9,44313,46613,2300
22109,LA,Terrebonne,,2019,4.5,44363,46437,2074
22109,LA,Terrebonne,,2020,8.2,41907,45659,3752
22109,LA,Terrebonne,,2021,5.8,42418,45015,2597
22111,LA,Union,,2007,4.9,9677,10176,499
22111,LA,Union,,2008,5.2,9552,10078,526
22111,LA,Union,,2009,10.6,9221,10319,1098
22111,LA,Union,,2010,9.9,8702,9654,952
22111,LA,Union,,2011,9,8530,9376,846
22111,LA,Union,,2012,7.9,8525,9259,734
22111,LA,Union,,2013,7.5,8477,9162,685
22111,LA,Union,,2014,7.4,8643,9331,688
22111,LA,Union,,2015,7.1,8655,9317,662
22111,LA,Union,,2016,6.6,8647,9254,607
22111,LA,Union,,2017,5.6,8703,9215,512
22111,LA,Union,,2018,5.6,8716,9229,513
22111,LA,Union,,2019,5.6,8616,9129,513
22111,LA,Union,,2020,7.7,8300,8988,688
22111,LA,Union,,2021,4.8,8557,8993,436
22113,LA,Vermilion,,2007,3.7,23193,24087,894
22113,LA,Vermilion,,2008,4.2,23384,24398,1014
22113,LA,Vermilion,,2009,6.6,23058,24675,1617
22113,LA,Vermilion,,2010,6.9,23867,25628,1761
22113,LA,Vermilion,,2011,6.3,23870,25464,1594
22113,LA,Vermilion,,2012,5.5,24521,25941,1420
22113,LA,Vermilion,,2013,5.4,24730,26133,1403
22113,LA,Vermilion,,2014,5.5,24968,26415,1447
22113,LA,Vermilion,,2015,6.9,23959,25733,1774
22113,LA,Vermilion,,2016,7.6,22848,24732,1884
22113,LA,Vermilion,,2017,6,22808,24261,1453
22113,LA,Vermilion,,2018,5.2,22997,24271,1274
22113,LA,Vermilion,,2019,4.9,22976,24150,1174
22113,LA,Vermilion,,2020,7.9,21719,23581,1862
22113,LA,Vermilion,,2021,5,22645,23846,1201
22115,LA,Vernon,,2007,4.5,20191,21132,941
22115,LA,Vernon,,2008,4.6,19732,20686,954
22115,LA,Vernon,,2009,6.7,19228,20605,1377
22115,LA,Vernon,,2010,8.1,17027,18530,1503
22115,LA,Vernon,,2011,8.6,17638,19291,1653
22115,LA,Vernon,,2012,7.9,17460,18956,1496
22115,LA,Vernon,,2013,8.5,16353,17866,1513
22115,LA,Vernon,,2014,8.4,15897,17349,1452
22115,LA,Vernon,,2015,7.7,16019,17359,1340
22115,LA,Vernon,,2016,7.3,15720,16949,1229
22115,LA,Vernon,,2017,6.5,15329,16396,1067
22115,LA,Vernon,,2018,6.4,14952,15977,1025
22115,LA,Vernon,,2019,5.8,14947,15867,920
22115,LA,Vernon,,2020,7.7,14576,15791,1215
22115,LA,Vernon,,2021,4.6,15282,16011,729
22117,LA,Washington,,2007,5.6,14956,15848,892
22117,LA,Washington,,2008,6.2,14920,15898,978
22117,LA,Washington,,2009,8.8,14359,15737,1378
22117,LA,Washington,,2010,9.1,15533,17086,1553
22117,LA,Washington,,2011,9,15158,16660,1502
22117,LA,Washington,,2012,8.4,15147,16539,1392
22117,LA,Washington,,2013,8,15098,16415,1317
22117,LA,Washington,,2014,7.7,15582,16884,1302
22117,LA,Washington,,2015,7.6,15687,16974,1287
22117,LA,Washington,,2016,7,15773,16966,1193
22117,LA,Washington,,2017,5.8,15975,16953,978
22117,LA,Washington,,2018,5.7,15918,16879,961
22117,LA,Washington,,2019,5.7,15888,16843,955
22117,LA,Washington,,2020,8.7,15165,16612,1447
22117,LA,Washington,,2021,5.9,15882,16870,988
22119,LA,Webster,,2007,5,18774,19765,991
22119,LA,Webster,,2008,5.9,18895,20086,1191
22119,LA,Webster,,2009,8.6,17959,19657,1698
22119,LA,Webster,,2010,9.8,15145,16794,1649
22119,LA,Webster,,2011,9.6,15017,16611,1594
22119,LA,Webster,,2012,9.2,14653,16137,1484
22119,LA,Webster,,2013,9.2,14255,15700,1445
22119,LA,Webster,,2014,8.6,14268,15605,1337
22119,LA,Webster,,2015,8.8,14157,15517,1360
22119,LA,Webster,,2016,8.5,13919,15218,1299
22119,LA,Webster,,2017,6.9,13771,14784,1013
22119,LA,Webster,,2018,6,13758,14641,883
22119,LA,Webster,,2019,5.9,13620,14471,851
22119,LA,Webster,,2020,8.4,12771,13948,1177
22119,LA,Webster,,2021,5.5,13235,14001,766
22121,LA,West Baton Rouge,,2007,4,10193,10613,420
22121,LA,West Baton Rouge,,2008,4.7,10175,10674,499
22121,LA,West Baton Rouge,,2009,6.7,9955,10667,712
22121,LA,West Baton Rouge,,2010,7.4,11032,11917,885
22121,LA,West Baton Rouge,,2011,7.4,11086,11969,883
22121,LA,West Baton Rouge,,2012,6.6,11177,11963,786
22121,LA,West Baton Rouge,,2013,5.9,11576,12300,724
22121,LA,West Baton Rouge,,2014,5.7,12098,12829,731
22121,LA,West Baton Rouge,,2015,5.6,12472,13206,734
22121,LA,West Baton Rouge,,2016,5.3,12549,13256,707
22121,LA,West Baton Rouge,,2017,4.6,12889,13508,619
22121,LA,West Baton Rouge,,2018,4.4,13138,13737,599
22121,LA,West Baton Rouge,,2019,4.4,13120,13720,600
22121,LA,West Baton Rouge,,2020,7.6,12461,13489,1028
22121,LA,West Baton Rouge,,2021,4.9,12949,13611,662
22123,LA,West Carroll,,2007,9.2,4058,4468,410
22123,LA,West Carroll,,2008,9.9,3975,4413,438
22123,LA,West Carroll,,2009,16.2,3767,4497,730
22123,LA,West Carroll,,2010,15.4,3742,4425,683
22123,LA,West Carroll,,2011,15.1,3618,4263,645
22123,LA,West Carroll,,2012,13,3623,4166,543
22123,LA,West Carroll,,2013,12.2,3719,4238,519
22123,LA,West Carroll,,2014,12.8,3679,4220,541
22123,LA,West Carroll,,2015,13.4,3556,4104,548
22123,LA,West Carroll,,2016,12,3617,4108,491
22123,LA,West Carroll,,2017,9.8,3613,4005,392
22123,LA,West Carroll,,2018,8.9,3657,4013,356
22123,LA,West Carroll,,2019,10.3,3271,3645,374
22123,LA,West Carroll,,2020,10.8,3262,3656,394
22123,LA,West Carroll,,2021,6.3,3286,3508,222
22125,LA,West Feliciana,,2007,5.4,4520,4778,258
22125,LA,West Feliciana,,2008,5.5,4494,4754,260
22125,LA,West Feliciana,,2009,7.5,4395,4750,355
22125,LA,West Feliciana,,2010,6.3,4905,5237,332
22125,LA,West Feliciana,,2011,6.3,4837,5160,323
22125,LA,West Feliciana,,2012,5.8,4858,5156,298
22125,LA,West Feliciana,,2013,5.7,4935,5233,298
22125,LA,West Feliciana,,2014,5.6,5039,5337,298
22125,LA,West Feliciana,,2015,5.2,5102,5384,282
22125,LA,West Feliciana,,2016,5.2,5058,5334,276
22125,LA,West Feliciana,,2017,4.2,5114,5336,222
22125,LA,West Feliciana,,2018,3.9,5200,5410,210
22125,LA,West Feliciana,,2019,4,5223,5438,215
22125,LA,West Feliciana,,2020,5.8,4869,5169,300
22125,LA,West Feliciana,,2021,3.7,5060,5253,193
22127,LA,Winn,,2007,4.9,6053,6362,309
22127,LA,Winn,,2008,5.4,6085,6432,347
22127,LA,Winn,,2009,8.4,5970,6514,544
22127,LA,Winn,,2010,8.8,5292,5804,512
22127,LA,Winn,,2011,8.9,5159,5666,507
22127,LA,Winn,,2012,8.1,5246,5711,465
22127,LA,Winn,,2013,7.9,4953,5375,422
22127,LA,Winn,,2014,7.4,4995,5394,399
22127,LA,Winn,,2015,8.4,4870,5317,447
22127,LA,Winn,,2016,7.8,4788,5191,403
22127,LA,Winn,,2017,6.4,4734,5060,326
22127,LA,Winn,,2018,6.1,4664,4968,304
22127,LA,Winn,,2019,6.1,4582,4878,296
22127,LA,Winn,,2020,7.6,4327,4685,358
22127,LA,Winn,,2021,4.8,4381,4602,221
23000,ME,Maine,,2007,4.7,667061,699753,32692
23000,ME,Maine,,2008,5.3,664441,701930,37489
23000,ME,Maine,,2009,8.4,639142,697698,58556
23000,ME,Maine,,2010,8.4,638984,697832,58848
23000,ME,Maine,,2011,7.7,644967,698979,54012
23000,ME,Maine,,2012,7.2,650315,700730,50415
23000,ME,Maine,,2013,6.7,657058,704240,47182
23000,ME,Maine,,2014,5.6,659008,698035,39027
23000,ME,Maine,,2015,4.4,657550,687859,30309
23000,ME,Maine,,2016,3.8,667723,693917,26194
23000,ME,Maine,,2017,3.4,680164,703871,23707
23000,ME,Maine,,2018,3.1,681334,703138,21804
23000,ME,Maine,,2019,2.8,682271,701631,19360
23000,ME,Maine,,2020,5,641262,675231,33969
23000,ME,Maine,,2021,4.6,650334,681884,31550
23001,ME,Androscoggin,,2007,4.6,55395,58065,2670
23001,ME,Androscoggin,,2008,5.4,55035,58172,3137
23001,ME,Androscoggin,,2009,8.7,52923,57986,5063
23001,ME,Androscoggin,,2010,8.9,51144,56130,4986
23001,ME,Androscoggin,,2011,7.9,51570,56017,4447
23001,ME,Androscoggin,,2012,7.5,52037,56231,4194
23001,ME,Androscoggin,,2013,6.7,52579,56367,3788
23001,ME,Androscoggin,,2014,5.4,53019,56041,3022
23001,ME,Androscoggin,,2015,4.2,52859,55166,2307
23001,ME,Androscoggin,,2016,3.6,53500,55482,1982
23001,ME,Androscoggin,,2017,3.2,54211,56004,1793
23001,ME,Androscoggin,,2018,3,54140,55837,1697
23001,ME,Androscoggin,,2019,2.7,54273,55782,1509
23001,ME,Androscoggin,,2020,5.1,51543,54287,2744
23001,ME,Androscoggin,,2021,4.9,51576,54219,2643
23003,ME,Aroostook,,2007,6.3,32889,35097,2208
23003,ME,Aroostook,,2008,6.8,32565,34950,2385
23003,ME,Aroostook,,2009,10.1,31136,34628,3492
23003,ME,Aroostook,,2010,10.1,31361,34871,3510
23003,ME,Aroostook,,2011,9.6,31191,34506,3315
23003,ME,Aroostook,,2012,9,31019,34077,3058
23003,ME,Aroostook,,2013,8.7,30887,33819,2932
23003,ME,Aroostook,,2014,7.5,30530,33021,2491
23003,ME,Aroostook,,2015,5.9,30022,31915,1893
23003,ME,Aroostook,,2016,5.4,29842,31548,1706
23003,ME,Aroostook,,2017,4.9,30220,31779,1559
23003,ME,Aroostook,,2018,4.4,29795,31176,1381
23003,ME,Aroostook,,2019,4.2,29277,30556,1279
23003,ME,Aroostook,,2020,5.1,27715,29199,1484
23003,ME,Aroostook,,2021,5.7,27408,29056,1648
23005,ME,Cumberland,,2007,3.4,151819,157217,5398
23005,ME,Cumberland,,2008,4.1,150942,157401,6459
23005,ME,Cumberland,,2009,6.7,145897,156407,10510
23005,ME,Cumberland,,2010,6.8,145927,156505,10578
23005,ME,Cumberland,,2011,6.2,148311,158112,9801
23005,ME,Cumberland,,2012,5.8,150299,159472,9173
23005,ME,Cumberland,,2013,5.3,152056,160650,8594
23005,ME,Cumberland,,2014,4.4,152585,159584,6999
23005,ME,Cumberland,,2015,3.4,153481,158956,5475
23005,ME,Cumberland,,2016,2.9,157678,162396,4718
23005,ME,Cumberland,,2017,2.6,161555,165899,4344
23005,ME,Cumberland,,2018,2.5,162313,166432,4119
23005,ME,Cumberland,,2019,2.2,163213,166841,3628
23005,ME,Cumberland,,2020,4.9,152878,160751,7873
23005,ME,Cumberland,,2021,4,155942,162433,6491
23007,ME,Franklin,,2007,6.1,13240,14097,857
23007,ME,Franklin,,2008,6.9,13254,14238,984
23007,ME,Franklin,,2009,10.8,12860,14418,1558
23007,ME,Franklin,,2010,9.6,14079,15567,1488
23007,ME,Franklin,,2011,8.9,14096,15467,1371
23007,ME,Franklin,,2012,8.3,14150,15439,1289
23007,ME,Franklin,,2013,7.8,14179,15374,1195
23007,ME,Franklin,,2014,6.5,14003,14971,968
23007,ME,Franklin,,2015,4.8,13932,14629,697
23007,ME,Franklin,,2016,4.5,13838,14483,645
23007,ME,Franklin,,2017,4.1,13960,14563,603
23007,ME,Franklin,,2018,3.7,13997,14535,538
23007,ME,Franklin,,2019,3.5,14029,14535,506
23007,ME,Franklin,,2020,5.6,12953,13726,773
23007,ME,Franklin,,2021,5.3,13109,13839,730
23009,ME,Hancock,,2007,5.5,27806,29417,1611
23009,ME,Hancock,,2008,5.9,27945,29697,1752
23009,ME,Hancock,,2009,9,26762,29407,2645
23009,ME,Hancock,,2010,9.2,27201,29941,2740
23009,ME,Hancock,,2011,8.7,27465,30072,2607
23009,ME,Hancock,,2012,8.3,27383,29865,2482
23009,ME,Hancock,,2013,7.9,27666,30047,2381
23009,ME,Hancock,,2014,6.7,27836,29849,2013
23009,ME,Hancock,,2015,5.6,27616,29250,1634
23009,ME,Hancock,,2016,4.5,27934,29245,1311
23009,ME,Hancock,,2017,3.9,28403,29553,1150
23009,ME,Hancock,,2018,3.5,28646,29678,1032
23009,ME,Hancock,,2019,3.2,28517,29455,938
23009,ME,Hancock,,2020,5.3,26239,27710,1471
23009,ME,Hancock,,2021,5,26953,28376,1423
23011,ME,Kennebec,,2007,4.6,59864,62739,2875
23011,ME,Kennebec,,2008,5.2,60116,63405,3289
23011,ME,Kennebec,,2009,7.9,58264,63236,4972
23011,ME,Kennebec,,2010,7.9,58167,63150,4983
23011,ME,Kennebec,,2011,7.3,58620,63259,4639
23011,ME,Kennebec,,2012,6.9,58655,63002,4347
23011,ME,Kennebec,,2013,6.3,59751,63761,4010
23011,ME,Kennebec,,2014,5.3,60073,63464,3391
23011,ME,Kennebec,,2015,4.3,59397,62035,2638
23011,ME,Kennebec,,2016,3.6,60193,62459,2266
23011,ME,Kennebec,,2017,3.3,61129,63224,2095
23011,ME,Kennebec,,2018,3,60969,62851,1882
23011,ME,Kennebec,,2019,2.7,61082,62758,1676
23011,ME,Kennebec,,2020,4.6,58547,61354,2807
23011,ME,Kennebec,,2021,4.3,58722,61360,2638
23013,ME,Knox,,2007,4.4,20152,21069,917
23013,ME,Knox,,2008,5.1,19860,20936,1076
23013,ME,Knox,,2009,8.2,18911,20599,1688
23013,ME,Knox,,2010,7.7,18894,20464,1570
23013,ME,Knox,,2011,7.2,18973,20443,1470
23013,ME,Knox,,2012,6.6,19195,20561,1366
23013,ME,Knox,,2013,6,19509,20745,1236
23013,ME,Knox,,2014,5.1,19638,20694,1056
23013,ME,Knox,,2015,4.1,19760,20607,847
23013,ME,Knox,,2016,3.5,20034,20762,728
23013,ME,Knox,,2017,3.2,20221,20893,672
23013,ME,Knox,,2018,2.9,20183,20794,611
23013,ME,Knox,,2019,2.6,20033,20576,543
23013,ME,Knox,,2020,5,18584,19562,978
23013,ME,Knox,,2021,4.4,19008,19881,873
23015,ME,Lincoln,,2007,4.2,17407,18172,765
23015,ME,Lincoln,,2008,5,17406,18330,924
23015,ME,Lincoln,,2009,7.9,16541,17952,1411
23015,ME,Lincoln,,2010,7.9,15834,17186,1352
23015,ME,Lincoln,,2011,7.6,15818,17122,1304
23015,ME,Lincoln,,2012,7,15997,17208,1211
23015,ME,Lincoln,,2013,6.9,16149,17337,1188
23015,ME,Lincoln,,2014,5.9,16234,17245,1011
23015,ME,Lincoln,,2015,4.4,16086,16835,749
23015,ME,Lincoln,,2016,3.7,16429,17057,628
23015,ME,Lincoln,,2017,3.3,16620,17188,568
23015,ME,Lincoln,,2018,3.1,16587,17113,526
23015,ME,Lincoln,,2019,2.7,16648,17104,456
23015,ME,Lincoln,,2020,4.9,15584,16386,802
23015,ME,Lincoln,,2021,4.4,15967,16707,740
23017,ME,Oxford,,2007,5.9,26616,28276,1660
23017,ME,Oxford,,2008,6.8,26303,28212,1909
23017,ME,Oxford,,2009,11.1,25016,28141,3125
23017,ME,Oxford,,2010,11.1,24947,28055,3108
23017,ME,Oxford,,2011,10.3,24977,27837,2860
23017,ME,Oxford,,2012,9.3,25205,27804,2599
23017,ME,Oxford,,2013,8.3,25412,27725,2313
23017,ME,Oxford,,2014,7,25504,27413,1909
23017,ME,Oxford,,2015,5.5,25250,26707,1457
23017,ME,Oxford,,2016,4.6,25409,26635,1226
23017,ME,Oxford,,2017,3.9,26006,27052,1046
23017,ME,Oxford,,2018,3.7,25912,26897,985
23017,ME,Oxford,,2019,3.3,25908,26783,875
23017,ME,Oxford,,2020,6.1,24197,25776,1579
23017,ME,Oxford,,2021,5.6,24828,26298,1470
23019,ME,Penobscot,,2007,5.1,74447,78472,4025
23019,ME,Penobscot,,2008,5.6,74419,78842,4423
23019,ME,Penobscot,,2009,8.5,72006,78702,6696
23019,ME,Penobscot,,2010,8.8,72360,79325,6965
23019,ME,Penobscot,,2011,8.1,73076,79527,6451
23019,ME,Penobscot,,2012,7.5,73746,79700,5954
23019,ME,Penobscot,,2013,6.9,74438,79954,5516
23019,ME,Penobscot,,2014,6.1,74358,79150,4792
23019,ME,Penobscot,,2015,4.7,73700,77374,3674
23019,ME,Penobscot,,2016,4.3,73852,77183,3331
23019,ME,Penobscot,,2017,3.8,74621,77582,2961
23019,ME,Penobscot,,2018,3.5,74730,77413,2683
23019,ME,Penobscot,,2019,3,75115,77440,2325
23019,ME,Penobscot,,2020,5,70505,74210,3705
23019,ME,Penobscot,,2021,4.7,71312,74855,3543
23021,ME,Piscataquis,,2007,7.5,6862,7419,557
23021,ME,Piscataquis,,2008,8.2,6793,7399,606
23021,ME,Piscataquis,,2009,12.6,6466,7402,936
23021,ME,Piscataquis,,2010,11.1,7114,8000,886
23021,ME,Piscataquis,,2011,9.9,7146,7934,788
23021,ME,Piscataquis,,2012,9.1,7134,7850,716
23021,ME,Piscataquis,,2013,8.9,7182,7881,699
23021,ME,Piscataquis,,2014,7.2,7157,7714,557
23021,ME,Piscataquis,,2015,5.5,7087,7501,414
23021,ME,Piscataquis,,2016,5,7123,7494,371
23021,ME,Piscataquis,,2017,4.1,7252,7561,309
23021,ME,Piscataquis,,2018,3.8,7229,7516,287
23021,ME,Piscataquis,,2019,3.4,7098,7350,252
23021,ME,Piscataquis,,2020,5,6798,7157,359
23021,ME,Piscataquis,,2021,5,7067,7440,373
23023,ME,Sagadahoc,,2007,3.9,18144,18880,736
23023,ME,Sagadahoc,,2008,4.7,18172,19066,894
23023,ME,Sagadahoc,,2009,7.4,17334,18719,1385
23023,ME,Sagadahoc,,2010,6.9,17950,19281,1331
23023,ME,Sagadahoc,,2011,6.6,17875,19142,1267
23023,ME,Sagadahoc,,2012,6.4,17946,19163,1217
23023,ME,Sagadahoc,,2013,5.7,18010,19092,1082
23023,ME,Sagadahoc,,2014,4.5,18218,19077,859
23023,ME,Sagadahoc,,2015,3.5,18386,19058,672
23023,ME,Sagadahoc,,2016,3,18673,19241,568
23023,ME,Sagadahoc,,2017,2.8,19016,19554,538
23023,ME,Sagadahoc,,2018,2.5,19203,19694,491
23023,ME,Sagadahoc,,2019,2.1,19329,19742,413
23023,ME,Sagadahoc,,2020,4.4,18403,19246,843
23023,ME,Sagadahoc,,2021,3.7,18448,19159,711
23025,ME,Somerset,,2007,6.9,23142,24865,1723
23025,ME,Somerset,,2008,7.7,22856,24767,1911
23025,ME,Somerset,,2009,11.3,21925,24731,2806
23025,ME,Somerset,,2010,11.5,21952,24804,2852
23025,ME,Somerset,,2011,10.6,22038,24663,2625
23025,ME,Somerset,,2012,9.6,22167,24534,2367
23025,ME,Somerset,,2013,9.2,22489,24776,2287
23025,ME,Somerset,,2014,7.8,22476,24372,1896
23025,ME,Somerset,,2015,6.6,22227,23789,1562
23025,ME,Somerset,,2016,5.6,22225,23544,1319
23025,ME,Somerset,,2017,5,22107,23260,1153
23025,ME,Somerset,,2018,4.4,21942,22962,1020
23025,ME,Somerset,,2019,4.1,21738,22657,919
23025,ME,Somerset,,2020,6.1,20662,22010,1348
23025,ME,Somerset,,2021,6.3,20920,22318,1398
23027,ME,Waldo,,2007,5.4,17829,18854,1025
23027,ME,Waldo,,2008,6.1,17928,19085,1157
23027,ME,Waldo,,2009,9.2,17315,19071,1756
23027,ME,Waldo,,2010,8.8,18686,20489,1803
23027,ME,Waldo,,2011,8.1,18734,20386,1652
23027,ME,Waldo,,2012,7.9,18983,20622,1639
23027,ME,Waldo,,2013,7.2,19459,20975,1516
23027,ME,Waldo,,2014,6,19634,20888,1254
23027,ME,Waldo,,2015,5.2,19669,20752,1083
23027,ME,Waldo,,2016,4.2,20041,20914,873
23027,ME,Waldo,,2017,3.7,20550,21333,783
23027,ME,Waldo,,2018,3.2,20654,21347,693
23027,ME,Waldo,,2019,2.9,20291,20898,607
23027,ME,Waldo,,2020,4.7,19035,19981,946
23027,ME,Waldo,,2021,4.7,19298,20249,951
23029,ME,Washington,,2007,7.7,13371,14484,1113
23029,ME,Washington,,2008,8.3,13298,14507,1209
23029,ME,Washington,,2009,11.4,12792,14439,1647
23029,ME,Washington,,2010,11.2,13339,15017,1678
23029,ME,Washington,,2011,10.3,13330,14867,1537
23029,ME,Washington,,2012,9.9,13230,14686,1456
23029,ME,Washington,,2013,9.3,13250,14609,1359
23029,ME,Washington,,2014,8.1,13248,14412,1164
23029,ME,Washington,,2015,6.4,13184,14085,901
23029,ME,Washington,,2016,5.5,13268,14042,774
23029,ME,Washington,,2017,5,13450,14163,713
23029,ME,Washington,,2018,4.6,13351,13988,637
23029,ME,Washington,,2019,4.2,13228,13810,582
23029,ME,Washington,,2020,5.7,12574,13340,766
23029,ME,Washington,,2021,6.5,12583,13452,869
23031,ME,York,,2007,4,108082,112622,4540
23031,ME,York,,2008,4.8,107554,112923,5369
23031,ME,York,,2009,8,102976,111875,8899
23031,ME,York,,2010,8.3,100031,109048,9017
23031,ME,York,,2011,7.2,101749,109629,7880
23031,ME,York,,2012,6.7,103173,110523,7350
23031,ME,York,,2013,6.4,104047,111135,7088
23031,ME,York,,2014,5.1,104495,110143,5648
23031,ME,York,,2015,3.9,104891,109193,4302
23031,ME,York,,2016,3.4,107686,111436,3750
23031,ME,York,,2017,3,110844,114265,3421
23031,ME,York,,2018,2.8,111685,114906,3221
23031,ME,York,,2019,2.5,112492,115342,2850
23031,ME,York,,2020,5,105050,110537,5487
23031,ME,York,,2021,4.5,107197,112246,5049
24000,MD,Maryland,,2007,3.7,2877994,2989317,111323
24000,MD,Maryland,,2008,4.5,2891508,3027934,136426
24000,MD,Maryland,,2009,7.6,2819397,3049869,230472
24000,MD,Maryland,,2010,7.8,2836945,3078368,241423
24000,MD,Maryland,,2011,7.3,2870857,3097300,226443
24000,MD,Maryland,,2012,6.9,2906518,3120947,214429
24000,MD,Maryland,,2013,6.5,2924626,3128908,204282
24000,MD,Maryland,,2014,5.7,2945911,3125017,179106
24000,MD,Maryland,,2015,5,2983083,3139988,156905
24000,MD,Maryland,,2016,4.3,3020827,3155918,135091
24000,MD,Maryland,,2017,4,3114580,3243896,129316
24000,MD,Maryland,,2018,3.6,3142323,3261068,118745
24000,MD,Maryland,,2019,3.4,3212155,3326497,114342
24000,MD,Maryland,,2020,6.7,3012106,3227527,215421
24000,MD,Maryland,,2021,5.8,2992228,3175550,183322
24001,MD,Allegany,,2007,5.5,33262,35190,1928
24001,MD,Allegany,,2008,6,33521,35668,2147
24001,MD,Allegany,,2009,9.2,33109,36454,3345
24001,MD,Allegany,,2010,9.5,31189,34477,3288
24001,MD,Allegany,,2011,9.1,30990,34102,3112
24001,MD,Allegany,,2012,8.8,30875,33850,2975
24001,MD,Allegany,,2013,8.4,30785,33614,2829
24001,MD,Allegany,,2014,7.5,30763,33252,2489
24001,MD,Allegany,,2015,6.8,30051,32260,2209
24001,MD,Allegany,,2016,6,30416,32365,1949
24001,MD,Allegany,,2017,5.5,30836,32643,1807
24001,MD,Allegany,,2018,5.1,30875,32539,1664
24001,MD,Allegany,,2019,5,31166,32809,1643
24001,MD,Allegany,,2020,7.8,28925,31382,2457
24001,MD,Allegany,,2021,6.4,28538,30504,1966
24003,MD,Anne Arundel,,2007,3.2,272510,281588,9078
24003,MD,Anne Arundel,,2008,4,274099,285489,11390
24003,MD,Anne Arundel,,2009,6.9,268328,288114,19786
24003,MD,Anne Arundel,,2010,7.1,266214,286473,20259
24003,MD,Anne Arundel,,2011,6.4,270942,289406,18464
24003,MD,Anne Arundel,,2012,5.9,276469,293879,17410
24003,MD,Anne Arundel,,2013,5.6,279785,296534,16749
24003,MD,Anne Arundel,,2014,5,282564,297403,14839
24003,MD,Anne Arundel,,2015,4.3,287823,300799,12976
24003,MD,Anne Arundel,,2016,3.7,292085,303234,11149
24003,MD,Anne Arundel,,2017,3.4,302969,313685,10716
24003,MD,Anne Arundel,,2018,3.1,308136,317971,9835
24003,MD,Anne Arundel,,2019,2.9,317125,326680,9555
24003,MD,Anne Arundel,,2020,5.8,299113,317403,18290
24003,MD,Anne Arundel,,2021,4.7,297777,312621,14844
24005,MD,Baltimore,,2007,3.8,413498,429814,16316
24005,MD,Baltimore,,2008,4.7,413616,433891,20275
24005,MD,Baltimore,,2009,8,400495,435306,34811
24005,MD,Baltimore,,2010,8.4,395705,432111,36406
24005,MD,Baltimore,,2011,7.8,401906,435678,33772
24005,MD,Baltimore,,2012,7.2,408491,440412,31921
24005,MD,Baltimore,,2013,6.8,411999,442142,30143
24005,MD,Baltimore,,2014,6,414836,441320,26484
24005,MD,Baltimore,,2015,5.2,421631,444707,23076
24005,MD,Baltimore,,2016,4.5,424736,444683,19947
24005,MD,Baltimore,,2017,4.2,437550,456532,18982
24005,MD,Baltimore,,2018,3.7,440676,457801,17125
24005,MD,Baltimore,,2019,3.5,450509,467047,16538
24005,MD,Baltimore,,2020,6.8,421646,452245,30599
24005,MD,Baltimore,,2021,5.7,419727,444930,25203
24009,MD,Calvert,,2007,3,46452,47899,1447
24009,MD,Calvert,,2008,3.7,47401,49210,1809
24009,MD,Calvert,,2009,6.3,46058,49164,3106
24009,MD,Calvert,,2010,7.1,44522,47901,3379
24009,MD,Calvert,,2011,6.6,44595,47730,3135
24009,MD,Calvert,,2012,6.2,44781,47732,2951
24009,MD,Calvert,,2013,5.9,44952,47757,2805
24009,MD,Calvert,,2014,5.2,44735,47212,2477
24009,MD,Calvert,,2015,4.5,44875,46993,2118
24009,MD,Calvert,,2016,3.7,46930,48750,1820
24009,MD,Calvert,,2017,3.5,48289,50035,1746
24009,MD,Calvert,,2018,3.3,48817,50475,1658
24009,MD,Calvert,,2019,3,50071,51633,1562
24009,MD,Calvert,,2020,5.2,47128,49699,2571
24009,MD,Calvert,,2021,4.6,46537,48774,2237
24011,MD,Caroline,,2007,4.5,15587,16313,726
24011,MD,Caroline,,2008,5.7,15680,16624,944
24011,MD,Caroline,,2009,9.7,14954,16559,1605
24011,MD,Caroline,,2010,9.5,15803,17459,1656
24011,MD,Caroline,,2011,8.7,15967,17493,1526
24011,MD,Caroline,,2012,7.6,16272,17617,1345
24011,MD,Caroline,,2013,6.9,16464,17678,1214
24011,MD,Caroline,,2014,6.2,16332,17406,1074
24011,MD,Caroline,,2015,5.4,16525,17460,935
24011,MD,Caroline,,2016,4.6,16830,17643,813
24011,MD,Caroline,,2017,4.1,17466,18215,749
24011,MD,Caroline,,2018,3.5,17843,18496,653
24011,MD,Caroline,,2019,3.4,18036,18678,642
24011,MD,Caroline,,2020,5.6,16714,17701,987
24011,MD,Caroline,,2021,4.7,16609,17435,826
24013,MD,Carroll,,2007,3.2,91585,94564,2979
24013,MD,Carroll,,2008,3.9,92077,95810,3733
24013,MD,Carroll,,2009,6.9,89068,95692,6624
24013,MD,Carroll,,2010,7,86236,92731,6495
24013,MD,Carroll,,2011,6.2,87107,92864,5757
24013,MD,Carroll,,2012,5.8,87885,93319,5434
24013,MD,Carroll,,2013,5.4,87988,93054,5066
24013,MD,Carroll,,2014,4.7,88185,92570,4385
24013,MD,Carroll,,2015,4.1,89165,93014,3849
24013,MD,Carroll,,2016,3.5,89753,93015,3262
24013,MD,Carroll,,2017,3.3,92385,95492,3107
24013,MD,Carroll,,2018,3,93880,96786,2906
24013,MD,Carroll,,2019,2.8,95871,98624,2753
24013,MD,Carroll,,2020,5.1,90205,95028,4823
24013,MD,Carroll,,2021,4.2,89896,93816,3920
24015,MD,Cecil,,2007,4.1,48768,50863,2095
24015,MD,Cecil,,2008,5.4,48575,51355,2780
24015,MD,Cecil,,2009,9.8,46401,51428,5027
24015,MD,Cecil,,2010,9.7,47005,52082,5077
24015,MD,Cecil,,2011,9,47454,52121,4667
24015,MD,Cecil,,2012,8.2,47630,51898,4268
24015,MD,Cecil,,2013,7.6,48243,52235,3992
24015,MD,Cecil,,2014,6.5,49013,52420,3407
24015,MD,Cecil,,2015,5.9,49457,52545,3088
24015,MD,Cecil,,2016,5,49912,52564,2652
24015,MD,Cecil,,2017,4.6,51100,53566,2466
24015,MD,Cecil,,2018,4.1,51411,53608,2197
24015,MD,Cecil,,2019,3.8,52739,54821,2082
24015,MD,Cecil,,2020,5.9,50171,53323,3152
24015,MD,Cecil,,2021,5.2,49595,52338,2743
24017,MD,Charles,,2007,3.1,73999,76376,2377
24017,MD,Charles,,2008,3.8,75276,78275,2999
24017,MD,Charles,,2009,6.3,73478,78435,4957
24017,MD,Charles,,2010,7.1,72775,78337,5562
24017,MD,Charles,,2011,6.8,73669,79025,5356
24017,MD,Charles,,2012,6.6,74359,79594,5235
24017,MD,Charles,,2013,6.4,75103,80247,5144
24017,MD,Charles,,2014,5.7,75591,80126,4535
24017,MD,Charles,,2015,4.9,76540,80471,3931
24017,MD,Charles,,2016,4.1,80379,83812,3433
24017,MD,Charles,,2017,3.8,83476,86802,3326
24017,MD,Charles,,2018,3.6,84773,87915,3142
24017,MD,Charles,,2019,3.5,87407,90564,3157
24017,MD,Charles,,2020,6.6,82357,88174,5817
24017,MD,Charles,,2021,5.7,81268,86208,4940
24019,MD,Dorchester,,2007,6.2,15758,16799,1041
24019,MD,Dorchester,,2008,7.2,15607,16809,1202
24019,MD,Dorchester,,2009,11.4,15069,17017,1948
24019,MD,Dorchester,,2010,11.6,14657,16586,1929
24019,MD,Dorchester,,2011,11.2,14679,16534,1855
24019,MD,Dorchester,,2012,10.7,14441,16171,1730
24019,MD,Dorchester,,2013,9.7,14405,15949,1544
24019,MD,Dorchester,,2014,8.3,14470,15775,1305
24019,MD,Dorchester,,2015,7,14680,15790,1110
24019,MD,Dorchester,,2016,6,14911,15863,952
24019,MD,Dorchester,,2017,5.5,14974,15844,870
24019,MD,Dorchester,,2018,4.8,15004,15762,758
24019,MD,Dorchester,,2019,4.4,15700,16429,729
24019,MD,Dorchester,,2020,6.6,15467,16553,1086
24019,MD,Dorchester,,2021,5.6,15321,16235,914
24021,MD,Frederick,,2007,3.1,120589,124435,3846
24021,MD,Frederick,,2008,3.9,119634,124426,4792
24021,MD,Frederick,,2009,6.8,116310,124770,8460
24021,MD,Frederick,,2010,7.1,119018,128100,9082
24021,MD,Frederick,,2011,6.5,120249,128615,8366
24021,MD,Frederick,,2012,6,120933,128681,7748
24021,MD,Frederick,,2013,5.7,121130,128447,7317
24021,MD,Frederick,,2014,5,121643,128021,6378
24021,MD,Frederick,,2015,4.4,122837,128473,5636
24021,MD,Frederick,,2016,3.8,123692,128533,4841
24021,MD,Frederick,,2017,3.5,127973,132632,4659
24021,MD,Frederick,,2018,3.2,131303,135693,4390
24021,MD,Frederick,,2019,3,136073,140321,4248
24021,MD,Frederick,,2020,5.8,129513,137540,8027
24021,MD,Frederick,,2021,4.8,128334,134802,6468
24023,MD,Garrett,,2007,4.7,16004,16794,790
24023,MD,Garrett,,2008,5.2,16067,16942,875
24023,MD,Garrett,,2009,8.4,15506,16922,1416
24023,MD,Garrett,,2010,9.1,14397,15839,1442
24023,MD,Garrett,,2011,8.5,14477,15821,1344
24023,MD,Garrett,,2012,8.2,14538,15833,1295
24023,MD,Garrett,,2013,8,14485,15741,1256
24023,MD,Garrett,,2014,7,14440,15534,1094
24023,MD,Garrett,,2015,6.2,14660,15627,967
24023,MD,Garrett,,2016,5.5,14635,15483,848
24023,MD,Garrett,,2017,5,14916,15699,783
24023,MD,Garrett,,2018,4.4,15081,15777,696
24023,MD,Garrett,,2019,4.2,15574,16258,684
24023,MD,Garrett,,2020,6.7,14574,15623,1049
24023,MD,Garrett,,2021,5.2,14561,15365,804
24025,MD,Harford,,2007,3.6,127782,132534,4752
24025,MD,Harford,,2008,4.4,128560,134412,5852
24025,MD,Harford,,2009,7.7,124934,135341,10407
24025,MD,Harford,,2010,8,122387,133007,10620
24025,MD,Harford,,2011,7.3,124122,133875,9753
24025,MD,Harford,,2012,6.9,126328,135618,9290
24025,MD,Harford,,2013,6.5,126915,135674,8759
24025,MD,Harford,,2014,5.6,127649,135219,7570
24025,MD,Harford,,2015,4.8,129254,135807,6553
24025,MD,Harford,,2016,4.1,130653,136199,5546
24025,MD,Harford,,2017,3.7,134920,140156,5236
24025,MD,Harford,,2018,3.3,137414,142173,4759
24025,MD,Harford,,2019,3.2,141410,146064,4654
24025,MD,Harford,,2020,5.8,133250,141380,8130
24025,MD,Harford,,2021,4.8,132625,139296,6671
24027,MD,Howard,,2007,2.7,155775,160127,4352
24027,MD,Howard,,2008,3.3,157247,162551,5304
24027,MD,Howard,,2009,5.6,155243,164453,9210
24027,MD,Howard,,2010,5.8,151535,160815,9280
24027,MD,Howard,,2011,5.2,155375,163979,8604
24027,MD,Howard,,2012,4.9,160013,168338,8325
24027,MD,Howard,,2013,4.8,163135,171324,8189
24027,MD,Howard,,2014,4.3,165997,173385,7388
24027,MD,Howard,,2015,3.7,170079,176684,6605
24027,MD,Howard,,2016,3.2,173421,179120,5699
24027,MD,Howard,,2017,3,180542,186139,5597
24027,MD,Howard,,2018,2.8,183944,189214,5270
24027,MD,Howard,,2019,2.6,189759,194875,5116
24027,MD,Howard,,2020,5.1,179273,188920,9647
24027,MD,Howard,,2021,4.3,178469,186574,8105
24029,MD,Kent,,2007,3.8,10775,11198,423
24029,MD,Kent,,2008,5.1,10561,11125,564
24029,MD,Kent,,2009,8.2,10058,10954,896
24029,MD,Kent,,2010,9.1,9688,10653,965
24029,MD,Kent,,2011,8.2,9895,10775,880
24029,MD,Kent,,2012,7.5,9833,10634,801
24029,MD,Kent,,2013,7.1,9609,10346,737
24029,MD,Kent,,2014,6.3,9688,10344,656
24029,MD,Kent,,2015,5.2,10015,10568,553
24029,MD,Kent,,2016,4.7,9750,10230,480
24029,MD,Kent,,2017,4.3,9922,10364,442
24029,MD,Kent,,2018,4,10057,10477,420
24029,MD,Kent,,2019,3.8,10049,10448,399
24029,MD,Kent,,2020,6.6,9186,9836,650
24029,MD,Kent,,2021,5.5,9085,9609,524
24031,MD,Montgomery,,2007,2.8,498244,512726,14482
24031,MD,Montgomery,,2008,3.4,502576,520067,17491
24031,MD,Montgomery,,2009,5.8,494416,524629,30213
24031,MD,Montgomery,,2010,5.8,502458,533156,30698
24031,MD,Montgomery,,2011,5.3,508359,536947,28588
24031,MD,Montgomery,,2012,5.1,513193,540810,27617
24031,MD,Montgomery,,2013,4.9,516469,543134,26665
24031,MD,Montgomery,,2014,4.3,520698,544271,23573
24031,MD,Montgomery,,2015,3.8,526310,547229,20919
24031,MD,Montgomery,,2016,3.3,526510,544649,18139
24031,MD,Montgomery,,2017,3.2,543489,561370,17881
24031,MD,Montgomery,,2018,2.9,547810,564403,16593
24031,MD,Montgomery,,2019,2.8,559116,575351,16235
24031,MD,Montgomery,,2020,6.2,521828,556465,34637
24031,MD,Montgomery,,2021,5.5,517358,547389,30031
24033,MD,Prince George's,,2007,3.9,431117,448420,17303
24033,MD,Prince George's,,2008,4.6,433384,454281,20897
24033,MD,Prince George's,,2009,7.5,425672,460136,34464
24033,MD,Prince George's,,2010,7.7,443412,480390,36978
24033,MD,Prince George's,,2011,7.5,446690,483094,36404
24033,MD,Prince George's,,2012,7.2,450330,485215,34885
24033,MD,Prince George's,,2013,6.9,452620,485941,33321
24033,MD,Prince George's,,2014,6,457128,486156,29028
24033,MD,Prince George's,,2015,5.1,461301,486318,25017
24033,MD,Prince George's,,2016,4.3,478398,499860,21462
24033,MD,Prince George's,,2017,4,493342,513992,20650
24033,MD,Prince George's,,2018,3.8,493920,513343,19423
24033,MD,Prince George's,,2019,3.6,503782,522677,18895
24033,MD,Prince George's,,2020,8,471489,512497,41008
24033,MD,Prince George's,,2021,7.5,465458,502972,37514
24035,MD,Queen Anne's,,2007,3.3,25324,26198,874
24035,MD,Queen Anne's,,2008,4.3,25724,26872,1148
24035,MD,Queen Anne's,,2009,7.2,25231,27188,1957
24035,MD,Queen Anne's,,2010,7.5,24220,26181,1961
24035,MD,Queen Anne's,,2011,6.9,24790,26616,1826
24035,MD,Queen Anne's,,2012,6.2,25078,26746,1668
24035,MD,Queen Anne's,,2013,5.8,24932,26465,1533
24035,MD,Queen Anne's,,2014,5,25040,26364,1324
24035,MD,Queen Anne's,,2015,4.4,25434,26612,1178
24035,MD,Queen Anne's,,2016,3.8,25564,26567,1003
24035,MD,Queen Anne's,,2017,3.5,26759,27734,975
24035,MD,Queen Anne's,,2018,3.1,27369,28244,875
24035,MD,Queen Anne's,,2019,3,27923,28777,854
24035,MD,Queen Anne's,,2020,5.4,26578,28107,1529
24035,MD,Queen Anne's,,2021,4.4,26534,27745,1211
24037,MD,St. Mary's,,2007,3.2,49495,51118,1623
24037,MD,St. Mary's,,2008,3.8,50511,52528,2017
24037,MD,St. Mary's,,2009,6,50720,53978,3258
24037,MD,St. Mary's,,2010,6.7,50089,53693,3604
24037,MD,St. Mary's,,2011,6.4,50823,54283,3460
24037,MD,St. Mary's,,2012,6.1,51177,54521,3344
24037,MD,St. Mary's,,2013,5.9,51049,54258,3209
24037,MD,St. Mary's,,2014,5.3,51200,54062,2862
24037,MD,St. Mary's,,2015,4.8,51964,54562,2598
24037,MD,St. Mary's,,2016,4.1,52486,54730,2244
24037,MD,St. Mary's,,2017,3.8,53692,55828,2136
24037,MD,St. Mary's,,2018,3.5,54592,56588,1996
24037,MD,St. Mary's,,2019,3.2,56404,58278,1874
24037,MD,St. Mary's,,2020,4.8,55673,58492,2819
24037,MD,St. Mary's,,2021,4.5,54995,57574,2579
24039,MD,Somerset,,2007,5.7,10612,11257,645
24039,MD,Somerset,,2008,6.8,10607,11376,769
24039,MD,Somerset,,2009,10.2,10050,11189,1139
24039,MD,Somerset,,2010,12.1,8744,9952,1208
24039,MD,Somerset,,2011,11.8,8716,9881,1165
24039,MD,Somerset,,2012,11.1,8655,9737,1082
24039,MD,Somerset,,2013,10.6,8558,9573,1015
24039,MD,Somerset,,2014,9.3,8407,9271,864
24039,MD,Somerset,,2015,8.1,8470,9215,745
24039,MD,Somerset,,2016,7,8573,9219,646
24039,MD,Somerset,,2017,6.6,8778,9399,621
24039,MD,Somerset,,2018,6.5,8729,9337,608
24039,MD,Somerset,,2019,6,8738,9292,554
24039,MD,Somerset,,2020,8.4,7989,8726,737
24039,MD,Somerset,,2021,7.6,8154,8824,670
24041,MD,Talbot,,2007,3.6,18299,18985,686
24041,MD,Talbot,,2008,4.4,18517,19378,861
24041,MD,Talbot,,2009,7.8,17347,18817,1470
24041,MD,Talbot,,2010,8.2,17849,19436,1587
24041,MD,Talbot,,2011,7.5,17994,19457,1463
24041,MD,Talbot,,2012,7.1,18042,19420,1378
24041,MD,Talbot,,2013,6.4,17941,19158,1217
24041,MD,Talbot,,2014,5.4,18089,19118,1029
24041,MD,Talbot,,2015,4.8,18331,19259,928
24041,MD,Talbot,,2016,4,18727,19517,790
24041,MD,Talbot,,2017,3.8,19208,19968,760
24041,MD,Talbot,,2018,3.5,19292,19982,690
24041,MD,Talbot,,2019,3.3,18959,19608,649
24041,MD,Talbot,,2020,6.1,16896,17987,1091
24041,MD,Talbot,,2021,5.3,16718,17647,929
24043,MD,Washington,,2007,4.7,65332,68533,3201
24043,MD,Washington,,2008,5.9,64286,68316,4030
24043,MD,Washington,,2009,10.4,61653,68833,7180
24043,MD,Washington,,2010,9.8,68493,75930,7437
24043,MD,Washington,,2011,8.8,69745,76499,6754
24043,MD,Washington,,2012,7.7,71224,77183,5959
24043,MD,Washington,,2013,7.3,71601,77209,5608
24043,MD,Washington,,2014,6.4,71498,76367,4869
24043,MD,Washington,,2015,5.5,72415,76634,4219
24043,MD,Washington,,2016,4.9,71575,75300,3725
24043,MD,Washington,,2017,4.5,72847,76255,3408
24043,MD,Washington,,2018,4.1,72678,75763,3085
24043,MD,Washington,,2019,3.7,73303,76153,2850
24043,MD,Washington,,2020,6.8,68031,73020,4989
24043,MD,Washington,,2021,5.4,68574,72458,3884
24045,MD,Wicomico,,2007,4.2,50299,52493,2194
24045,MD,Wicomico,,2008,5.5,50317,53240,2923
24045,MD,Wicomico,,2009,9,48053,52801,4748
24045,MD,Wicomico,,2010,9.9,45440,50451,5011
24045,MD,Wicomico,,2011,9.9,45559,50558,4999
24045,MD,Wicomico,,2012,9.3,45799,50480,4681
24045,MD,Wicomico,,2013,8.6,45800,50121,4321
24045,MD,Wicomico,,2014,7.6,46230,50050,3820
24045,MD,Wicomico,,2015,6.7,46839,50182,3343
24045,MD,Wicomico,,2016,6,47331,50359,3028
24045,MD,Wicomico,,2017,5.5,48660,51490,2830
24045,MD,Wicomico,,2018,4.9,49045,51587,2542
24045,MD,Wicomico,,2019,4.5,49896,52253,2357
24045,MD,Wicomico,,2020,7.6,46087,49852,3765
24045,MD,Wicomico,,2021,6.1,46932,49998,3066
24047,MD,Worcester,,2007,6.3,25975,27712,1737
24047,MD,Worcester,,2008,7.7,25738,27888,2150
24047,MD,Worcester,,2009,11.7,24778,28071,3293
24047,MD,Worcester,,2010,13.7,22894,26529,3635
24047,MD,Worcester,,2011,13.9,22718,26378,3660
24047,MD,Worcester,,2012,12.8,22776,26108,3332
24047,MD,Worcester,,2013,12.5,22663,25888,3225
24047,MD,Worcester,,2014,11.4,22722,25640,2918
24047,MD,Worcester,,2015,10.4,22784,25423,2639
24047,MD,Worcester,,2016,9,22900,25158,2258
24047,MD,Worcester,,2017,8.2,23592,25709,2117
24047,MD,Worcester,,2018,7.5,23811,25755,1944
24047,MD,Worcester,,2019,7.2,24307,26179,1872
24047,MD,Worcester,,2020,11.6,22436,25367,2931
24047,MD,Worcester,,2021,8.2,22861,24913,2052
24510,MD,Baltimore,,2007,5.9,260952,277380,16428
24510,MD,Baltimore,,2008,6.9,261928,281402,19474
24510,MD,Baltimore,,2009,11,252468,283620,31152
24510,MD,Baltimore,,2010,11.4,262216,296080,33864
24510,MD,Baltimore,,2011,10.7,264036,295569,31533
24510,MD,Baltimore,,2012,10,267396,297153,29757
24510,MD,Baltimore,,2013,9.6,267999,296422,28423
24510,MD,Baltimore,,2014,8.4,268993,293732,24739
24510,MD,Baltimore,,2015,7.4,271643,293358,21715
24510,MD,Baltimore,,2016,6.4,270665,289071,18406
24510,MD,Baltimore,,2017,5.9,276896,294349,17453
24510,MD,Baltimore,,2018,5.3,275863,291380,15517
24510,MD,Baltimore,,2019,4.9,278237,292677,14440
24510,MD,Baltimore,,2020,8.7,257578,282207,24629
24510,MD,Baltimore,,2021,7.6,256302,277525,21223
25000,MA,Massachusetts,,2007,4.5,3277912,3433239,155327
25000,MA,Massachusetts,,2008,5.3,3282299,3465906,183607
25000,MA,Massachusetts,,2009,8.1,3189506,3470431,280925
25000,MA,Massachusetts,,2010,8.1,3198617,3479304,280687
25000,MA,Massachusetts,,2011,7.2,3232458,3484135,251677
25000,MA,Massachusetts,,2012,6.7,3271256,3506457,235201
25000,MA,Massachusetts,,2013,6.6,3283144,3516689,233545
25000,MA,Massachusetts,,2014,5.7,3364853,3569557,204704
25000,MA,Massachusetts,,2015,4.8,3417296,3589409,172113
25000,MA,Massachusetts,,2016,4,3472327,3617498,145171
25000,MA,Massachusetts,,2017,3.8,3582389,3724520,142131
25000,MA,Massachusetts,,2018,3.4,3678445,3809873,131428
25000,MA,Massachusetts,,2019,3.1,3714547,3831947,117400
25000,MA,Massachusetts,,2020,9.4,3390249,3741684,351435
25000,MA,Massachusetts,,2021,5.7,3535478,3750870,215392
25001,MA,Barnstable,,2007,4.8,115716,121566,5850
25001,MA,Barnstable,,2008,5.8,115089,122145,7056
25001,MA,Barnstable,,2009,8.4,111861,122070,10209
25001,MA,Barnstable,,2010,9.6,100362,111065,10703
25001,MA,Barnstable,,2011,9,100197,110145,9948
25001,MA,Barnstable,,2012,8.5,99648,108908,9260
25001,MA,Barnstable,,2013,8.3,99545,108607,9062
25001,MA,Barnstable,,2014,7.2,104101,112130,8029
25001,MA,Barnstable,,2015,6.1,104824,111635,6811
25001,MA,Barnstable,,2016,5.1,106010,111677,5667
25001,MA,Barnstable,,2017,4.8,108844,114296,5452
25001,MA,Barnstable,,2018,4.4,111087,116246,5159
25001,MA,Barnstable,,2019,4.1,110921,115632,4711
25001,MA,Barnstable,,2020,10.8,98545,110468,11923
25001,MA,Barnstable,,2021,6.7,104925,112478,7553
25003,MA,Berkshire,,2007,4.4,69747,72974,3227
25003,MA,Berkshire,,2008,5.1,69383,73119,3736
25003,MA,Berkshire,,2009,7.7,67467,73092,5625
25003,MA,Berkshire,,2010,8.5,61862,67602,5740
25003,MA,Berkshire,,2011,7.8,61735,66986,5251
25003,MA,Berkshire,,2012,7.4,61587,66497,4910
25003,MA,Berkshire,,2013,7.3,60802,65621,4819
25003,MA,Berkshire,,2014,6.6,61314,65621,4307
25003,MA,Berkshire,,2015,5.4,61612,65127,3515
25003,MA,Berkshire,,2016,4.7,61392,64396,3004
25003,MA,Berkshire,,2017,4.5,62468,65428,2960
25003,MA,Berkshire,,2018,4.2,62827,65595,2768
25003,MA,Berkshire,,2019,3.7,62434,64847,2413
25003,MA,Berkshire,,2020,9.8,56266,62370,6104
25003,MA,Berkshire,,2021,6.7,58491,62666,4175
25005,MA,Bristol,,2007,5.8,273751,290705,16954
25005,MA,Bristol,,2008,7,271170,291587,20417
25005,MA,Bristol,,2009,10.6,261506,292650,31144
25005,MA,Bristol,,2010,10.3,257175,286619,29444
25005,MA,Bristol,,2011,9.4,259243,286139,26896
25005,MA,Bristol,,2012,8.8,261994,287144,25150
25005,MA,Bristol,,2013,8.6,262075,286797,24722
25005,MA,Bristol,,2014,7.4,267763,289031,21268
25005,MA,Bristol,,2015,6.1,272081,289804,17723
25005,MA,Bristol,,2016,5.1,275900,290690,14790
25005,MA,Bristol,,2017,4.9,284403,298931,14528
25005,MA,Bristol,,2018,4.4,291498,304879,13381
25005,MA,Bristol,,2019,3.9,293056,305047,11991
25005,MA,Bristol,,2020,10.8,267445,299978,32533
25005,MA,Bristol,,2021,6.5,279940,299547,19607
25007,MA,Dukes,,2007,3.5,10758,11153,395
25007,MA,Dukes,,2008,4.1,10773,11235,462
25007,MA,Dukes,,2009,6.4,10610,11332,722
25007,MA,Dukes,,2010,9.5,8239,9102,863
25007,MA,Dukes,,2011,9.3,8341,9196,855
25007,MA,Dukes,,2012,8.9,8552,9386,834
25007,MA,Dukes,,2013,9,8564,9413,849
25007,MA,Dukes,,2014,7.9,8730,9480,750
25007,MA,Dukes,,2015,6.5,8845,9463,618
25007,MA,Dukes,,2016,5.3,8857,9357,500
25007,MA,Dukes,,2017,5,9162,9643,481
25007,MA,Dukes,,2018,4.7,9331,9795,464
25007,MA,Dukes,,2019,4.3,9286,9704,418
25007,MA,Dukes,,2020,9.9,8598,9542,944
25007,MA,Dukes,,2021,6.5,9010,9640,630
25009,MA,Essex,,2007,4.8,356652,374594,17942
25009,MA,Essex,,2008,5.6,357273,378507,21234
25009,MA,Essex,,2009,8.7,348127,381092,32965
25009,MA,Essex,,2010,8.4,358956,392060,33104
25009,MA,Essex,,2011,7.6,364243,394216,29973
25009,MA,Essex,,2012,7.1,369621,397907,28286
25009,MA,Essex,,2013,7,371871,399717,27846
25009,MA,Essex,,2014,6,380981,405217,24236
25009,MA,Essex,,2015,5,387425,407766,20341
25009,MA,Essex,,2016,4.1,393617,410554,16937
25009,MA,Essex,,2017,3.9,405437,421835,16398
25009,MA,Essex,,2018,3.5,415008,430237,15229
25009,MA,Essex,,2019,3.1,418029,431580,13551
25009,MA,Essex,,2020,10.4,380186,424185,43999
25009,MA,Essex,,2021,6.4,396759,423777,27018
25011,MA,Franklin,,2007,4.2,37547,39189,1642
25011,MA,Franklin,,2008,5,37154,39094,1940
25011,MA,Franklin,,2009,7.6,35965,38914,2949
25011,MA,Franklin,,2010,7.4,37037,39992,2955
25011,MA,Franklin,,2011,6.5,37118,39707,2589
25011,MA,Franklin,,2012,6.1,37406,39837,2431
25011,MA,Franklin,,2013,6.1,36955,39349,2394
25011,MA,Franklin,,2014,5.3,37440,39533,2093
25011,MA,Franklin,,2015,4.4,37717,39445,1728
25011,MA,Franklin,,2016,3.6,38108,39542,1434
25011,MA,Franklin,,2017,3.4,39288,40680,1392
25011,MA,Franklin,,2018,3.1,40155,41445,1290
25011,MA,Franklin,,2019,2.8,40184,41357,1173
25011,MA,Franklin,,2020,7.9,37042,40222,3180
25011,MA,Franklin,,2021,5,38757,40785,2028
25013,MA,Hampden,,2007,5.6,211561,224123,12562
25013,MA,Hampden,,2008,6.4,211185,225643,14458
25013,MA,Hampden,,2009,9.3,205804,226897,21093
25013,MA,Hampden,,2010,10,198838,220874,22036
25013,MA,Hampden,,2011,9.3,199625,220059,20434
25013,MA,Hampden,,2012,8.6,201584,220550,18966
25013,MA,Hampden,,2013,8.6,201484,220365,18881
25013,MA,Hampden,,2014,7.6,205495,222339,16844
25013,MA,Hampden,,2015,6.4,208496,222712,14216
25013,MA,Hampden,,2016,5.4,210141,222228,12087
25013,MA,Hampden,,2017,5.2,215770,227565,11795
25013,MA,Hampden,,2018,4.8,220751,231786,11035
25013,MA,Hampden,,2019,4.3,220973,230948,9975
25013,MA,Hampden,,2020,11,201171,225995,24824
25013,MA,Hampden,,2021,7.6,209942,227099,17157
25015,MA,Hampshire,,2007,3.8,85133,88498,3365
25015,MA,Hampshire,,2008,4.4,84929,88793,3864
25015,MA,Hampshire,,2009,6.4,81809,87434,5625
25015,MA,Hampshire,,2010,6.8,79777,85594,5817
25015,MA,Hampshire,,2011,6.1,80101,85347,5246
25015,MA,Hampshire,,2012,5.8,80787,85787,5000
25015,MA,Hampshire,,2013,6,80401,85519,5118
25015,MA,Hampshire,,2014,5.3,82492,87070,4578
25015,MA,Hampshire,,2015,4.5,83446,87376,3930
25015,MA,Hampshire,,2016,3.8,84767,88079,3312
25015,MA,Hampshire,,2017,3.5,86809,89978,3169
25015,MA,Hampshire,,2018,3.1,88479,91330,2851
25015,MA,Hampshire,,2019,2.8,88994,91601,2607
25015,MA,Hampshire,,2020,7.6,81642,88360,6718
25015,MA,Hampshire,,2021,4.7,85206,89375,4169
25017,MA,Middlesex,,2007,3.7,788631,818839,30208
25017,MA,Middlesex,,2008,4.3,792201,828076,35875
25017,MA,Middlesex,,2009,6.9,769965,826729,56764
25017,MA,Middlesex,,2010,6.7,770355,825858,55503
25017,MA,Middlesex,,2011,5.9,778977,827631,48654
25017,MA,Middlesex,,2012,5.4,791299,836827,45528
25017,MA,Middlesex,,2013,5.4,795217,840728,45511
25017,MA,Middlesex,,2014,4.7,815591,855475,39884
25017,MA,Middlesex,,2015,3.9,829704,863474,33770
25017,MA,Middlesex,,2016,3.3,844884,873570,28686
25017,MA,Middlesex,,2017,3.1,872853,901081,28228
25017,MA,Middlesex,,2018,2.8,898422,924241,25819
25017,MA,Middlesex,,2019,2.4,909939,932660,22721
25017,MA,Middlesex,,2020,7.7,831412,900978,69566
25017,MA,Middlesex,,2021,4.6,864759,906656,41897
25019,MA,Nantucket,,2007,2.3,8348,8548,200
25019,MA,Nantucket,,2008,3.3,8166,8441,275
25019,MA,Nantucket,,2009,6.7,7282,7808,526
25019,MA,Nantucket,,2010,9.4,5590,6167,577
25019,MA,Nantucket,,2011,8.6,5701,6236,535
25019,MA,Nantucket,,2012,7.8,5920,6424,504
25019,MA,Nantucket,,2013,7.2,6124,6601,477
25019,MA,Nantucket,,2014,6.2,6537,6968,431
25019,MA,Nantucket,,2015,5.4,6597,6972,375
25019,MA,Nantucket,,2016,4.6,6727,7050,323
25019,MA,Nantucket,,2017,4.5,6939,7268,329
25019,MA,Nantucket,,2018,4.5,7255,7600,345
25019,MA,Nantucket,,2019,4.4,7383,7722,339
25019,MA,Nantucket,,2020,11.1,6775,7622,847
25019,MA,Nantucket,,2021,7.7,7138,7733,595
25021,MA,Norfolk,,2007,3.9,341383,355323,13940
25021,MA,Norfolk,,2008,4.7,342321,359125,16804
25021,MA,Norfolk,,2009,7.3,331923,358033,26110
25021,MA,Norfolk,,2010,7.2,332356,358241,25885
25021,MA,Norfolk,,2011,6.3,336362,358845,22483
25021,MA,Norfolk,,2012,5.7,340369,361023,20654
25021,MA,Norfolk,,2013,5.7,342068,362910,20842
25021,MA,Norfolk,,2014,5,349123,367467,18344
25021,MA,Norfolk,,2015,4.2,353831,369187,15356
25021,MA,Norfolk,,2016,3.5,359531,372572,13041
25021,MA,Norfolk,,2017,3.4,370046,383071,13025
25021,MA,Norfolk,,2018,3.1,380800,392853,12053
25021,MA,Norfolk,,2019,2.7,388029,398627,10598
25021,MA,Norfolk,,2020,8.8,355614,390023,34409
25021,MA,Norfolk,,2021,5.1,370471,390570,20099
25023,MA,Plymouth,,2007,4.8,247929,260470,12541
25023,MA,Plymouth,,2008,5.6,247725,262430,14705
25023,MA,Plymouth,,2009,8.5,241485,263810,22325
25023,MA,Plymouth,,2010,8.7,239166,261927,22761
25023,MA,Plymouth,,2011,7.7,241599,261870,20271
25023,MA,Plymouth,,2012,7,243400,261836,18436
25023,MA,Plymouth,,2013,6.9,244681,262840,18159
25023,MA,Plymouth,,2014,6,250815,266834,16019
25023,MA,Plymouth,,2015,5,254463,267990,13527
25023,MA,Plymouth,,2016,4.2,259120,270543,11423
25023,MA,Plymouth,,2017,4,266641,277824,11183
25023,MA,Plymouth,,2018,3.6,274377,284693,10316
25023,MA,Plymouth,,2019,3.2,279665,288870,9205
25023,MA,Plymouth,,2020,10,255314,283634,28320
25023,MA,Plymouth,,2021,6.1,266284,283684,17400
25025,MA,Suffolk,,2007,4.5,348575,365057,16482
25025,MA,Suffolk,,2008,5.2,353875,373295,19420
25025,MA,Suffolk,,2009,7.7,345635,374525,28890
25025,MA,Suffolk,,2010,7.4,364690,393897,29207
25025,MA,Suffolk,,2011,6.6,371705,398015,26310
25025,MA,Suffolk,,2012,6.2,378940,403827,24887
25025,MA,Suffolk,,2013,6.1,382380,407326,24946
25025,MA,Suffolk,,2014,5.3,393729,415644,21915
25025,MA,Suffolk,,2015,4.4,402435,420939,18504
25025,MA,Suffolk,,2016,3.7,411526,427208,15682
25025,MA,Suffolk,,2017,3.5,429084,444526,15442
25025,MA,Suffolk,,2018,3.1,443490,457696,14206
25025,MA,Suffolk,,2019,2.8,449409,462128,12719
25025,MA,Suffolk,,2020,10.3,409219,456198,46979
25025,MA,Suffolk,,2021,6,426176,453174,26998
25027,MA,Worcester,,2007,5,382180,402189,20009
25027,MA,Worcester,,2008,5.8,381054,404398,23344
25027,MA,Worcester,,2009,8.9,370065,406052,35987
25027,MA,Worcester,,2010,8.6,384217,420308,36091
25027,MA,Worcester,,2011,7.7,387512,419746,32234
25027,MA,Worcester,,2012,7.2,390151,420507,30356
25027,MA,Worcester,,2013,7.1,390976,420896,29920
25027,MA,Worcester,,2014,6.1,400741,426751,26010
25027,MA,Worcester,,2015,5.1,405817,427517,21700
25027,MA,Worcester,,2016,4.3,411749,430035,18286
25027,MA,Worcester,,2017,4,424645,442393,17748
25027,MA,Worcester,,2018,3.7,434968,451479,16511
25027,MA,Worcester,,2019,3.3,436248,451227,14979
25027,MA,Worcester,,2020,9.3,401024,442111,41087
25027,MA,Worcester,,2021,5.9,417617,443682,26065
26000,MI,Michigan,,2007,7.1,4640173,4994841,354668
26000,MI,Michigan,,2008,8.2,4513249,4915781,402532
26000,MI,Michigan,,2009,13.1,4221462,4860036,638574
26000,MI,Michigan,,2010,12.2,4173946,4754799,580853
26000,MI,Michigan,,2011,10,4201785,4668979,467194
26000,MI,Michigan,,2012,9,4261963,4685462,423499
26000,MI,Michigan,,2013,8.7,4323410,4736919,413509
26000,MI,Michigan,,2014,7.2,4416017,4759720,343703
26000,MI,Michigan,,2015,5.4,4501816,4760207,258391
26000,MI,Michigan,,2016,5,4606948,4848638,241690
26000,MI,Michigan,,2017,4.6,4685853,4911247,225394
26000,MI,Michigan,,2018,4.2,4734158,4940313,206155
26000,MI,Michigan,,2019,4.1,4766050,4969294,203244
26000,MI,Michigan,,2020,10,4361873,4846013,484140
26000,MI,Michigan,,2021,5.9,4495651,4776110,280459
26001,MI,Alcona,,2007,10.3,3853,4297,444
26001,MI,Alcona,,2008,11.5,3792,4287,495
26001,MI,Alcona,,2009,18.4,3342,4094,752
26001,MI,Alcona,,2010,17.3,3171,3836,665
26001,MI,Alcona,,2011,13.8,3269,3791,522
26001,MI,Alcona,,2012,12.5,3257,3724,467
26001,MI,Alcona,,2013,13.2,3304,3808,504
26001,MI,Alcona,,2014,10.6,3428,3836,408
26001,MI,Alcona,,2015,8.1,3515,3826,311
26001,MI,Alcona,,2016,7.7,3543,3839,296
26001,MI,Alcona,,2017,7.1,3569,3840,271
26001,MI,Alcona,,2018,6.6,3564,3816,252
26001,MI,Alcona,,2019,6.4,3643,3893,250
26001,MI,Alcona,,2020,10.4,3440,3841,401
26001,MI,Alcona,,2021,7.1,3462,3725,263
26003,MI,Alger,,2007,8.5,4017,4390,373
26003,MI,Alger,,2008,9.5,3872,4278,406
26003,MI,Alger,,2009,13.3,3672,4237,565
26003,MI,Alger,,2010,13.7,3068,3556,488
26003,MI,Alger,,2011,12.2,3042,3463,421
26003,MI,Alger,,2012,11.8,3040,3446,406
26003,MI,Alger,,2013,11.6,2993,3386,393
26003,MI,Alger,,2014,10.4,2977,3324,347
26003,MI,Alger,,2015,8.6,2966,3246,280
26003,MI,Alger,,2016,8.3,3002,3274,272
26003,MI,Alger,,2017,8.2,3021,3291,270
26003,MI,Alger,,2018,8,2959,3215,256
26003,MI,Alger,,2019,7.9,2937,3190,253
26003,MI,Alger,,2020,11.3,2768,3120,352
26003,MI,Alger,,2021,8,2841,3089,248
26005,MI,Allegan,,2007,6.4,52364,55953,3589
26005,MI,Allegan,,2008,7.4,51033,55140,4107
26005,MI,Allegan,,2009,12.6,47245,54033,6788
26005,MI,Allegan,,2010,11,50270,56490,6220
26005,MI,Allegan,,2011,8.4,51967,56723,4756
26005,MI,Allegan,,2012,7.3,52752,56883,4131
26005,MI,Allegan,,2013,6.6,54330,58171,3841
26005,MI,Allegan,,2014,5.4,56610,59859,3249
26005,MI,Allegan,,2015,4.2,58207,60755,2548
26005,MI,Allegan,,2016,3.9,59033,61447,2414
26005,MI,Allegan,,2017,3.7,58962,61238,2276
26005,MI,Allegan,,2018,3.3,59982,62032,2050
26005,MI,Allegan,,2019,3.2,60494,62488,1994
26005,MI,Allegan,,2020,7.6,57267,61980,4713
26005,MI,Allegan,,2021,4.7,57735,60557,2822
26007,MI,Alpena,,2007,8.5,13628,14888,1260
26007,MI,Alpena,,2008,8.9,13516,14841,1325
26007,MI,Alpena,,2009,13.5,12831,14833,2002
26007,MI,Alpena,,2010,12.8,12328,14130,1802
26007,MI,Alpena,,2011,10.4,12228,13648,1420
26007,MI,Alpena,,2012,9.6,12146,13436,1290
26007,MI,Alpena,,2013,9.6,12134,13418,1284
26007,MI,Alpena,,2014,8,12483,13571,1088
26007,MI,Alpena,,2015,6.3,12820,13686,866
26007,MI,Alpena,,2016,6,12867,13689,822
26007,MI,Alpena,,2017,5.6,12846,13615,769
26007,MI,Alpena,,2018,5.2,12670,13359,689
26007,MI,Alpena,,2019,4.8,12568,13206,638
26007,MI,Alpena,,2020,8.1,12143,13211,1068
26007,MI,Alpena,,2021,5.5,12458,13183,725
26009,MI,Antrim,,2007,8.1,10888,11850,962
26009,MI,Antrim,,2008,9.5,10536,11636,1100
26009,MI,Antrim,,2009,14.8,9737,11434,1697
26009,MI,Antrim,,2010,15.5,8826,10448,1622
26009,MI,Antrim,,2011,12.8,8838,10130,1292
26009,MI,Antrim,,2012,11.4,8894,10038,1144
26009,MI,Antrim,,2013,11.3,8879,10013,1134
26009,MI,Antrim,,2014,9.5,9129,10090,961
26009,MI,Antrim,,2015,7.6,9282,10041,759
26009,MI,Antrim,,2016,7.1,9378,10098,720
26009,MI,Antrim,,2017,6.5,9421,10074,653
26009,MI,Antrim,,2018,5.7,9500,10074,574
26009,MI,Antrim,,2019,5.2,9773,10314,541
26009,MI,Antrim,,2020,10.2,9081,10112,1031
26009,MI,Antrim,,2021,7,9172,9865,693
26011,MI,Arenac,,2007,9.9,7085,7862,777
26011,MI,Arenac,,2008,10.4,7138,7967,829
26011,MI,Arenac,,2009,16.3,6580,7858,1278
26011,MI,Arenac,,2010,16,5778,6881,1103
26011,MI,Arenac,,2011,13.5,5761,6662,901
26011,MI,Arenac,,2012,12.6,5723,6551,828
26011,MI,Arenac,,2013,12.9,5669,6507,838
26011,MI,Arenac,,2014,11.1,5699,6410,711
26011,MI,Arenac,,2015,9.1,5691,6259,568
26011,MI,Arenac,,2016,8.4,5627,6140,513
26011,MI,Arenac,,2017,8,5543,6023,480
26011,MI,Arenac,,2018,7.1,5550,5976,426
26011,MI,Arenac,,2019,6.7,5652,6057,405
26011,MI,Arenac,,2020,11.8,5243,5943,700
26011,MI,Arenac,,2021,8.3,5234,5709,475
26013,MI,Baraga,,2007,12.9,3711,4260,549
26013,MI,Baraga,,2008,13.6,3683,4264,581
26013,MI,Baraga,,2009,23.7,3398,4454,1056
26013,MI,Baraga,,2010,18.8,3132,3858,726
26013,MI,Baraga,,2011,15.8,3067,3643,576
26013,MI,Baraga,,2012,13.9,3052,3545,493
26013,MI,Baraga,,2013,14.3,3043,3552,509
26013,MI,Baraga,,2014,11.3,3081,3472,391
26013,MI,Baraga,,2015,9.2,3008,3314,306
26013,MI,Baraga,,2016,8.3,2962,3230,268
26013,MI,Baraga,,2017,7.6,2936,3179,243
26013,MI,Baraga,,2018,6.2,2967,3162,195
26013,MI,Baraga,,2019,6.4,3005,3212,207
26013,MI,Baraga,,2020,12.3,2759,3147,388
26013,MI,Baraga,,2021,7.9,2769,3006,237
26015,MI,Barry,,2007,5.5,28683,30355,1672
26015,MI,Barry,,2008,6.5,27967,29908,1941
26015,MI,Barry,,2009,10.1,25845,28750,2905
26015,MI,Barry,,2010,10.1,26171,29098,2927
26015,MI,Barry,,2011,7.8,26577,28836,2259
26015,MI,Barry,,2012,6.8,27107,29072,1965
26015,MI,Barry,,2013,6.3,27508,29364,1856
26015,MI,Barry,,2014,5.4,28388,30015,1627
26015,MI,Barry,,2015,4.3,29042,30360,1318
26015,MI,Barry,,2016,4,29584,30829,1245
26015,MI,Barry,,2017,3.9,30077,31291,1214
26015,MI,Barry,,2018,3.4,30599,31690,1091
26015,MI,Barry,,2019,3.3,30822,31875,1053
26015,MI,Barry,,2020,7.7,28982,31394,2412
26015,MI,Barry,,2021,4.6,29443,30851,1408
26017,MI,Bay,,2007,6.9,51188,54974,3786
26017,MI,Bay,,2008,7.6,50401,54566,4165
26017,MI,Bay,,2009,11.6,48189,54536,6347
26017,MI,Bay,,2010,11.2,48078,54152,6074
26017,MI,Bay,,2011,9.4,48174,53200,5026
26017,MI,Bay,,2012,8.6,48478,53057,4579
26017,MI,Bay,,2013,8.6,48622,53217,4595
26017,MI,Bay,,2014,7.2,49393,53232,3839
26017,MI,Bay,,2015,5.8,49397,52464,3067
26017,MI,Bay,,2016,5.5,49168,52039,2871
26017,MI,Bay,,2017,5.5,48167,50944,2777
26017,MI,Bay,,2018,4.8,47988,50422,2434
26017,MI,Bay,,2019,4.7,47819,50195,2376
26017,MI,Bay,,2020,9.6,44622,49355,4733
26017,MI,Bay,,2021,6.1,45003,47921,2918
26019,MI,Benzie,,2007,8.1,8261,8988,727
26019,MI,Benzie,,2008,9,8034,8833,799
26019,MI,Benzie,,2009,13.4,7502,8666,1164
26019,MI,Benzie,,2010,13.1,7712,8870,1158
26019,MI,Benzie,,2011,11.6,7664,8667,1003
26019,MI,Benzie,,2012,10.3,7670,8555,885
26019,MI,Benzie,,2013,10.2,7745,8625,880
26019,MI,Benzie,,2014,8.7,7986,8745,759
26019,MI,Benzie,,2015,7.1,8103,8719,616
26019,MI,Benzie,,2016,6.6,8276,8864,588
26019,MI,Benzie,,2017,6.4,8276,8842,566
26019,MI,Benzie,,2018,5.5,8307,8795,488
26019,MI,Benzie,,2019,5.2,8381,8839,458
26019,MI,Benzie,,2020,9.8,7812,8660,848
26019,MI,Benzie,,2021,6,7949,8453,504
26021,MI,Berrien,,2007,7,74044,79601,5557
26021,MI,Berrien,,2008,7.9,73253,79503,6250
26021,MI,Berrien,,2009,12.4,67723,77325,9602
26021,MI,Berrien,,2010,11.7,67041,75898,8857
26021,MI,Berrien,,2011,9.8,67126,74383,7257
26021,MI,Berrien,,2012,8.9,67007,73574,6567
26021,MI,Berrien,,2013,8.6,66456,72701,6245
26021,MI,Berrien,,2014,6.8,68569,73550,4981
26021,MI,Berrien,,2015,5.3,69862,73748,3886
26021,MI,Berrien,,2016,5,70297,74004,3707
26021,MI,Berrien,,2017,4.8,70539,74069,3530
26021,MI,Berrien,,2018,4.3,70190,73369,3179
26021,MI,Berrien,,2019,4.1,70966,73989,3023
26021,MI,Berrien,,2020,9.1,65825,72419,6594
26021,MI,Berrien,,2021,5.8,65843,69898,4055
26023,MI,Branch,,2007,7.5,20575,22234,1659
26023,MI,Branch,,2008,8.4,19966,21808,1842
26023,MI,Branch,,2009,13.8,18500,21460,2960
26023,MI,Branch,,2010,12.3,17409,19846,2437
26023,MI,Branch,,2011,10,17204,19125,1921
26023,MI,Branch,,2012,8.7,17079,18715,1636
26023,MI,Branch,,2013,8.3,17489,19080,1591
26023,MI,Branch,,2014,6.7,18041,19328,1287
26023,MI,Branch,,2015,5.2,18243,19238,995
26023,MI,Branch,,2016,4.9,18224,19157,933
26023,MI,Branch,,2017,4.5,18371,19246,875
26023,MI,Branch,,2018,3.7,18626,19351,725
26023,MI,Branch,,2019,4,18621,19394,773
26023,MI,Branch,,2020,8.4,18014,19662,1648
26023,MI,Branch,,2021,5,18140,19085,945
26025,MI,Calhoun,,2007,7,64822,69706,4884
26025,MI,Calhoun,,2008,7.5,63626,68759,5133
26025,MI,Calhoun,,2009,11.5,60342,68153,7811
26025,MI,Calhoun,,2010,11.4,57068,64398,7330
26025,MI,Calhoun,,2011,9.4,57150,63082,5932
26025,MI,Calhoun,,2012,8.2,57308,62460,5152
26025,MI,Calhoun,,2013,7.8,58086,63003,4917
26025,MI,Calhoun,,2014,6.3,60140,64211,4071
26025,MI,Calhoun,,2015,5.2,61137,64461,3324
26025,MI,Calhoun,,2016,4.8,61453,64585,3132
26025,MI,Calhoun,,2017,4.8,60884,63963,3079
26025,MI,Calhoun,,2018,4.2,60463,63142,2679
26025,MI,Calhoun,,2019,4.2,59910,62522,2612
26025,MI,Calhoun,,2020,10.1,55530,61755,6225
26025,MI,Calhoun,,2021,6.6,55459,59357,3898
26027,MI,Cass,,2007,5.7,25610,27170,1560
26027,MI,Cass,,2008,6.8,24692,26484,1792
26027,MI,Cass,,2009,11.1,22376,25162,2786
26027,MI,Cass,,2010,11.1,21670,24365,2695
26027,MI,Cass,,2011,9.3,22108,24374,2266
26027,MI,Cass,,2012,8.3,21855,23841,1986
26027,MI,Cass,,2013,8.1,21688,23608,1920
26027,MI,Cass,,2014,6.7,22273,23884,1611
26027,MI,Cass,,2015,5.1,22898,24132,1234
26027,MI,Cass,,2016,4.7,23254,24412,1158
26027,MI,Cass,,2017,4.5,23198,24299,1101
26027,MI,Cass,,2018,4.1,23470,24475,1005
26027,MI,Cass,,2019,4.3,23711,24781,1070
26027,MI,Cass,,2020,9.2,22107,24347,2240
26027,MI,Cass,,2021,5.1,21980,23154,1174
26029,MI,Charlevoix,,2007,8.8,12862,14106,1244
26029,MI,Charlevoix,,2008,9.7,12671,14038,1367
26029,MI,Charlevoix,,2009,14.4,11702,13671,1969
26029,MI,Charlevoix,,2010,13.6,11420,13220,1800
26029,MI,Charlevoix,,2011,11.7,11379,12886,1507
26029,MI,Charlevoix,,2012,10.7,11575,12959,1384
26029,MI,Charlevoix,,2013,10.6,11656,13039,1383
26029,MI,Charlevoix,,2014,8.2,12053,13123,1070
26029,MI,Charlevoix,,2015,6.1,12311,13111,800
26029,MI,Charlevoix,,2016,5.6,12362,13093,731
26029,MI,Charlevoix,,2017,5.5,12356,13075,719
26029,MI,Charlevoix,,2018,4.8,12493,13124,631
26029,MI,Charlevoix,,2019,4.7,12292,12903,611
26029,MI,Charlevoix,,2020,10.2,11224,12505,1281
26029,MI,Charlevoix,,2021,6,11484,12219,735
26031,MI,Cheboygan,,2007,10.4,11160,12459,1299
26031,MI,Cheboygan,,2008,11.3,10799,12170,1371
26031,MI,Cheboygan,,2009,13.5,10230,11832,1602
26031,MI,Cheboygan,,2010,13.5,9719,11238,1519
26031,MI,Cheboygan,,2011,11.8,9530,10808,1278
26031,MI,Cheboygan,,2012,11.7,9304,10542,1238
26031,MI,Cheboygan,,2013,11.4,9331,10537,1206
26031,MI,Cheboygan,,2014,10.7,9551,10701,1150
26031,MI,Cheboygan,,2015,9.2,9750,10742,992
26031,MI,Cheboygan,,2016,9.5,9821,10851,1030
26031,MI,Cheboygan,,2017,9.9,9739,10808,1069
26031,MI,Cheboygan,,2018,9.3,9728,10721,993
26031,MI,Cheboygan,,2019,8.8,9596,10527,931
26031,MI,Cheboygan,,2020,15,8770,10315,1545
26031,MI,Cheboygan,,2021,8.3,9113,9941,828
26033,MI,Chippewa,,2007,8.9,15945,17505,1560
26033,MI,Chippewa,,2008,9.6,15565,17225,1660
26033,MI,Chippewa,,2009,12.4,14969,17083,2114
26033,MI,Chippewa,,2010,11.6,15595,17637,2042
26033,MI,Chippewa,,2011,10.4,15539,17348,1809
26033,MI,Chippewa,,2012,9.9,15465,17169,1704
26033,MI,Chippewa,,2013,10.4,15286,17052,1766
26033,MI,Chippewa,,2014,9.5,15304,16912,1608
26033,MI,Chippewa,,2015,7.9,15455,16776,1321
26033,MI,Chippewa,,2016,7.7,15165,16438,1273
26033,MI,Chippewa,,2017,7.6,15115,16352,1237
26033,MI,Chippewa,,2018,6.7,15168,16256,1088
26033,MI,Chippewa,,2019,6.4,15082,16112,1030
26033,MI,Chippewa,,2020,9.5,14400,15905,1505
26033,MI,Chippewa,,2021,6.5,14754,15786,1032
26035,MI,Clare,,2007,10.7,11783,13201,1418
26035,MI,Clare,,2008,11.6,11403,12899,1496
26035,MI,Clare,,2009,16.2,10797,12883,2086
26035,MI,Clare,,2010,15.1,10533,12407,1874
26035,MI,Clare,,2011,12.7,10588,12126,1538
26035,MI,Clare,,2012,11.7,10599,12004,1405
26035,MI,Clare,,2013,11.6,10530,11913,1383
26035,MI,Clare,,2014,9.9,10767,11945,1178
26035,MI,Clare,,2015,7.8,10912,11841,929
26035,MI,Clare,,2016,7.4,11106,11991,885
26035,MI,Clare,,2017,6.9,11136,11957,821
26035,MI,Clare,,2018,6.2,11096,11824,728
26035,MI,Clare,,2019,6.2,11078,11809,731
26035,MI,Clare,,2020,12.1,10288,11700,1412
26035,MI,Clare,,2021,8,10251,11148,897
26037,MI,Clinton,,2007,5.5,35732,37822,2090
26037,MI,Clinton,,2008,5.9,35425,37651,2226
26037,MI,Clinton,,2009,9.2,33626,37030,3404
26037,MI,Clinton,,2010,8.1,36106,39302,3196
26037,MI,Clinton,,2011,6.6,36314,38900,2586
26037,MI,Clinton,,2012,6,36337,38665,2328
26037,MI,Clinton,,2013,6,36827,39171,2344
26037,MI,Clinton,,2014,5,37671,39673,2002
26037,MI,Clinton,,2015,4,38344,39927,1583
26037,MI,Clinton,,2016,3.7,39093,40607,1514
26037,MI,Clinton,,2017,3.6,39511,40979,1468
26037,MI,Clinton,,2018,3.2,39835,41157,1322
26037,MI,Clinton,,2019,3.1,40055,41318,1263
26037,MI,Clinton,,2020,6.8,37457,40183,2726
26037,MI,Clinton,,2021,4.4,37179,38904,1725
26039,MI,Crawford,,2007,8.1,6112,6649,537
26039,MI,Crawford,,2008,9.3,5851,6454,603
26039,MI,Crawford,,2009,13.2,5511,6347,836
26039,MI,Crawford,,2010,13.8,4804,5571,767
26039,MI,Crawford,,2011,12.3,4804,5480,676
26039,MI,Crawford,,2012,11.6,4761,5388,627
26039,MI,Crawford,,2013,11.3,4783,5395,612
26039,MI,Crawford,,2014,9.5,4841,5350,509
26039,MI,Crawford,,2015,7.9,4880,5301,421
26039,MI,Crawford,,2016,7.6,4972,5383,411
26039,MI,Crawford,,2017,6.8,5046,5417,371
26039,MI,Crawford,,2018,6,5210,5544,334
26039,MI,Crawford,,2019,5.7,5277,5597,320
26039,MI,Crawford,,2020,11,4975,5589,614
26039,MI,Crawford,,2021,7.1,4981,5359,378
26041,MI,Delta,,2007,7.7,18576,20128,1552
26041,MI,Delta,,2008,8.4,18026,19673,1647
26041,MI,Delta,,2009,11.9,17061,19376,2315
26041,MI,Delta,,2010,12.2,15809,17998,2189
26041,MI,Delta,,2011,10.3,15933,17769,1836
26041,MI,Delta,,2012,9.8,15858,17572,1714
26041,MI,Delta,,2013,10.2,15767,17551,1784
26041,MI,Delta,,2014,8.5,15998,17479,1481
26041,MI,Delta,,2015,6.9,16136,17327,1191
26041,MI,Delta,,2016,6.6,16033,17169,1136
26041,MI,Delta,,2017,6.2,15994,17050,1056
26041,MI,Delta,,2018,5.4,16137,17050,913
26041,MI,Delta,,2019,5.3,16232,17146,914
26041,MI,Delta,,2020,9.2,15280,16819,1539
26041,MI,Delta,,2021,6.2,15244,16243,999
26043,MI,Dickinson,,2007,6.1,13495,14375,880
26043,MI,Dickinson,,2008,6.9,13413,14400,987
26043,MI,Dickinson,,2009,11.3,12596,14205,1609
26043,MI,Dickinson,,2010,11.2,11627,13090,1463
26043,MI,Dickinson,,2011,9.2,11607,12783,1176
26043,MI,Dickinson,,2012,8.3,11625,12682,1057
26043,MI,Dickinson,,2013,8.2,11622,12662,1040
26043,MI,Dickinson,,2014,6.8,12002,12881,879
26043,MI,Dickinson,,2015,5.7,11941,12665,724
26043,MI,Dickinson,,2016,5.2,11882,12539,657
26043,MI,Dickinson,,2017,4.6,11966,12549,583
26043,MI,Dickinson,,2018,3.8,12058,12540,482
26043,MI,Dickinson,,2019,4.3,11750,12280,530
26043,MI,Dickinson,,2020,7.4,11218,12116,898
26043,MI,Dickinson,,2021,4.8,11552,12132,580
26045,MI,Eaton,,2007,5.3,55787,58906,3119
26045,MI,Eaton,,2008,6.2,55019,58663,3644
26045,MI,Eaton,,2009,10.2,51756,57604,5848
26045,MI,Eaton,,2010,9.4,51387,56702,5315
26045,MI,Eaton,,2011,7.7,51306,55596,4290
26045,MI,Eaton,,2012,6.8,51340,55109,3769
26045,MI,Eaton,,2013,6.6,51854,55521,3667
26045,MI,Eaton,,2014,5.7,52662,55866,3204
26045,MI,Eaton,,2015,4.5,53607,56123,2516
26045,MI,Eaton,,2016,4.2,54670,57051,2381
26045,MI,Eaton,,2017,4,54956,57267,2311
26045,MI,Eaton,,2018,3.5,55258,57269,2011
26045,MI,Eaton,,2019,3.5,55526,57519,1993
26045,MI,Eaton,,2020,7.9,51632,56087,4455
26045,MI,Eaton,,2021,5.3,51211,54084,2873
26047,MI,Emmet,,2007,9.1,17993,19797,1804
26047,MI,Emmet,,2008,9.9,17833,19785,1952
26047,MI,Emmet,,2009,13.9,16744,19454,2710
26047,MI,Emmet,,2010,14,15752,18319,2567
26047,MI,Emmet,,2011,12.6,15721,17982,2261
26047,MI,Emmet,,2012,11.8,15748,17860,2112
26047,MI,Emmet,,2013,11.7,16047,18179,2132
26047,MI,Emmet,,2014,9.6,16262,17980,1718
26047,MI,Emmet,,2015,7.3,16431,17725,1294
26047,MI,Emmet,,2016,6.6,16489,17649,1160
26047,MI,Emmet,,2017,6.4,16515,17648,1133
26047,MI,Emmet,,2018,5.9,16665,17714,1049
26047,MI,Emmet,,2019,5.5,16754,17730,976
26047,MI,Emmet,,2020,10.8,15304,17159,1855
26047,MI,Emmet,,2021,6.4,15305,16348,1043
26049,MI,Genesee,,2007,8.4,190633,208167,17534
26049,MI,Genesee,,2008,10.2,181485,202076,20591
26049,MI,Genesee,,2009,14.5,169285,198024,28739
26049,MI,Genesee,,2010,13.7,159283,184543,25260
26049,MI,Genesee,,2011,11.1,160278,180273,19995
26049,MI,Genesee,,2012,10,161660,179625,17965
26049,MI,Genesee,,2013,9.8,164277,182045,17768
26049,MI,Genesee,,2014,8,167392,181939,14547
26049,MI,Genesee,,2015,6.3,168867,180129,11262
26049,MI,Genesee,,2016,5.8,170150,180586,10436
26049,MI,Genesee,,2017,5.6,170419,180563,10144
26049,MI,Genesee,,2018,5,171833,180835,9002
26049,MI,Genesee,,2019,5.1,172270,181449,9179
26049,MI,Genesee,,2020,11.6,158667,179481,20814
26049,MI,Genesee,,2021,7.6,161241,174492,13251
26051,MI,Gladwin,,2007,10.2,9591,10678,1087
26051,MI,Gladwin,,2008,10.8,9320,10445,1125
26051,MI,Gladwin,,2009,16.1,8675,10345,1670
26051,MI,Gladwin,,2010,14.4,8820,10304,1484
26051,MI,Gladwin,,2011,12.5,8819,10080,1261
26051,MI,Gladwin,,2012,11.7,8797,9962,1165
26051,MI,Gladwin,,2013,11.6,8885,10048,1163
26051,MI,Gladwin,,2014,9.3,9124,10059,935
26051,MI,Gladwin,,2015,7.4,9290,10029,739
26051,MI,Gladwin,,2016,7,9216,9915,699
26051,MI,Gladwin,,2017,6.4,9253,9887,634
26051,MI,Gladwin,,2018,5.7,9357,9920,563
26051,MI,Gladwin,,2019,5.8,9341,9918,577
26051,MI,Gladwin,,2020,10.2,8827,9827,1000
26051,MI,Gladwin,,2021,7.1,8918,9595,677
26053,MI,Gogebic,,2007,7.8,7020,7618,598
26053,MI,Gogebic,,2008,8.5,6885,7527,642
26053,MI,Gogebic,,2009,12.6,6507,7445,938
26053,MI,Gogebic,,2010,12.7,6245,7154,909
26053,MI,Gogebic,,2011,11.4,6136,6926,790
26053,MI,Gogebic,,2012,11,6064,6811,747
26053,MI,Gogebic,,2013,10.7,6010,6733,723
26053,MI,Gogebic,,2014,8.9,6113,6710,597
26053,MI,Gogebic,,2015,7.4,6044,6528,484
26053,MI,Gogebic,,2016,6.2,5961,6354,393
26053,MI,Gogebic,,2017,5.9,5943,6314,371
26053,MI,Gogebic,,2018,5.1,5886,6203,317
26053,MI,Gogebic,,2019,5.2,5698,6008,310
26053,MI,Gogebic,,2020,8.1,5341,5812,471
26053,MI,Gogebic,,2021,5.5,5273,5582,309
26055,MI,Grand Traverse,,2007,6.7,45752,49016,3264
26055,MI,Grand Traverse,,2008,7.4,45101,48705,3604
26055,MI,Grand Traverse,,2009,11.5,42659,48213,5554
26055,MI,Grand Traverse,,2010,11.3,41783,47109,5326
26055,MI,Grand Traverse,,2011,9.4,42181,46562,4381
26055,MI,Grand Traverse,,2012,8.2,42750,46544,3794
26055,MI,Grand Traverse,,2013,7.6,43658,47225,3567
26055,MI,Grand Traverse,,2014,6,45141,48044,2903
26055,MI,Grand Traverse,,2015,4.7,46381,48682,2301
26055,MI,Grand Traverse,,2016,4.3,47371,49515,2144
26055,MI,Grand Traverse,,2017,4.1,47294,49333,2039
26055,MI,Grand Traverse,,2018,3.7,47408,49245,1837
26055,MI,Grand Traverse,,2019,3.5,48031,49789,1758
26055,MI,Grand Traverse,,2020,8.7,44732,48991,4259
26055,MI,Grand Traverse,,2021,5,45518,47928,2410
26057,MI,Gratiot,,2007,8.8,18101,19839,1738
26057,MI,Gratiot,,2008,9.3,17551,19350,1799
26057,MI,Gratiot,,2009,13.6,16819,19473,2654
26057,MI,Gratiot,,2010,11.5,17137,19358,2221
26057,MI,Gratiot,,2011,9.6,17201,19032,1831
26057,MI,Gratiot,,2012,8.9,16991,18646,1655
26057,MI,Gratiot,,2013,8.8,16861,18489,1628
26057,MI,Gratiot,,2014,7.1,17203,18514,1311
26057,MI,Gratiot,,2015,5.8,17325,18382,1057
26057,MI,Gratiot,,2016,5.2,17266,18220,954
26057,MI,Gratiot,,2017,5.4,16894,17851,957
26057,MI,Gratiot,,2018,4.7,16984,17819,835
26057,MI,Gratiot,,2019,4.4,17250,18053,803
26057,MI,Gratiot,,2020,8.3,16310,17788,1478
26057,MI,Gratiot,,2021,5.6,16094,17041,947
26059,MI,Hillsdale,,2007,8.8,19840,21762,1922
26059,MI,Hillsdale,,2008,10.3,18712,20864,2152
26059,MI,Hillsdale,,2009,16.9,17298,20827,3529
26059,MI,Hillsdale,,2010,13.1,18474,21271,2797
26059,MI,Hillsdale,,2011,10.2,18496,20600,2104
26059,MI,Hillsdale,,2012,9,18681,20537,1856
26059,MI,Hillsdale,,2013,8.8,18771,20585,1814
26059,MI,Hillsdale,,2014,7,19106,20546,1440
26059,MI,Hillsdale,,2015,5.3,20005,21129,1124
26059,MI,Hillsdale,,2016,5.1,20150,21233,1083
26059,MI,Hillsdale,,2017,4.8,19914,20925,1011
26059,MI,Hillsdale,,2018,4.1,19760,20598,838
26059,MI,Hillsdale,,2019,4.3,19641,20513,872
26059,MI,Hillsdale,,2020,9.4,18199,20084,1885
26059,MI,Hillsdale,,2021,5.5,18630,19704,1074
26061,MI,Houghton,,2007,7.3,16358,17641,1283
26061,MI,Houghton,,2008,7.8,16027,17383,1356
26061,MI,Houghton,,2009,10.5,15733,17586,1853
26061,MI,Houghton,,2010,10.4,15920,17777,1857
26061,MI,Houghton,,2011,9.2,15697,17286,1589
26061,MI,Houghton,,2012,8.8,15469,16969,1500
26061,MI,Houghton,,2013,8.8,15408,16888,1480
26061,MI,Houghton,,2014,7.7,15674,16978,1304
26061,MI,Houghton,,2015,6.4,15577,16648,1071
26061,MI,Houghton,,2016,6.2,15585,16612,1027
26061,MI,Houghton,,2017,5.8,15502,16465,963
26061,MI,Houghton,,2018,5.1,15348,16179,831
26061,MI,Houghton,,2019,4.9,15452,16252,800
26061,MI,Houghton,,2020,7.7,14664,15880,1216
26061,MI,Houghton,,2021,5,14888,15678,790
26063,MI,Huron,,2007,8,15357,16699,1342
26063,MI,Huron,,2008,8.9,14793,16245,1452
26063,MI,Huron,,2009,14.3,13783,16076,2293
26063,MI,Huron,,2010,12.1,14486,16481,1995
26063,MI,Huron,,2011,9.3,14849,16377,1528
26063,MI,Huron,,2012,7.9,15146,16453,1307
26063,MI,Huron,,2013,8.3,15031,16388,1357
26063,MI,Huron,,2014,6.9,15439,16580,1141
26063,MI,Huron,,2015,5.5,15546,16444,898
26063,MI,Huron,,2016,5.2,15204,16042,838
26063,MI,Huron,,2017,5.1,14815,15609,794
26063,MI,Huron,,2018,4.7,14747,15468,721
26063,MI,Huron,,2019,4.5,14744,15436,692
26063,MI,Huron,,2020,8.9,14048,15414,1366
26063,MI,Huron,,2021,5.4,14058,14854,796
26065,MI,Ingham,,2007,6.3,143744,153341,9597
26065,MI,Ingham,,2008,7,141670,152368,10698
26065,MI,Ingham,,2009,11.1,134201,151008,16807
26065,MI,Ingham,,2010,10,132451,147144,14693
26065,MI,Ingham,,2011,8.5,132587,144888,12301
26065,MI,Ingham,,2012,7.7,132626,143745,11119
26065,MI,Ingham,,2013,7.6,133742,144696,10954
26065,MI,Ingham,,2014,6.2,136700,145727,9027
26065,MI,Ingham,,2015,4.7,139586,146506,6920
26065,MI,Ingham,,2016,4.3,142853,149317,6464
26065,MI,Ingham,,2017,4.2,144847,151233,6386
26065,MI,Ingham,,2018,3.7,145837,151380,5543
26065,MI,Ingham,,2019,3.6,145801,151232,5431
26065,MI,Ingham,,2020,7.8,134870,146305,11435
26065,MI,Ingham,,2021,5.6,133763,141678,7915
26067,MI,Ionia,,2007,7.6,28144,30456,2312
26067,MI,Ionia,,2008,8.4,27487,29998,2511
26067,MI,Ionia,,2009,13.7,25095,29088,3993
26067,MI,Ionia,,2010,11.6,26215,29644,3429
26067,MI,Ionia,,2011,9.4,26321,29045,2724
26067,MI,Ionia,,2012,8.4,26325,28731,2406
26067,MI,Ionia,,2013,7.9,26603,28878,2275
26067,MI,Ionia,,2014,6.2,27486,29305,1819
26067,MI,Ionia,,2015,4.6,28131,29496,1365
26067,MI,Ionia,,2016,4.3,28468,29735,1267
26067,MI,Ionia,,2017,3.9,28675,29839,1164
26067,MI,Ionia,,2018,3.5,28917,29961,1044
26067,MI,Ionia,,2019,3.5,29319,30374,1055
26067,MI,Ionia,,2020,8.3,27633,30119,2486
26067,MI,Ionia,,2021,4.8,28105,29513,1408
26069,MI,Iosco,,2007,10.1,9791,10887,1096
26069,MI,Iosco,,2008,10.9,9500,10659,1159
26069,MI,Iosco,,2009,17.3,8688,10507,1819
26069,MI,Iosco,,2010,15.4,8689,10265,1576
26069,MI,Iosco,,2011,12.3,8850,10095,1245
26069,MI,Iosco,,2012,11.1,9057,10187,1130
26069,MI,Iosco,,2013,11.3,9067,10226,1159
26069,MI,Iosco,,2014,9.8,9317,10324,1007
26069,MI,Iosco,,2015,7.6,9373,10147,774
26069,MI,Iosco,,2016,7.4,9395,10141,746
26069,MI,Iosco,,2017,7.3,9396,10131,735
26069,MI,Iosco,,2018,6.4,9439,10085,646
26069,MI,Iosco,,2019,6.1,9576,10195,619
26069,MI,Iosco,,2020,11,8999,10107,1108
26069,MI,Iosco,,2021,7.2,9110,9819,709
26071,MI,Iron,,2007,7.5,5490,5934,444
26071,MI,Iron,,2008,8.4,5345,5832,487
26071,MI,Iron,,2009,11.8,5067,5744,677
26071,MI,Iron,,2010,11.6,4635,5245,610
26071,MI,Iron,,2011,9.9,4645,5158,513
26071,MI,Iron,,2012,9.4,4618,5099,481
26071,MI,Iron,,2013,10.1,4575,5087,512
26071,MI,Iron,,2014,8.7,4761,5215,454
26071,MI,Iron,,2015,7.1,4859,5233,374
26071,MI,Iron,,2016,6.5,4891,5233,342
26071,MI,Iron,,2017,6.3,4838,5164,326
26071,MI,Iron,,2018,5.6,4852,5141,289
26071,MI,Iron,,2019,5.6,4834,5122,288
26071,MI,Iron,,2020,8.6,4505,4928,423
26071,MI,Iron,,2021,6.1,4454,4742,288
26073,MI,Isabella,,2007,5.3,36658,38703,2045
26073,MI,Isabella,,2008,6,36282,38591,2309
26073,MI,Isabella,,2009,8.6,34816,38111,3295
26073,MI,Isabella,,2010,9.5,31867,35219,3352
26073,MI,Isabella,,2011,8,32059,34865,2806
26073,MI,Isabella,,2012,7.3,32301,34843,2542
26073,MI,Isabella,,2013,7.2,32502,35005,2503
26073,MI,Isabella,,2014,5.9,33453,35562,2109
26073,MI,Isabella,,2015,4.9,33747,35472,1725
26073,MI,Isabella,,2016,4.7,33768,35448,1680
26073,MI,Isabella,,2017,4.4,33620,35170,1550
26073,MI,Isabella,,2018,3.9,33546,34905,1359
26073,MI,Isabella,,2019,3.9,33383,34727,1344
26073,MI,Isabella,,2020,8.7,30089,32957,2868
26073,MI,Isabella,,2021,5.3,30098,31774,1676
26075,MI,Jackson,,2007,7.7,71536,77491,5955
26075,MI,Jackson,,2008,8.4,69952,76333,6381
26075,MI,Jackson,,2009,13.2,65948,76000,10052
26075,MI,Jackson,,2010,11.8,65197,73954,8757
26075,MI,Jackson,,2011,9.5,65573,72456,6883
26075,MI,Jackson,,2012,8.4,65789,71833,6044
26075,MI,Jackson,,2013,8.2,66462,72368,5906
26075,MI,Jackson,,2014,6.7,68293,73167,4874
26075,MI,Jackson,,2015,5.4,69458,73385,3927
26075,MI,Jackson,,2016,4.9,70963,74612,3649
26075,MI,Jackson,,2017,4.5,70984,74366,3382
26075,MI,Jackson,,2018,4,71622,74579,2957
26075,MI,Jackson,,2019,3.8,71790,74630,2840
26075,MI,Jackson,,2020,9.3,67413,74332,6919
26075,MI,Jackson,,2021,5.7,67863,71993,4130
26077,MI,Kalamazoo,,2007,5.4,127266,134522,7256
26077,MI,Kalamazoo,,2008,6.2,125527,133800,8273
26077,MI,Kalamazoo,,2009,9.9,119597,132752,13155
26077,MI,Kalamazoo,,2010,9.7,116004,128519,12515
26077,MI,Kalamazoo,,2011,8.1,115812,126001,10189
26077,MI,Kalamazoo,,2012,7.2,116156,125104,8948
26077,MI,Kalamazoo,,2013,6.8,116902,125414,8512
26077,MI,Kalamazoo,,2014,5.6,121148,128362,7214
26077,MI,Kalamazoo,,2015,4.4,124041,129756,5715
26077,MI,Kalamazoo,,2016,4.1,126947,132365,5418
26077,MI,Kalamazoo,,2017,4,127572,132832,5260
26077,MI,Kalamazoo,,2018,3.4,129212,133827,4615
26077,MI,Kalamazoo,,2019,3.4,129625,134120,4495
26077,MI,Kalamazoo,,2020,7.6,121713,131685,9972
26077,MI,Kalamazoo,,2021,5,122189,128630,6441
26079,MI,Kalkaska,,2007,8.1,7994,8702,708
26079,MI,Kalkaska,,2008,8.7,7770,8514,744
26079,MI,Kalkaska,,2009,14.1,7252,8438,1186
26079,MI,Kalkaska,,2010,15.2,6643,7833,1190
26079,MI,Kalkaska,,2011,12.5,6621,7568,947
26079,MI,Kalkaska,,2012,11.2,6622,7456,834
26079,MI,Kalkaska,,2013,11.1,6746,7586,840
26079,MI,Kalkaska,,2014,9.5,7001,7732,731
26079,MI,Kalkaska,,2015,7.8,7070,7666,596
26079,MI,Kalkaska,,2016,7.2,7182,7743,561
26079,MI,Kalkaska,,2017,6.8,7345,7883,538
26079,MI,Kalkaska,,2018,5.9,7376,7841,465
26079,MI,Kalkaska,,2019,5.7,7525,7983,458
26079,MI,Kalkaska,,2020,11.6,6955,7865,910
26079,MI,Kalkaska,,2021,7.3,7078,7632,554
26081,MI,Kent,,2007,6,303869,323134,19265
26081,MI,Kent,,2008,6.7,298230,319781,21551
26081,MI,Kent,,2009,10.7,279174,312565,33391
26081,MI,Kent,,2010,9.9,282588,313539,30951
26081,MI,Kent,,2011,7.9,289956,314702,24746
26081,MI,Kent,,2012,6.7,299448,321042,21594
26081,MI,Kent,,2013,6.2,307705,327984,20279
26081,MI,Kent,,2014,5,320264,336948,16684
26081,MI,Kent,,2015,3.8,330959,344072,13113
26081,MI,Kent,,2016,3.6,338786,351257,12471
26081,MI,Kent,,2017,3.4,343580,355685,12105
26081,MI,Kent,,2018,3,349395,360213,10818
26081,MI,Kent,,2019,2.9,351070,361705,10635
26081,MI,Kent,,2020,7.9,327484,355726,28242
26081,MI,Kent,,2021,4.7,332738,349167,16429
26083,MI,Keweenaw,,2007,11.1,941,1058,117
26083,MI,Keweenaw,,2008,10.8,946,1061,115
26083,MI,Keweenaw,,2009,13.8,967,1122,155
26083,MI,Keweenaw,,2010,14.6,857,1003,146
26083,MI,Keweenaw,,2011,13.2,879,1013,134
26083,MI,Keweenaw,,2012,12.7,863,988,125
26083,MI,Keweenaw,,2013,13.4,856,989,133
26083,MI,Keweenaw,,2014,11.2,876,986,110
26083,MI,Keweenaw,,2015,9.3,856,944,88
26083,MI,Keweenaw,,2016,8.7,862,944,82
26083,MI,Keweenaw,,2017,8.7,823,901,78
26083,MI,Keweenaw,,2018,7,820,882,62
26083,MI,Keweenaw,,2019,6.9,840,902,62
26083,MI,Keweenaw,,2020,9.3,812,895,83
26083,MI,Keweenaw,,2021,6.7,824,883,59
26085,MI,Lake,,2007,10.5,3641,4070,429
26085,MI,Lake,,2008,11.3,3493,3938,445
26085,MI,Lake,,2009,16.3,3390,4049,659
26085,MI,Lake,,2010,15.8,3240,3847,607
26085,MI,Lake,,2011,13.1,3339,3844,505
26085,MI,Lake,,2012,12.9,3200,3674,474
26085,MI,Lake,,2013,13.2,3154,3632,478
26085,MI,Lake,,2014,11.2,3219,3626,407
26085,MI,Lake,,2015,8.7,3377,3698,321
26085,MI,Lake,,2016,7.6,3479,3764,285
26085,MI,Lake,,2017,8,3427,3727,300
26085,MI,Lake,,2018,6.9,3388,3638,250
26085,MI,Lake,,2019,6.4,3533,3775,242
26085,MI,Lake,,2020,11.3,3509,3954,445
26085,MI,Lake,,2021,8.2,3527,3843,316
26087,MI,Lapeer,,2007,8.1,40464,44033,3569
26087,MI,Lapeer,,2008,9.9,38808,43055,4247
26087,MI,Lapeer,,2009,16.5,35605,42651,7046
26087,MI,Lapeer,,2010,15.8,34495,40953,6458
26087,MI,Lapeer,,2011,12.8,34589,39663,5074
26087,MI,Lapeer,,2012,11.6,35196,39806,4610
26087,MI,Lapeer,,2013,11.3,35796,40377,4581
26087,MI,Lapeer,,2014,9.5,36049,39845,3796
26087,MI,Lapeer,,2015,7.1,36768,39587,2819
26087,MI,Lapeer,,2016,6.4,38080,40678,2598
26087,MI,Lapeer,,2017,5.5,39141,41429,2288
26087,MI,Lapeer,,2018,5.2,39360,41531,2171
26087,MI,Lapeer,,2019,5.3,39637,41874,2237
26087,MI,Lapeer,,2020,12.2,35571,40521,4950
26087,MI,Lapeer,,2021,6.1,37704,40133,2429
26089,MI,Leelanau,,2007,5.5,10725,11352,627
26089,MI,Leelanau,,2008,6.1,10444,11127,683
26089,MI,Leelanau,,2009,9,9901,10884,983
26089,MI,Leelanau,,2010,10,9438,10492,1054
26089,MI,Leelanau,,2011,8.8,9400,10307,907
26089,MI,Leelanau,,2012,7.9,9395,10205,810
26089,MI,Leelanau,,2013,7.6,9518,10301,783
26089,MI,Leelanau,,2014,6.7,9848,10553,705
26089,MI,Leelanau,,2015,5.3,10068,10634,566
26089,MI,Leelanau,,2016,4.9,10083,10603,520
26089,MI,Leelanau,,2017,4.7,10005,10502,497
26089,MI,Leelanau,,2018,4.3,9982,10430,448
26089,MI,Leelanau,,2019,3.8,10071,10471,400
26089,MI,Leelanau,,2020,8.3,9362,10207,845
26089,MI,Leelanau,,2021,5.2,9524,10047,523
26091,MI,Lenawee,,2007,8,45650,49617,3967
26091,MI,Lenawee,,2008,9.8,43811,48592,4781
26091,MI,Lenawee,,2009,15.2,40840,48140,7300
26091,MI,Lenawee,,2010,12.7,43076,49318,6242
26091,MI,Lenawee,,2011,10,43359,48152,4793
26091,MI,Lenawee,,2012,8.3,43745,47688,3943
26091,MI,Lenawee,,2013,7.8,44072,47776,3704
26091,MI,Lenawee,,2014,6.4,45011,48104,3093
26091,MI,Lenawee,,2015,5.1,45280,47701,2421
26091,MI,Lenawee,,2016,4.7,45278,47487,2209
26091,MI,Lenawee,,2017,4.6,44951,47139,2188
26091,MI,Lenawee,,2018,4.1,44971,46891,1920
26091,MI,Lenawee,,2019,4,44613,46448,1835
26091,MI,Lenawee,,2020,9.3,41328,45546,4218
26091,MI,Lenawee,,2021,5.5,42093,44522,2429
26093,MI,Livingston,,2007,5.4,89211,94300,5089
26093,MI,Livingston,,2008,6.6,86338,92442,6104
26093,MI,Livingston,,2009,11.3,80244,90474,10230
26093,MI,Livingston,,2010,10.8,83377,93444,10067
26093,MI,Livingston,,2011,8.7,84291,92312,8021
26093,MI,Livingston,,2012,7.8,86053,93382,7329
26093,MI,Livingston,,2013,7.4,88055,95059,7004
26093,MI,Livingston,,2014,6.3,89348,95367,6019
26093,MI,Livingston,,2015,4.6,91736,96123,4387
26093,MI,Livingston,,2016,4.1,95886,99935,4049
26093,MI,Livingston,,2017,3.4,99425,102925,3500
26093,MI,Livingston,,2018,3.3,101074,104525,3451
26093,MI,Livingston,,2019,3.2,102606,106042,3436
26093,MI,Livingston,,2020,8.6,92104,100793,8689
26093,MI,Livingston,,2021,4.2,97621,101855,4234
26095,MI,Luce,,2007,9.2,2517,2771,254
26095,MI,Luce,,2008,9.2,2483,2736,253
26095,MI,Luce,,2009,12.9,2356,2706,350
26095,MI,Luce,,2010,13,2151,2473,322
26095,MI,Luce,,2011,11.7,2122,2404,282
26095,MI,Luce,,2012,10.8,2118,2375,257
26095,MI,Luce,,2013,10.3,2159,2406,247
26095,MI,Luce,,2014,8.5,2276,2488,212
26095,MI,Luce,,2015,7.1,2297,2472,175
26095,MI,Luce,,2016,6.8,2245,2409,164
26095,MI,Luce,,2017,6.7,2250,2412,162
26095,MI,Luce,,2018,6.3,2232,2382,150
26095,MI,Luce,,2019,6.4,2124,2270,146
26095,MI,Luce,,2020,9.1,2022,2224,202
26095,MI,Luce,,2021,7.1,1969,2119,150
26097,MI,Mackinac,,2007,10.2,5774,6428,654
26097,MI,Mackinac,,2008,11.7,5560,6298,738
26097,MI,Mackinac,,2009,13.7,5303,6146,843
26097,MI,Mackinac,,2010,14.2,4721,5500,779
26097,MI,Mackinac,,2011,12.6,4607,5274,667
26097,MI,Mackinac,,2012,12,4586,5211,625
26097,MI,Mackinac,,2013,12.2,4619,5258,639
26097,MI,Mackinac,,2014,11.2,4711,5306,595
26097,MI,Mackinac,,2015,9.8,4644,5151,507
26097,MI,Mackinac,,2016,10,4689,5208,519
26097,MI,Mackinac,,2017,10,4678,5197,519
26097,MI,Mackinac,,2018,9.6,4710,5208,498
26097,MI,Mackinac,,2019,9.3,4713,5199,486
26097,MI,Mackinac,,2020,13.9,4248,4932,684
26097,MI,Mackinac,,2021,8.6,4375,4785,410
26099,MI,Macomb,,2007,7.2,388415,418353,29938
26099,MI,Macomb,,2008,8.5,376995,412082,35087
26099,MI,Macomb,,2009,15,349665,411420,61755
26099,MI,Macomb,,2010,13.4,361414,417371,55957
26099,MI,Macomb,,2011,10.8,363502,407342,43840
26099,MI,Macomb,,2012,9.8,372357,412673,40316
26099,MI,Macomb,,2013,9.4,381732,421344,39612
26099,MI,Macomb,,2014,7.9,387466,420573,33107
26099,MI,Macomb,,2015,5.7,396168,420070,23902
26099,MI,Macomb,,2016,5.2,412956,435441,22485
26099,MI,Macomb,,2017,4.4,428149,447838,19689
26099,MI,Macomb,,2018,4.1,433446,451838,18392
26099,MI,Macomb,,2019,4.2,437744,456825,19081
26099,MI,Macomb,,2020,11.8,390268,442237,51969
26099,MI,Macomb,,2021,5.9,413707,439812,26105
26101,MI,Manistee,,2007,8.5,10950,11973,1023
26101,MI,Manistee,,2008,8.8,10671,11704,1033
26101,MI,Manistee,,2009,12.6,10074,11532,1458
26101,MI,Manistee,,2010,12.7,9552,10942,1390
26101,MI,Manistee,,2011,11.5,9428,10652,1224
26101,MI,Manistee,,2012,10.7,9408,10533,1125
26101,MI,Manistee,,2013,10.5,9417,10523,1106
26101,MI,Manistee,,2014,8.5,9497,10381,884
26101,MI,Manistee,,2015,6.7,9754,10458,704
26101,MI,Manistee,,2016,6.6,9866,10565,699
26101,MI,Manistee,,2017,6.4,9753,10422,669
26101,MI,Manistee,,2018,5.8,9751,10356,605
26101,MI,Manistee,,2019,5.6,9835,10420,585
26101,MI,Manistee,,2020,11.3,9012,10162,1150
26101,MI,Manistee,,2021,7.3,9034,9744,710
26103,MI,Marquette,,2007,6.3,33591,35857,2266
26103,MI,Marquette,,2008,6.9,33378,35860,2482
26103,MI,Marquette,,2009,10.1,32465,36124,3659
26103,MI,Marquette,,2010,9.6,31326,34642,3316
26103,MI,Marquette,,2011,8.5,30993,33886,2893
26103,MI,Marquette,,2012,8,31400,34119,2719
26103,MI,Marquette,,2013,8.1,31305,34063,2758
26103,MI,Marquette,,2014,7,31488,33868,2380
26103,MI,Marquette,,2015,6.1,31507,33546,2039
26103,MI,Marquette,,2016,5.8,31489,33412,1923
26103,MI,Marquette,,2017,5.5,31097,32908,1811
26103,MI,Marquette,,2018,4.9,30932,32538,1606
26103,MI,Marquette,,2019,5,30887,32496,1609
26103,MI,Marquette,,2020,8.6,28905,31639,2734
26103,MI,Marquette,,2021,5.4,28995,30639,1644
26105,MI,Mason,,2007,7.9,13739,14911,1172
26105,MI,Mason,,2008,8.4,13551,14801,1250
26105,MI,Mason,,2009,13,12807,14715,1908
26105,MI,Mason,,2010,12.2,12662,14424,1762
26105,MI,Mason,,2011,10.6,12723,14226,1503
26105,MI,Mason,,2012,9.6,13020,14395,1375
26105,MI,Mason,,2013,9.1,13204,14522,1318
26105,MI,Mason,,2014,7.5,13607,14715,1108
26105,MI,Mason,,2015,6.2,13589,14485,896
26105,MI,Mason,,2016,5.9,13476,14316,840
26105,MI,Mason,,2017,5.7,13239,14036,797
26105,MI,Mason,,2018,4.9,13113,13793,680
26105,MI,Mason,,2019,5,12975,13658,683
26105,MI,Mason,,2020,9.7,11986,13270,1284
26105,MI,Mason,,2021,6.4,12171,13009,838
26107,MI,Mecosta,,2007,7.6,18511,20039,1528
26107,MI,Mecosta,,2008,8.6,18001,19687,1686
26107,MI,Mecosta,,2009,12.5,17657,20190,2533
26107,MI,Mecosta,,2010,12.2,16778,19116,2338
26107,MI,Mecosta,,2011,10.9,17012,19083,2071
26107,MI,Mecosta,,2012,10,17002,18892,1890
26107,MI,Mecosta,,2013,9.9,16912,18775,1863
26107,MI,Mecosta,,2014,7.9,17694,19222,1528
26107,MI,Mecosta,,2015,6.2,18036,19235,1199
26107,MI,Mecosta,,2016,5.7,18071,19160,1089
26107,MI,Mecosta,,2017,5.6,17740,18798,1058
26107,MI,Mecosta,,2018,5,17566,18497,931
26107,MI,Mecosta,,2019,4.7,17566,18440,874
26107,MI,Mecosta,,2020,9.5,16555,18300,1745
26107,MI,Mecosta,,2021,6.4,16605,17735,1130
26109,MI,Menominee,,2007,5.8,12423,13194,771
26109,MI,Menominee,,2008,6.3,12232,13052,820
26109,MI,Menominee,,2009,11.6,11563,13076,1513
26109,MI,Menominee,,2010,11.3,10508,11847,1339
26109,MI,Menominee,,2011,8.8,10760,11793,1033
26109,MI,Menominee,,2012,7.9,10864,11800,936
26109,MI,Menominee,,2013,7.7,10887,11792,905
26109,MI,Menominee,,2014,6.9,10943,11752,809
26109,MI,Menominee,,2015,5.5,10951,11583,632
26109,MI,Menominee,,2016,5.2,10693,11281,588
26109,MI,Menominee,,2017,4.8,10475,11001,526
26109,MI,Menominee,,2018,4.1,10557,11006,449
26109,MI,Menominee,,2019,4.1,10561,11011,450
26109,MI,Menominee,,2020,6.7,9917,10633,716
26109,MI,Menominee,,2021,4.5,9966,10438,472
26111,MI,Midland,,2007,5.6,40557,42960,2403
26111,MI,Midland,,2008,6.2,40473,43133,2660
26111,MI,Midland,,2009,9.5,38587,42622,4035
26111,MI,Midland,,2010,9.5,36989,40881,3892
26111,MI,Midland,,2011,8,37535,40821,3286
26111,MI,Midland,,2012,7.7,37700,40838,3138
26111,MI,Midland,,2013,7.6,37814,40942,3128
26111,MI,Midland,,2014,6.1,39163,41707,2544
26111,MI,Midland,,2015,4.9,39575,41628,2053
26111,MI,Midland,,2016,4.8,39179,41136,1957
26111,MI,Midland,,2017,4.6,38697,40546,1849
26111,MI,Midland,,2018,4,39099,40728,1629
26111,MI,Midland,,2019,3.8,38644,40181,1537
26111,MI,Midland,,2020,7.9,36115,39208,3093
26111,MI,Midland,,2021,4.9,36396,38276,1880
26113,MI,Missaukee,,2007,8.6,5961,6521,560
26113,MI,Missaukee,,2008,10.4,5740,6405,665
26113,MI,Missaukee,,2009,15.2,5323,6277,954
26113,MI,Missaukee,,2010,12.3,6206,7076,870
26113,MI,Missaukee,,2011,10.4,6286,7018,732
26113,MI,Missaukee,,2012,9.5,6275,6937,662
26113,MI,Missaukee,,2013,9.1,6327,6964,637
26113,MI,Missaukee,,2014,7.8,6528,7078,550
26113,MI,Missaukee,,2015,6.6,6557,7021,464
26113,MI,Missaukee,,2016,6,6622,7045,423
26113,MI,Missaukee,,2017,5.8,6521,6920,399
26113,MI,Missaukee,,2018,5.2,6527,6882,355
26113,MI,Missaukee,,2019,4.9,6600,6938,338
26113,MI,Missaukee,,2020,9.5,6241,6898,657
26113,MI,Missaukee,,2021,5.6,6421,6800,379
26115,MI,Monroe,,2007,6.8,72035,77280,5245
26115,MI,Monroe,,2008,8.6,69306,75842,6536
26115,MI,Monroe,,2009,14.2,63688,74223,10535
26115,MI,Monroe,,2010,11.4,66399,74925,8526
26115,MI,Monroe,,2011,9.1,66833,73512,6679
26115,MI,Monroe,,2012,7.6,68251,73897,5646
26115,MI,Monroe,,2013,7.3,69210,74666,5456
26115,MI,Monroe,,2014,6.1,71563,76222,4659
26115,MI,Monroe,,2015,4.6,73051,76585,3534
26115,MI,Monroe,,2016,4.4,73276,76614,3338
26115,MI,Monroe,,2017,4.7,72521,76087,3566
26115,MI,Monroe,,2018,4.2,72832,76040,3208
26115,MI,Monroe,,2019,4,72770,75772,3002
26115,MI,Monroe,,2020,9.2,67313,74146,6833
26115,MI,Monroe,,2021,6,67809,72149,4340
26117,MI,Montcalm,,2007,11.8,23695,26851,3156
26117,MI,Montcalm,,2008,11.4,23301,26309,3008
26117,MI,Montcalm,,2009,16.2,22219,26524,4305
26117,MI,Montcalm,,2010,13.7,23755,27524,3769
26117,MI,Montcalm,,2011,11.1,24195,27220,3025
26117,MI,Montcalm,,2012,10.1,24598,27352,2754
26117,MI,Montcalm,,2013,9.5,24940,27557,2617
26117,MI,Montcalm,,2014,7.6,25615,27716,2101
26117,MI,Montcalm,,2015,5.8,26205,27820,1615
26117,MI,Montcalm,,2016,5.4,26501,28000,1499
26117,MI,Montcalm,,2017,4.9,26778,28167,1389
26117,MI,Montcalm,,2018,4.3,27145,28362,1217
26117,MI,Montcalm,,2019,4.2,27151,28328,1177
26117,MI,Montcalm,,2020,9.5,25157,27803,2646
26117,MI,Montcalm,,2021,5.6,25561,27073,1512
26119,MI,Montmorency,,2007,13.3,3618,4174,556
26119,MI,Montmorency,,2008,13.9,3453,4010,557
26119,MI,Montmorency,,2009,20.3,3169,3974,805
26119,MI,Montmorency,,2010,19.6,2820,3507,687
26119,MI,Montmorency,,2011,17.4,2748,3327,579
26119,MI,Montmorency,,2012,16.1,2723,3245,522
26119,MI,Montmorency,,2013,15.9,2698,3209,511
26119,MI,Montmorency,,2014,13,2753,3163,410
26119,MI,Montmorency,,2015,10.1,2772,3083,311
26119,MI,Montmorency,,2016,10.2,2755,3069,314
26119,MI,Montmorency,,2017,10.3,2743,3058,315
26119,MI,Montmorency,,2018,8.8,2754,3020,266
26119,MI,Montmorency,,2019,8.5,2743,2998,255
26119,MI,Montmorency,,2020,13.8,2596,3010,414
26119,MI,Montmorency,,2021,9.4,2661,2936,275
26121,MI,Muskegon,,2007,7.3,82838,89376,6538
26121,MI,Muskegon,,2008,8.5,81070,88615,7545
26121,MI,Muskegon,,2009,14.6,74933,87695,12762
26121,MI,Muskegon,,2010,14.1,66050,76905,10855
26121,MI,Muskegon,,2011,11,67161,75451,8290
26121,MI,Muskegon,,2012,9.9,68384,75915,7531
26121,MI,Muskegon,,2013,9.8,68958,76458,7500
26121,MI,Muskegon,,2014,7.7,71415,77368,5953
26121,MI,Muskegon,,2015,5.9,73101,77683,4582
26121,MI,Muskegon,,2016,5.5,73383,77659,4276
26121,MI,Muskegon,,2017,5.2,73815,77895,4080
26121,MI,Muskegon,,2018,4.6,74516,78109,3593
26121,MI,Muskegon,,2019,4.3,73939,77300,3361
26121,MI,Muskegon,,2020,11.9,68203,77415,9212
26121,MI,Muskegon,,2021,7.5,69663,75304,5641
26123,MI,Newaygo,,2007,8,21099,22934,1835
26123,MI,Newaygo,,2008,9,20563,22590,2027
26123,MI,Newaygo,,2009,13.6,19068,22062,2994
26123,MI,Newaygo,,2010,12.3,19965,22762,2797
26123,MI,Newaygo,,2011,10.2,20120,22407,2287
26123,MI,Newaygo,,2012,9.1,20096,22099,2003
26123,MI,Newaygo,,2013,8.8,20165,22101,1936
26123,MI,Newaygo,,2014,7.2,21039,22672,1633
26123,MI,Newaygo,,2015,5.5,21906,23190,1284
26123,MI,Newaygo,,2016,4.9,22239,23394,1155
26123,MI,Newaygo,,2017,4.9,22159,23290,1131
26123,MI,Newaygo,,2018,4.4,22190,23213,1023
26123,MI,Newaygo,,2019,4.3,22423,23430,1007
26123,MI,Newaygo,,2020,9,21172,23274,2102
26123,MI,Newaygo,,2021,5.6,21533,22817,1284
26125,MI,Oakland,,2007,5.9,584886,621588,36702
26125,MI,Oakland,,2008,6.9,566130,608180,42050
26125,MI,Oakland,,2009,12.3,526060,599894,73834
26125,MI,Oakland,,2010,11.4,547238,617349,70111
26125,MI,Oakland,,2011,9.2,552687,608692,56005
26125,MI,Oakland,,2012,8.2,567085,617642,50557
26125,MI,Oakland,,2013,7.7,581499,630193,48694
26125,MI,Oakland,,2014,6.4,589088,629684,40596
26125,MI,Oakland,,2015,4.7,601330,630756,29426
26125,MI,Oakland,,2016,4.1,625608,652450,26842
26125,MI,Oakland,,2017,3.5,649306,673030,23724
26125,MI,Oakland,,2018,3.4,659290,682269,22979
26125,MI,Oakland,,2019,3.4,665495,688661,23166
26125,MI,Oakland,,2020,9.1,593872,653339,59467
26125,MI,Oakland,,2021,4.7,629457,660330,30873
26127,MI,Oceana,,2007,8.5,13169,14389,1220
26127,MI,Oceana,,2008,10.4,12597,14056,1459
26127,MI,Oceana,,2009,15.7,11889,14108,2219
26127,MI,Oceana,,2010,15.7,11155,13232,2077
26127,MI,Oceana,,2011,13.5,11191,12938,1747
26127,MI,Oceana,,2012,12.5,11261,12872,1611
26127,MI,Oceana,,2013,12.3,11200,12765,1565
26127,MI,Oceana,,2014,10.1,11573,12867,1294
26127,MI,Oceana,,2015,8.1,11536,12552,1016
26127,MI,Oceana,,2016,7.4,11446,12360,914
26127,MI,Oceana,,2017,7,11366,12220,854
26127,MI,Oceana,,2018,6.3,11291,12048,757
26127,MI,Oceana,,2019,6.1,11342,12075,733
26127,MI,Oceana,,2020,10.9,10695,11998,1303
26127,MI,Oceana,,2021,7.4,10721,11581,860
26129,MI,Ogemaw,,2007,8.5,8821,9644,823
26129,MI,Ogemaw,,2008,9.3,8645,9528,883
26129,MI,Ogemaw,,2009,13.2,8302,9564,1262
26129,MI,Ogemaw,,2010,14.1,7723,8987,1264
26129,MI,Ogemaw,,2011,12.3,7680,8755,1075
26129,MI,Ogemaw,,2012,11.3,7679,8655,976
26129,MI,Ogemaw,,2013,11.7,7623,8630,1007
26129,MI,Ogemaw,,2014,9.8,7769,8615,846
26129,MI,Ogemaw,,2015,8,7777,8450,673
26129,MI,Ogemaw,,2016,7.9,7612,8262,650
26129,MI,Ogemaw,,2017,7.6,7559,8177,618
26129,MI,Ogemaw,,2018,7,7646,8218,572
26129,MI,Ogemaw,,2019,6.8,7502,8048,546
26129,MI,Ogemaw,,2020,11.4,7129,8048,919
26129,MI,Ogemaw,,2021,7.8,7256,7874,618
26131,MI,Ontonagon,,2007,8.5,3125,3414,289
26131,MI,Ontonagon,,2008,9.2,2971,3273,302
26131,MI,Ontonagon,,2009,15.4,2698,3188,490
26131,MI,Ontonagon,,2010,16.3,2546,3042,496
26131,MI,Ontonagon,,2011,15.6,2331,2763,432
26131,MI,Ontonagon,,2012,13.3,2245,2588,343
26131,MI,Ontonagon,,2013,13.7,2117,2453,336
26131,MI,Ontonagon,,2014,11.4,2114,2386,272
26131,MI,Ontonagon,,2015,9.5,2087,2306,219
26131,MI,Ontonagon,,2016,8.6,2019,2209,190
26131,MI,Ontonagon,,2017,8.7,1978,2166,188
26131,MI,Ontonagon,,2018,7.9,1934,2099,165
26131,MI,Ontonagon,,2019,7,1940,2085,145
26131,MI,Ontonagon,,2020,10.8,1822,2043,221
26131,MI,Ontonagon,,2021,7.6,1859,2012,153
26133,MI,Osceola,,2007,8.1,9085,9885,800
26133,MI,Osceola,,2008,9.4,8545,9434,889
26133,MI,Osceola,,2009,14.9,8068,9479,1411
26133,MI,Osceola,,2010,13.2,8920,10278,1358
26133,MI,Osceola,,2011,10.9,9032,10140,1108
26133,MI,Osceola,,2012,9.8,9021,10006,985
26133,MI,Osceola,,2013,9.9,9060,10053,993
26133,MI,Osceola,,2014,8.5,9362,10237,875
26133,MI,Osceola,,2015,6.6,9537,10210,673
26133,MI,Osceola,,2016,5.8,9859,10462,603
26133,MI,Osceola,,2017,5.9,10004,10629,625
26133,MI,Osceola,,2018,4.5,10416,10903,487
26133,MI,Osceola,,2019,4.1,10802,11266,464
26133,MI,Osceola,,2020,8.7,10513,11509,996
26133,MI,Osceola,,2021,5.5,10653,11277,624
26135,MI,Oscoda,,2007,10.6,3584,4010,426
26135,MI,Oscoda,,2008,12.7,3384,3878,494
26135,MI,Oscoda,,2009,20.8,2950,3725,775
26135,MI,Oscoda,,2010,19,2652,3275,623
26135,MI,Oscoda,,2011,17.1,2595,3132,537
26135,MI,Oscoda,,2012,15.5,2531,2994,463
26135,MI,Oscoda,,2013,15.5,2510,2969,459
26135,MI,Oscoda,,2014,11.8,2632,2985,353
26135,MI,Oscoda,,2015,8.8,2669,2926,257
26135,MI,Oscoda,,2016,7.4,2700,2915,215
26135,MI,Oscoda,,2017,7.2,2702,2913,211
26135,MI,Oscoda,,2018,6.5,2761,2952,191
26135,MI,Oscoda,,2019,7.2,2779,2993,214
26135,MI,Oscoda,,2020,12.9,2434,2796,362
26135,MI,Oscoda,,2021,9.1,2391,2630,239
26137,MI,Otsego,,2007,9.3,11174,12323,1149
26137,MI,Otsego,,2008,10.1,10809,12017,1208
26137,MI,Otsego,,2009,14.3,10208,11911,1703
26137,MI,Otsego,,2010,13.8,10123,11748,1625
26137,MI,Otsego,,2011,11.7,10081,11417,1336
26137,MI,Otsego,,2012,10.6,10040,11229,1189
26137,MI,Otsego,,2013,10.3,10094,11256,1162
26137,MI,Otsego,,2014,8.1,10321,11235,914
26137,MI,Otsego,,2015,6.2,10751,11464,713
26137,MI,Otsego,,2016,6,11017,11721,704
26137,MI,Otsego,,2017,5.9,10970,11660,690
26137,MI,Otsego,,2018,5.3,10997,11612,615
26137,MI,Otsego,,2019,5.1,11045,11633,588
26137,MI,Otsego,,2020,10.7,10364,11602,1238
26137,MI,Otsego,,2021,6.8,10579,11351,772
26139,MI,Ottawa,,2007,5.7,127903,135690,7787
26139,MI,Ottawa,,2008,6.9,124815,134006,9191
26139,MI,Ottawa,,2009,12.1,114401,130221,15820
26139,MI,Ottawa,,2010,10,125410,139321,13911
26139,MI,Ottawa,,2011,7.6,128745,139393,10648
26139,MI,Ottawa,,2012,6.5,132919,142161,9242
26139,MI,Ottawa,,2013,6,136483,145244,8761
26139,MI,Ottawa,,2014,4.8,142408,149580,7172
26139,MI,Ottawa,,2015,3.7,147476,153110,5634
26139,MI,Ottawa,,2016,3.4,150491,155788,5297
26139,MI,Ottawa,,2017,3.2,153056,158161,5105
26139,MI,Ottawa,,2018,2.8,156454,161039,4585
26139,MI,Ottawa,,2019,2.8,157317,161861,4544
26139,MI,Ottawa,,2020,7.1,147975,159280,11305
26139,MI,Ottawa,,2021,4.1,150355,156739,6384
26141,MI,Presque Isle,,2007,12.7,5324,6102,778
26141,MI,Presque Isle,,2008,13.6,5192,6011,819
26141,MI,Presque Isle,,2009,18.3,4897,5995,1098
26141,MI,Presque Isle,,2010,16.9,4724,5688,964
26141,MI,Presque Isle,,2011,15.5,4684,5542,858
26141,MI,Presque Isle,,2012,14.3,4758,5554,796
26141,MI,Presque Isle,,2013,14.6,4679,5478,799
26141,MI,Presque Isle,,2014,12.8,4761,5460,699
26141,MI,Presque Isle,,2015,10.3,4831,5387,556
26141,MI,Presque Isle,,2016,9.7,4792,5304,512
26141,MI,Presque Isle,,2017,9.1,4698,5171,473
26141,MI,Presque Isle,,2018,8,4641,5046,405
26141,MI,Presque Isle,,2019,7.7,4573,4952,379
26141,MI,Presque Isle,,2020,11.6,4364,4939,575
26141,MI,Presque Isle,,2021,7.9,4417,4796,379
26143,MI,Roscommon,,2007,9.9,9432,10464,1032
26143,MI,Roscommon,,2008,11,9076,10201,1125
26143,MI,Roscommon,,2009,14.7,8512,9982,1470
26143,MI,Roscommon,,2010,16.2,7172,8556,1384
26143,MI,Roscommon,,2011,14.2,7159,8347,1188
26143,MI,Roscommon,,2012,13.3,7048,8128,1080
26143,MI,Roscommon,,2013,13.8,6991,8106,1115
26143,MI,Roscommon,,2014,11.5,7059,7975,916
26143,MI,Roscommon,,2015,9.1,7131,7849,718
26143,MI,Roscommon,,2016,8.6,7219,7894,675
26143,MI,Roscommon,,2017,8.7,7155,7837,682
26143,MI,Roscommon,,2018,7.8,7245,7862,617
26143,MI,Roscommon,,2019,7.6,7185,7776,591
26143,MI,Roscommon,,2020,12.8,6752,7740,988
26143,MI,Roscommon,,2021,9.6,6679,7388,709
26145,MI,Saginaw,,2007,7.3,89824,96855,7031
26145,MI,Saginaw,,2008,8.4,86261,94180,7919
26145,MI,Saginaw,,2009,12.2,82466,93935,11469
26145,MI,Saginaw,,2010,11.9,79123,89791,10668
26145,MI,Saginaw,,2011,9.8,80762,89529,8767
26145,MI,Saginaw,,2012,9.1,80916,89033,8117
26145,MI,Saginaw,,2013,9,81122,89110,7988
26145,MI,Saginaw,,2014,7.5,82552,89243,6691
26145,MI,Saginaw,,2015,5.8,83622,88751,5129
26145,MI,Saginaw,,2016,5.4,83977,88762,4785
26145,MI,Saginaw,,2017,5.3,83062,87718,4656
26145,MI,Saginaw,,2018,4.8,83005,87179,4174
26145,MI,Saginaw,,2019,4.9,82632,86847,4215
26145,MI,Saginaw,,2020,10.4,75670,84423,8753
26145,MI,Saginaw,,2021,7.1,75566,81321,5755
26147,MI,St. Clair,,2007,8.6,76122,83278,7156
26147,MI,St. Clair,,2008,10.2,73389,81701,8312
26147,MI,St. Clair,,2009,16.8,67469,81118,13649
26147,MI,St. Clair,,2010,15.8,64761,76956,12195
26147,MI,St. Clair,,2011,12.6,64512,73843,9331
26147,MI,St. Clair,,2012,11.7,65253,73906,8653
26147,MI,St. Clair,,2013,11.4,66203,74753,8550
26147,MI,St. Clair,,2014,9.5,66608,73631,7023
26147,MI,St. Clair,,2015,6.7,67674,72569,4895
26147,MI,St. Clair,,2016,6,70103,74615,4512
26147,MI,St. Clair,,2017,5.1,72179,76071,3892
26147,MI,St. Clair,,2018,4.8,72759,76430,3671
26147,MI,St. Clair,,2019,4.8,73476,77195,3719
26147,MI,St. Clair,,2020,11.7,65913,74653,8740
26147,MI,St. Clair,,2021,5.9,69862,74255,4393
26149,MI,St. Joseph,,2007,6.4,29614,31647,2033
26149,MI,St. Joseph,,2008,8.6,27926,30566,2640
26149,MI,St. Joseph,,2009,14.4,24568,28689,4121
26149,MI,St. Joseph,,2010,12.2,24448,27837,3389
26149,MI,St. Joseph,,2011,10.4,24661,27536,2875
26149,MI,St. Joseph,,2012,8.8,25117,27545,2428
26149,MI,St. Joseph,,2013,7.7,26090,28262,2172
26149,MI,St. Joseph,,2014,5.8,27245,28928,1683
26149,MI,St. Joseph,,2015,4.6,27848,29179,1331
26149,MI,St. Joseph,,2016,4.2,27985,29200,1215
26149,MI,St. Joseph,,2017,4.1,27542,28734,1192
26149,MI,St. Joseph,,2018,3.8,27278,28343,1065
26149,MI,St. Joseph,,2019,4.3,26978,28195,1217
26149,MI,St. Joseph,,2020,9.4,26261,28988,2727
26149,MI,St. Joseph,,2021,5.1,26354,27776,1422
26151,MI,Sanilac,,2007,9.1,19810,21801,1991
26151,MI,Sanilac,,2008,11,18814,21139,2325
26151,MI,Sanilac,,2009,17.1,17298,20867,3569
26151,MI,Sanilac,,2010,15,16828,19790,2962
26151,MI,Sanilac,,2011,11.7,17158,19442,2284
26151,MI,Sanilac,,2012,10.4,17363,19373,2010
26151,MI,Sanilac,,2013,10.4,17421,19441,2020
26151,MI,Sanilac,,2014,8.5,18001,19678,1677
26151,MI,Sanilac,,2015,6.6,18310,19601,1291
26151,MI,Sanilac,,2016,6.3,18247,19470,1223
26151,MI,Sanilac,,2017,5.8,18187,19305,1118
26151,MI,Sanilac,,2018,5.2,18247,19248,1001
26151,MI,Sanilac,,2019,4.8,18633,19578,945
26151,MI,Sanilac,,2020,10.1,17443,19398,1955
26151,MI,Sanilac,,2021,6.1,17768,18923,1155
26153,MI,Schoolcraft,,2007,11,3520,3955,435
26153,MI,Schoolcraft,,2008,11.3,3453,3891,438
26153,MI,Schoolcraft,,2009,14.2,3348,3903,555
26153,MI,Schoolcraft,,2010,13.2,3262,3759,497
26153,MI,Schoolcraft,,2011,12.8,3196,3664,468
26153,MI,Schoolcraft,,2012,12.4,3106,3547,441
26153,MI,Schoolcraft,,2013,12.7,3117,3571,454
26153,MI,Schoolcraft,,2014,11,3152,3541,389
26153,MI,Schoolcraft,,2015,11,3096,3477,381
26153,MI,Schoolcraft,,2016,9.2,3087,3399,312
26153,MI,Schoolcraft,,2017,8.2,3084,3360,276
26153,MI,Schoolcraft,,2018,7.2,3128,3371,243
26153,MI,Schoolcraft,,2019,7.2,3067,3304,237
26153,MI,Schoolcraft,,2020,10.2,2909,3238,329
26153,MI,Schoolcraft,,2021,8,2877,3128,251
26155,MI,Shiawassee,,2007,8.3,33126,36125,2999
26155,MI,Shiawassee,,2008,9.8,31855,35309,3454
26155,MI,Shiawassee,,2009,14.5,30047,35150,5103
26155,MI,Shiawassee,,2010,12.5,30015,34314,4299
26155,MI,Shiawassee,,2011,10.3,30032,33488,3456
26155,MI,Shiawassee,,2012,9.5,30073,33217,3144
26155,MI,Shiawassee,,2013,9.3,30022,33103,3081
26155,MI,Shiawassee,,2014,7.6,30742,33256,2514
26155,MI,Shiawassee,,2015,5.7,31263,33167,1904
26155,MI,Shiawassee,,2016,5.3,31723,33510,1787
26155,MI,Shiawassee,,2017,5.1,31679,33374,1695
26155,MI,Shiawassee,,2018,4.3,31799,33244,1445
26155,MI,Shiawassee,,2019,4.3,32011,33464,1453
26155,MI,Shiawassee,,2020,9.5,29589,32699,3110
26155,MI,Shiawassee,,2021,5.7,29908,31704,1796
26157,MI,Tuscola,,2007,8.5,26132,28573,2441
26157,MI,Tuscola,,2008,10.1,25041,27852,2811
26157,MI,Tuscola,,2009,15.5,23510,27823,4313
26157,MI,Tuscola,,2010,14.3,22061,25755,3694
26157,MI,Tuscola,,2011,11.5,22162,25054,2892
26157,MI,Tuscola,,2012,10.4,22154,24738,2584
26157,MI,Tuscola,,2013,10.4,22467,25087,2620
26157,MI,Tuscola,,2014,8.6,22988,25150,2162
26157,MI,Tuscola,,2015,6.8,22933,24606,1673
26157,MI,Tuscola,,2016,6.4,22711,24253,1542
26157,MI,Tuscola,,2017,6.1,22467,23934,1467
26157,MI,Tuscola,,2018,5.5,22465,23775,1310
26157,MI,Tuscola,,2019,5.2,22674,23912,1238
26157,MI,Tuscola,,2020,10.5,21121,23597,2476
26157,MI,Tuscola,,2021,6.3,21236,22658,1422
26159,MI,Van Buren,,2007,7.1,37319,40152,2833
26159,MI,Van Buren,,2008,8.1,36661,39896,3235
26159,MI,Van Buren,,2009,12.4,34768,39712,4944
26159,MI,Van Buren,,2010,13.1,32504,37401,4897
26159,MI,Van Buren,,2011,11.1,32314,36340,4026
26159,MI,Van Buren,,2012,10.4,31658,35338,3680
26159,MI,Van Buren,,2013,10,31607,35114,3507
26159,MI,Van Buren,,2014,8.1,32578,35436,2858
26159,MI,Van Buren,,2015,6.4,33157,35409,2252
26159,MI,Van Buren,,2016,5.8,33502,35566,2064
26159,MI,Van Buren,,2017,5.6,33319,35298,1979
26159,MI,Van Buren,,2018,4.9,33401,35136,1735
26159,MI,Van Buren,,2019,4.6,33716,35353,1637
26159,MI,Van Buren,,2020,8.7,31642,34675,3033
26159,MI,Van Buren,,2021,6.1,31794,33843,2049
26161,MI,Washtenaw,,2007,4.9,178913,188162,9249
26161,MI,Washtenaw,,2008,5.7,175542,186154,10612
26161,MI,Washtenaw,,2009,8.4,168878,184354,15476
26161,MI,Washtenaw,,2010,7.9,167031,181304,14273
26161,MI,Washtenaw,,2011,6.5,168847,180647,11800
26161,MI,Washtenaw,,2012,5.9,171675,182378,10703
26161,MI,Washtenaw,,2013,5.8,173862,184506,10644
26161,MI,Washtenaw,,2014,4.9,178470,187616,9146
26161,MI,Washtenaw,,2015,3.8,182177,189301,7124
26161,MI,Washtenaw,,2016,3.7,184914,192000,7086
26161,MI,Washtenaw,,2017,3.5,187585,194316,6731
26161,MI,Washtenaw,,2018,3.1,190241,196277,6036
26161,MI,Washtenaw,,2019,2.9,193127,198915,5788
26161,MI,Washtenaw,,2020,6.7,180109,193121,13012
26161,MI,Washtenaw,,2021,4.3,181350,189511,8161
26163,MI,Wayne,,2007,8.4,804318,878104,73786
26163,MI,Wayne,,2008,9.7,779638,863168,83530
26163,MI,Wayne,,2009,15.4,726528,858770,132242
26163,MI,Wayne,,2010,15,676615,795744,119129
26163,MI,Wayne,,2011,12.5,674201,770687,96486
26163,MI,Wayne,,2012,11.7,683411,773587,90176
26163,MI,Wayne,,2013,11.4,689531,778327,88796
26163,MI,Wayne,,2014,9.6,694103,767640,73537
26163,MI,Wayne,,2015,6.8,704576,756308,51732
26163,MI,Wayne,,2016,6.2,730549,778939,48390
26163,MI,Wayne,,2017,5.5,756569,800940,44371
26163,MI,Wayne,,2018,5.2,766155,808388,42233
26163,MI,Wayne,,2019,5,776312,817145,40833
26163,MI,Wayne,,2020,13.5,693025,801382,108357
26163,MI,Wayne,,2021,8,734140,797703,63563
26165,MI,Wexford,,2007,8.7,13307,14577,1270
26165,MI,Wexford,,2008,10.9,12746,14311,1565
26165,MI,Wexford,,2009,17.2,11906,14371,2465
26165,MI,Wexford,,2010,14,12950,15059,2109
26165,MI,Wexford,,2011,11.7,12900,14610,1710
26165,MI,Wexford,,2012,10.9,12943,14523,1580
26165,MI,Wexford,,2013,11,13063,14675,1612
26165,MI,Wexford,,2014,8.6,13463,14724,1261
26165,MI,Wexford,,2015,6.8,13647,14648,1001
26165,MI,Wexford,,2016,5.9,13868,14741,873
26165,MI,Wexford,,2017,5.5,13966,14778,812
26165,MI,Wexford,,2018,4.7,14043,14739,696
26165,MI,Wexford,,2019,4.6,14179,14862,683
26165,MI,Wexford,,2020,10.6,13293,14866,1573
26165,MI,Wexford,,2021,6,13694,14561,867
27000,MN,Minnesota,,2007,4.6,2765611,2898861,133250
27000,MN,Minnesota,,2008,5.4,2756573,2914133,157560
27000,MN,Minnesota,,2009,7.9,2699974,2932056,232082
27000,MN,Minnesota,,2010,7.4,2722623,2940696,218073
27000,MN,Minnesota,,2011,6.5,2760400,2952527,192127
27000,MN,Minnesota,,2012,5.6,2783181,2949770,166589
27000,MN,Minnesota,,2013,5,2812453,2961729,149276
27000,MN,Minnesota,,2014,4.3,2852488,2979798,127310
27000,MN,Minnesota,,2015,3.8,2891673,3005414,113741
27000,MN,Minnesota,,2016,3.9,2906348,3023110,116762
27000,MN,Minnesota,,2017,3.5,2963830,3071006,107176
27000,MN,Minnesota,,2018,3.1,2989055,3085627,96572
27000,MN,Minnesota,,2019,3.4,3021984,3129844,107860
27000,MN,Minnesota,,2020,6.3,2925515,3122981,197466
27000,MN,Minnesota,,2021,3.4,2918393,3021360,102967
27001,MN,Aitkin,,2007,6.8,7172,7699,527
27001,MN,Aitkin,,2008,8.1,7036,7652,616
27001,MN,Aitkin,,2009,10.5,6892,7698,806
27001,MN,Aitkin,,2010,10.4,6553,7315,762
27001,MN,Aitkin,,2011,9.6,6443,7128,685
27001,MN,Aitkin,,2012,8.1,6350,6913,563
27001,MN,Aitkin,,2013,7.6,6297,6812,515
27001,MN,Aitkin,,2014,6.8,6328,6792,464
27001,MN,Aitkin,,2015,6.7,6432,6893,461
27001,MN,Aitkin,,2016,7,6531,7024,493
27001,MN,Aitkin,,2017,6.3,6757,7210,453
27001,MN,Aitkin,,2018,6,6797,7230,433
27001,MN,Aitkin,,2019,6.5,6892,7375,483
27001,MN,Aitkin,,2020,8.4,6889,7521,632
27001,MN,Aitkin,,2021,4.7,6904,7244,340
27003,MN,Anoka,,2007,4.6,180465,189109,8644
27003,MN,Anoka,,2008,5.4,178872,189160,10288
27003,MN,Anoka,,2009,8.5,174077,190279,16202
27003,MN,Anoka,,2010,8,172432,187507,15075
27003,MN,Anoka,,2011,6.9,174542,187418,12876
27003,MN,Anoka,,2012,5.9,176355,187476,11121
27003,MN,Anoka,,2013,5.1,178948,188571,9623
27003,MN,Anoka,,2014,4.2,181414,189457,8043
27003,MN,Anoka,,2015,3.7,183267,190298,7031
27003,MN,Anoka,,2016,3.7,184641,191787,7146
27003,MN,Anoka,,2017,3.4,189568,196203,6635
27003,MN,Anoka,,2018,3,191702,197594,5892
27003,MN,Anoka,,2019,3.3,194536,201114,6578
27003,MN,Anoka,,2020,6.5,187963,201039,13076
27003,MN,Anoka,,2021,3.4,188434,195027,6593
27005,MN,Becker,,2007,5.8,15842,16809,967
27005,MN,Becker,,2008,6.7,15617,16746,1129
27005,MN,Becker,,2009,8.7,15720,17224,1504
27005,MN,Becker,,2010,7.9,16218,17614,1396
27005,MN,Becker,,2011,7.2,16481,17753,1272
27005,MN,Becker,,2012,5.8,16848,17894,1046
27005,MN,Becker,,2013,5.6,16988,17989,1001
27005,MN,Becker,,2014,4.9,17140,18019,879
27005,MN,Becker,,2015,4.5,17621,18445,824
27005,MN,Becker,,2016,4.6,17699,18547,848
27005,MN,Becker,,2017,4.2,17864,18650,786
27005,MN,Becker,,2018,3.8,17986,18699,713
27005,MN,Becker,,2019,4.2,18211,19008,797
27005,MN,Becker,,2020,6.4,17812,19037,1225
27005,MN,Becker,,2021,3.4,18057,18683,626
27007,MN,Beltrami,,2007,6.1,19839,21121,1282
27007,MN,Beltrami,,2008,6.9,19663,21117,1454
27007,MN,Beltrami,,2009,8.8,19728,21631,1903
27007,MN,Beltrami,,2010,8.2,20748,22609,1861
27007,MN,Beltrami,,2011,8.2,20688,22543,1855
27007,MN,Beltrami,,2012,7,21261,22872,1611
27007,MN,Beltrami,,2013,6.3,21593,23055,1462
27007,MN,Beltrami,,2014,5.4,22096,23369,1273
27007,MN,Beltrami,,2015,5,22384,23565,1181
27007,MN,Beltrami,,2016,5.2,22427,23662,1235
27007,MN,Beltrami,,2017,4.9,22597,23766,1169
27007,MN,Beltrami,,2018,4.4,23218,24284,1066
27007,MN,Beltrami,,2019,4.5,23551,24670,1119
27007,MN,Beltrami,,2020,6.5,23386,25012,1626
27007,MN,Beltrami,,2021,3.7,23050,23933,883
27009,MN,Benton,,2007,5,21728,22877,1149
27009,MN,Benton,,2008,6,21617,23006,1389
27009,MN,Benton,,2009,8.6,21172,23169,1997
27009,MN,Benton,,2010,8.7,19273,21119,1846
27009,MN,Benton,,2011,7.6,19681,21298,1617
27009,MN,Benton,,2012,6.4,19859,21224,1365
27009,MN,Benton,,2013,6,20172,21463,1291
27009,MN,Benton,,2014,5.2,20638,21763,1125
27009,MN,Benton,,2015,4.5,20662,21644,982
27009,MN,Benton,,2016,4.4,20803,21764,961
27009,MN,Benton,,2017,4.1,20943,21836,893
27009,MN,Benton,,2018,3.7,21127,21945,818
27009,MN,Benton,,2019,4.1,21293,22214,921
27009,MN,Benton,,2020,6.8,20675,22187,1512
27009,MN,Benton,,2021,4.3,20405,21312,907
27011,MN,Big Stone,,2007,4.8,2660,2794,134
27011,MN,Big Stone,,2008,5.5,2639,2793,154
27011,MN,Big Stone,,2009,5.9,2761,2933,172
27011,MN,Big Stone,,2010,6.5,2723,2912,189
27011,MN,Big Stone,,2011,6.5,2721,2909,188
27011,MN,Big Stone,,2012,5.3,2684,2834,150
27011,MN,Big Stone,,2013,5.5,2420,2560,140
27011,MN,Big Stone,,2014,4.5,2481,2599,118
27011,MN,Big Stone,,2015,4.5,2567,2689,122
27011,MN,Big Stone,,2016,4.8,2572,2702,130
27011,MN,Big Stone,,2017,4.5,2467,2582,115
27011,MN,Big Stone,,2018,4.1,2412,2514,102
27011,MN,Big Stone,,2019,4.4,2404,2515,111
27011,MN,Big Stone,,2020,4.9,2430,2556,126
27011,MN,Big Stone,,2021,3.5,2312,2395,83
27013,MN,Blue Earth,,2007,3.8,34921,36290,1369
27013,MN,Blue Earth,,2008,4.4,35646,37279,1633
27013,MN,Blue Earth,,2009,6.5,35214,37679,2465
27013,MN,Blue Earth,,2010,6.4,35705,38142,2437
27013,MN,Blue Earth,,2011,5.4,36313,38398,2085
27013,MN,Blue Earth,,2012,4.8,36507,38360,1853
27013,MN,Blue Earth,,2013,4.2,37026,38655,1629
27013,MN,Blue Earth,,2014,3.5,37258,38618,1360
27013,MN,Blue Earth,,2015,3,38277,39466,1189
27013,MN,Blue Earth,,2016,3.2,38325,39595,1270
27013,MN,Blue Earth,,2017,2.9,39023,40207,1184
27013,MN,Blue Earth,,2018,2.7,39389,40480,1091
27013,MN,Blue Earth,,2019,2.9,39868,41079,1211
27013,MN,Blue Earth,,2020,5.5,38576,40820,2244
27013,MN,Blue Earth,,2021,3.1,37981,39179,1198
27015,MN,Brown,,2007,4.9,13925,14638,713
27015,MN,Brown,,2008,6,13960,14848,888
27015,MN,Brown,,2009,7.4,13895,15013,1118
27015,MN,Brown,,2010,6.9,14071,15114,1043
27015,MN,Brown,,2011,5.9,14184,15075,891
27015,MN,Brown,,2012,5.7,13992,14834,842
27015,MN,Brown,,2013,5.3,13772,14539,767
27015,MN,Brown,,2014,4.7,13561,14225,664
27015,MN,Brown,,2015,4.2,14043,14655,612
27015,MN,Brown,,2016,4.2,13904,14512,608
27015,MN,Brown,,2017,3.7,13905,14446,541
27015,MN,Brown,,2018,3.6,14023,14546,523
27015,MN,Brown,,2019,3.8,13976,14534,558
27015,MN,Brown,,2020,5.3,13543,14303,760
27015,MN,Brown,,2021,3.1,13014,13430,416
27017,MN,Carlton,,2007,5.7,16184,17165,981
27017,MN,Carlton,,2008,6.6,16219,17372,1153
27017,MN,Carlton,,2009,8.6,15999,17510,1511
27017,MN,Carlton,,2010,8.3,16312,17797,1485
27017,MN,Carlton,,2011,7.6,16316,17659,1343
27017,MN,Carlton,,2012,6.9,16283,17491,1208
27017,MN,Carlton,,2013,6.1,16466,17531,1065
27017,MN,Carlton,,2014,5.4,16686,17632,946
27017,MN,Carlton,,2015,5,16732,17617,885
27017,MN,Carlton,,2016,5.3,16791,17731,940
27017,MN,Carlton,,2017,4.8,16925,17776,851
27017,MN,Carlton,,2018,4.4,17136,17923,787
27017,MN,Carlton,,2019,4.7,17246,18104,858
27017,MN,Carlton,,2020,7.4,16497,17824,1327
27017,MN,Carlton,,2021,4,16421,17106,685
27019,MN,Carver,,2007,4,47560,49527,1967
27019,MN,Carver,,2008,4.9,47862,50316,2454
27019,MN,Carver,,2009,7.4,47001,50744,3743
27019,MN,Carver,,2010,6.7,48173,51658,3485
27019,MN,Carver,,2011,5.5,49344,52236,2892
27019,MN,Carver,,2012,4.9,49934,52484,2550
27019,MN,Carver,,2013,4.4,51033,53369,2336
27019,MN,Carver,,2014,3.7,52377,54396,2019
27019,MN,Carver,,2015,3.2,53510,55301,1791
27019,MN,Carver,,2016,3.3,54436,56292,1856
27019,MN,Carver,,2017,3,55976,57678,1702
27019,MN,Carver,,2018,2.6,56995,58539,1544
27019,MN,Carver,,2019,2.9,58192,59957,1765
27019,MN,Carver,,2020,5.3,56622,59781,3159
27019,MN,Carver,,2021,2.7,56606,58187,1581
27021,MN,Cass,,2007,7.2,13205,14226,1021
27021,MN,Cass,,2008,8.6,12909,14121,1212
27021,MN,Cass,,2009,10.8,12574,14100,1526
27021,MN,Cass,,2010,10.6,12872,14399,1527
27021,MN,Cass,,2011,10.1,12754,14183,1429
27021,MN,Cass,,2012,8.9,12632,13872,1240
27021,MN,Cass,,2013,8.3,12844,14012,1168
27021,MN,Cass,,2014,7.3,13011,14032,1021
27021,MN,Cass,,2015,6.8,13112,14073,961
27021,MN,Cass,,2016,6.8,13183,14150,967
27021,MN,Cass,,2017,6,13550,14417,867
27021,MN,Cass,,2018,5.5,13579,14370,791
27021,MN,Cass,,2019,5.9,13735,14590,855
27021,MN,Cass,,2020,9.3,13194,14551,1357
27021,MN,Cass,,2021,4.4,14909,15598,689
27023,MN,Chippewa,,2007,4.3,6748,7053,305
27023,MN,Chippewa,,2008,5.2,6741,7110,369
27023,MN,Chippewa,,2009,7.9,6699,7274,575
27023,MN,Chippewa,,2010,7.3,6631,7157,526
27023,MN,Chippewa,,2011,6.3,6743,7199,456
27023,MN,Chippewa,,2012,5.3,6690,7067,377
27023,MN,Chippewa,,2013,5.2,6590,6953,363
27023,MN,Chippewa,,2014,4.6,6592,6913,321
27023,MN,Chippewa,,2015,4.5,6651,6963,312
27023,MN,Chippewa,,2016,4.5,6648,6963,315
27023,MN,Chippewa,,2017,4,6678,6957,279
27023,MN,Chippewa,,2018,3.4,6677,6913,236
27023,MN,Chippewa,,2019,4.1,6687,6975,288
27023,MN,Chippewa,,2020,5.3,6443,6802,359
27023,MN,Chippewa,,2021,3,6271,6462,191
27025,MN,Chisago,,2007,5.9,25681,27278,1597
27025,MN,Chisago,,2008,6.8,25454,27311,1857
27025,MN,Chisago,,2009,10.1,24616,27380,2764
27025,MN,Chisago,,2010,8.9,26721,29333,2612
27025,MN,Chisago,,2011,7.6,26827,29046,2219
27025,MN,Chisago,,2012,6.6,26703,28593,1890
27025,MN,Chisago,,2013,5.7,26939,28557,1618
27025,MN,Chisago,,2014,4.8,27270,28651,1381
27025,MN,Chisago,,2015,4.3,27577,28805,1228
27025,MN,Chisago,,2016,4.3,27869,29128,1259
27025,MN,Chisago,,2017,4,28431,29617,1186
27025,MN,Chisago,,2018,3.6,28863,29938,1075
27025,MN,Chisago,,2019,4,29380,30603,1223
27025,MN,Chisago,,2020,6.8,28317,30383,2066
27025,MN,Chisago,,2021,3.7,28335,29423,1088
27027,MN,Clay,,2007,3.5,30112,31196,1084
27027,MN,Clay,,2008,3.7,30943,32127,1184
27027,MN,Clay,,2009,4.9,31045,32641,1596
27027,MN,Clay,,2010,5.6,32025,33907,1882
27027,MN,Clay,,2011,5.6,32764,34698,1934
27027,MN,Clay,,2012,4.9,33358,35061,1703
27027,MN,Clay,,2013,4.4,33345,34862,1517
27027,MN,Clay,,2014,3.5,34076,35306,1230
27027,MN,Clay,,2015,3.2,34494,35623,1129
27027,MN,Clay,,2016,3.4,34368,35591,1223
27027,MN,Clay,,2017,3.2,34662,35826,1164
27027,MN,Clay,,2018,3.1,34714,35816,1102
27027,MN,Clay,,2019,3.2,35325,36506,1181
27027,MN,Clay,,2020,4.4,34987,36616,1629
27027,MN,Clay,,2021,2.7,35108,36092,984
27029,MN,Clearwater,,2007,10.3,3465,3864,399
27029,MN,Clearwater,,2008,11.4,3570,4030,460
27029,MN,Clearwater,,2009,15,3587,4218,631
27029,MN,Clearwater,,2010,13.1,3990,4594,604
27029,MN,Clearwater,,2011,11.9,4037,4583,546
27029,MN,Clearwater,,2012,10.6,3947,4416,469
27029,MN,Clearwater,,2013,10.8,3998,4481,483
27029,MN,Clearwater,,2014,10.7,4075,4562,487
27029,MN,Clearwater,,2015,9.3,4214,4644,430
27029,MN,Clearwater,,2016,9.6,4260,4713,453
27029,MN,Clearwater,,2017,8.9,4215,4625,410
27029,MN,Clearwater,,2018,8.6,4111,4499,388
27029,MN,Clearwater,,2019,8.7,4136,4531,395
27029,MN,Clearwater,,2020,10.1,4101,4562,461
27029,MN,Clearwater,,2021,5.8,4153,4409,256
27031,MN,Cook,,2007,4.9,2973,3125,152
27031,MN,Cook,,2008,5.6,2937,3110,173
27031,MN,Cook,,2009,7.1,2884,3106,222
27031,MN,Cook,,2010,7.2,2839,3059,220
27031,MN,Cook,,2011,6.9,2848,3058,210
27031,MN,Cook,,2012,6.3,2860,3052,192
27031,MN,Cook,,2013,5.9,2878,3058,180
27031,MN,Cook,,2014,5.8,2888,3065,177
27031,MN,Cook,,2015,4.5,3020,3162,142
27031,MN,Cook,,2016,4.6,2952,3093,141
27031,MN,Cook,,2017,3.9,3001,3122,121
27031,MN,Cook,,2018,3.7,2947,3059,112
27031,MN,Cook,,2019,4.6,3012,3156,144
27031,MN,Cook,,2020,8.5,2753,3009,256
27031,MN,Cook,,2021,4.5,2738,2867,129
27033,MN,Cottonwood,,2007,4.1,5991,6244,253
27033,MN,Cottonwood,,2008,5.2,5938,6266,328
27033,MN,Cottonwood,,2009,6.4,6040,6453,413
27033,MN,Cottonwood,,2010,6.5,5825,6232,407
27033,MN,Cottonwood,,2011,6.2,5773,6153,380
27033,MN,Cottonwood,,2012,6.5,5565,5954,389
27033,MN,Cottonwood,,2013,5.9,5423,5763,340
27033,MN,Cottonwood,,2014,5.4,5295,5596,301
27033,MN,Cottonwood,,2015,4.9,5521,5804,283
27033,MN,Cottonwood,,2016,7.2,5134,5530,396
27033,MN,Cottonwood,,2017,5.3,5441,5743,302
27033,MN,Cottonwood,,2018,3.8,5610,5833,223
27033,MN,Cottonwood,,2019,3.9,5750,5985,235
27033,MN,Cottonwood,,2020,4.9,6062,6371,309
27033,MN,Cottonwood,,2021,3.4,6193,6409,216
27035,MN,Crow Wing,,2007,5.6,30802,32637,1835
27035,MN,Crow Wing,,2008,6.9,30357,32613,2256
27035,MN,Crow Wing,,2009,9.8,30039,33314,3275
27035,MN,Crow Wing,,2010,9.5,28999,32059,3060
27035,MN,Crow Wing,,2011,8.8,28852,31635,2783
27035,MN,Crow Wing,,2012,7.7,28558,30955,2397
27035,MN,Crow Wing,,2013,7,29262,31476,2214
27035,MN,Crow Wing,,2014,6,29665,31559,1894
27035,MN,Crow Wing,,2015,5.3,29920,31582,1662
27035,MN,Crow Wing,,2016,5.1,30198,31820,1622
27035,MN,Crow Wing,,2017,4.5,30905,32366,1461
27035,MN,Crow Wing,,2018,4.2,30967,32332,1365
27035,MN,Crow Wing,,2019,4.6,31138,32642,1504
27035,MN,Crow Wing,,2020,7.4,30117,32536,2419
27035,MN,Crow Wing,,2021,4,30555,31834,1279
27037,MN,Dakota,,2007,4.1,219810,229164,9354
27037,MN,Dakota,,2008,4.9,218579,229798,11219
27037,MN,Dakota,,2009,7.3,211839,228603,16764
27037,MN,Dakota,,2010,7,211524,227404,15880
27037,MN,Dakota,,2011,6.1,214573,228418,13845
27037,MN,Dakota,,2012,5.3,216288,228280,11992
27037,MN,Dakota,,2013,4.6,219363,229949,10586
27037,MN,Dakota,,2014,3.9,223040,232013,8973
27037,MN,Dakota,,2015,3.4,224956,232810,7854
27037,MN,Dakota,,2016,3.4,226978,234941,7963
27037,MN,Dakota,,2017,3.1,231802,239126,7324
27037,MN,Dakota,,2018,2.7,234826,241422,6596
27037,MN,Dakota,,2019,3.1,238218,245765,7547
27037,MN,Dakota,,2020,6.3,229690,245146,15456
27037,MN,Dakota,,2021,3.1,230287,237756,7469
27039,MN,Dodge,,2007,4.3,10521,10999,478
27039,MN,Dodge,,2008,5.2,10430,11000,570
27039,MN,Dodge,,2009,7.5,10258,11092,834
27039,MN,Dodge,,2010,6.9,10530,11315,785
27039,MN,Dodge,,2011,6,10578,11259,681
27039,MN,Dodge,,2012,5.1,10776,11352,576
27039,MN,Dodge,,2013,4.8,10797,11342,545
27039,MN,Dodge,,2014,4.3,10794,11274,480
27039,MN,Dodge,,2015,3.8,11043,11480,437
27039,MN,Dodge,,2016,3.7,11120,11549,429
27039,MN,Dodge,,2017,3.4,11353,11753,400
27039,MN,Dodge,,2018,3.2,11444,11825,381
27039,MN,Dodge,,2019,3.6,11588,12020,432
27039,MN,Dodge,,2020,5.5,11451,12122,671
27039,MN,Dodge,,2021,3.1,11371,11735,364
27041,MN,Douglas,,2007,4.4,19098,19987,889
27041,MN,Douglas,,2008,4.9,19284,20288,1004
27041,MN,Douglas,,2009,6.8,19292,20694,1402
27041,MN,Douglas,,2010,6.8,18481,19833,1352
27041,MN,Douglas,,2011,6.1,18618,19823,1205
27041,MN,Douglas,,2012,5.1,18825,19831,1006
27041,MN,Douglas,,2013,4.5,18996,19892,896
27041,MN,Douglas,,2014,3.8,19157,19917,760
27041,MN,Douglas,,2015,3.5,19478,20182,704
27041,MN,Douglas,,2016,3.5,19513,20218,705
27041,MN,Douglas,,2017,3.2,19961,20623,662
27041,MN,Douglas,,2018,3,20071,20697,626
27041,MN,Douglas,,2019,3.4,20560,21276,716
27041,MN,Douglas,,2020,4.9,20352,21402,1050
27041,MN,Douglas,,2021,2.8,20304,20894,590
27043,MN,Faribault,,2007,5.3,7348,7757,409
27043,MN,Faribault,,2008,6.2,7241,7721,480
27043,MN,Faribault,,2009,9.3,6971,7690,719
27043,MN,Faribault,,2010,8,7211,7837,626
27043,MN,Faribault,,2011,7.1,7255,7811,556
27043,MN,Faribault,,2012,5.9,7323,7780,457
27043,MN,Faribault,,2013,5.5,7092,7503,411
27043,MN,Faribault,,2014,5.3,6998,7393,395
27043,MN,Faribault,,2015,4.5,7185,7521,336
27043,MN,Faribault,,2016,4.4,6995,7316,321
27043,MN,Faribault,,2017,4.2,6870,7173,303
27043,MN,Faribault,,2018,3.7,6764,7024,260
27043,MN,Faribault,,2019,4.4,6794,7107,313
27043,MN,Faribault,,2020,6.3,6704,7157,453
27043,MN,Faribault,,2021,3.8,6548,6806,258
27045,MN,Fillmore,,2007,5.1,10560,11129,569
27045,MN,Fillmore,,2008,6.1,10265,10928,663
27045,MN,Fillmore,,2009,8.2,10308,11234,926
27045,MN,Fillmore,,2010,7.5,10408,11256,848
27045,MN,Fillmore,,2011,6.7,10499,11249,750
27045,MN,Fillmore,,2012,5.6,10658,11287,629
27045,MN,Fillmore,,2013,5.1,10551,11117,566
27045,MN,Fillmore,,2014,4.5,10553,11050,497
27045,MN,Fillmore,,2015,4.2,10956,11432,476
27045,MN,Fillmore,,2016,4,11028,11492,464
27045,MN,Fillmore,,2017,3.5,11059,11465,406
27045,MN,Fillmore,,2018,3.3,11150,11534,384
27045,MN,Fillmore,,2019,3.5,11237,11647,410
27045,MN,Fillmore,,2020,5.2,11137,11754,617
27045,MN,Fillmore,,2021,3,10949,11282,333
27047,MN,Freeborn,,2007,5,15485,16294,809
27047,MN,Freeborn,,2008,5.7,15362,16285,923
27047,MN,Freeborn,,2009,8.6,15061,16474,1413
27047,MN,Freeborn,,2010,7.7,15775,17097,1322
27047,MN,Freeborn,,2011,6.7,15949,17088,1139
27047,MN,Freeborn,,2012,5.8,15719,16695,976
27047,MN,Freeborn,,2013,5.1,15643,16476,833
27047,MN,Freeborn,,2014,4.4,15561,16283,722
27047,MN,Freeborn,,2015,3.9,15751,16383,632
27047,MN,Freeborn,,2016,3.8,15654,16276,622
27047,MN,Freeborn,,2017,3.7,15622,16220,598
27047,MN,Freeborn,,2018,3.4,15549,16100,551
27047,MN,Freeborn,,2019,3.7,15683,16279,596
27047,MN,Freeborn,,2020,5.8,15365,16311,946
27047,MN,Freeborn,,2021,3.5,14811,15344,533
27049,MN,Goodhue,,2007,5,23699,24939,1240
27049,MN,Goodhue,,2008,5.7,23627,25044,1417
27049,MN,Goodhue,,2009,7.8,23645,25636,1991
27049,MN,Goodhue,,2010,7,24866,26751,1885
27049,MN,Goodhue,,2011,6,25365,26988,1623
27049,MN,Goodhue,,2012,5.2,25351,26740,1389
27049,MN,Goodhue,,2013,4.8,25571,26849,1278
27049,MN,Goodhue,,2014,4,25707,26788,1081
27049,MN,Goodhue,,2015,3.6,25974,26942,968
27049,MN,Goodhue,,2016,3.7,25833,26830,997
27049,MN,Goodhue,,2017,3.3,26092,26970,878
27049,MN,Goodhue,,2018,2.9,26107,26900,793
27049,MN,Goodhue,,2019,3.3,26406,27294,888
27049,MN,Goodhue,,2020,6,25281,26889,1608
27049,MN,Goodhue,,2021,3.2,25176,26010,834
27051,MN,Grant,,2007,5.9,2832,3011,179
27051,MN,Grant,,2008,7,2828,3042,214
27051,MN,Grant,,2009,8.5,2895,3164,269
27051,MN,Grant,,2010,8,3131,3402,271
27051,MN,Grant,,2011,6.9,3148,3383,235
27051,MN,Grant,,2012,6.2,3135,3341,206
27051,MN,Grant,,2013,5.8,3095,3286,191
27051,MN,Grant,,2014,5.1,3122,3289,167
27051,MN,Grant,,2015,4.8,3194,3355,161
27051,MN,Grant,,2016,4.7,3131,3285,154
27051,MN,Grant,,2017,4.1,3160,3296,136
27051,MN,Grant,,2018,4.3,3174,3315,141
27051,MN,Grant,,2019,4.7,3192,3350,158
27051,MN,Grant,,2020,5.5,3180,3365,185
27051,MN,Grant,,2021,3.7,3092,3210,118
27053,MN,Hennepin,,2007,4.1,627171,653958,26787
27053,MN,Hennepin,,2008,4.9,622437,654479,32042
27053,MN,Hennepin,,2009,7.4,605520,653860,48340
27053,MN,Hennepin,,2010,7,605608,651084,45476
27053,MN,Hennepin,,2011,6.1,617481,657377,39896
27053,MN,Hennepin,,2012,5.3,625770,660564,34794
27053,MN,Hennepin,,2013,4.7,636456,667509,31053
27053,MN,Hennepin,,2014,3.9,647791,673912,26121
27053,MN,Hennepin,,2015,3.4,655614,678387,22773
27053,MN,Hennepin,,2016,3.3,662298,685106,22808
27053,MN,Hennepin,,2017,3.1,680190,701697,21507
27053,MN,Hennepin,,2018,2.7,687099,706043,18944
27053,MN,Hennepin,,2019,3,694727,715907,21180
27053,MN,Hennepin,,2020,6.7,667542,715240,47698
27053,MN,Hennepin,,2021,3.4,669687,693393,23706
27055,MN,Houston,,2007,5.1,10393,10951,558
27055,MN,Houston,,2008,5.7,10246,10870,624
27055,MN,Houston,,2009,8.1,10084,10974,890
27055,MN,Houston,,2010,7.7,10005,10840,835
27055,MN,Houston,,2011,6.9,9948,10688,740
27055,MN,Houston,,2012,5.8,9964,10583,619
27055,MN,Houston,,2013,5.1,9955,10488,533
27055,MN,Houston,,2014,4.5,9909,10379,470
27055,MN,Houston,,2015,3.9,10100,10509,409
27055,MN,Houston,,2016,3.9,10179,10593,414
27055,MN,Houston,,2017,3.5,10140,10504,364
27055,MN,Houston,,2018,3.1,10120,10441,321
27055,MN,Houston,,2019,3.4,10148,10506,358
27055,MN,Houston,,2020,4.5,9952,10416,464
27055,MN,Houston,,2021,2.9,9868,10158,290
27057,MN,Hubbard,,2007,6.4,8578,9166,588
27057,MN,Hubbard,,2008,7.5,8808,9526,718
27057,MN,Hubbard,,2009,10.1,8576,9544,968
27057,MN,Hubbard,,2010,9.9,8789,9759,970
27057,MN,Hubbard,,2011,9.2,8654,9532,878
27057,MN,Hubbard,,2012,8.1,8779,9551,772
27057,MN,Hubbard,,2013,7.3,8847,9545,698
27057,MN,Hubbard,,2014,6.5,8844,9462,618
27057,MN,Hubbard,,2015,6.3,8984,9583,599
27057,MN,Hubbard,,2016,6.5,9154,9790,636
27057,MN,Hubbard,,2017,5.7,9309,9868,559
27057,MN,Hubbard,,2018,5.3,9403,9931,528
27057,MN,Hubbard,,2019,5.7,9530,10109,579
27057,MN,Hubbard,,2020,7.3,9335,10068,733
27057,MN,Hubbard,,2021,4.1,9571,9978,407
27059,MN,Isanti,,2007,6,20337,21635,1298
27059,MN,Isanti,,2008,6.9,20202,21697,1495
27059,MN,Isanti,,2009,10.2,19561,21793,2232
27059,MN,Isanti,,2010,9.6,18592,20577,1985
27059,MN,Isanti,,2011,8.3,18910,20631,1721
27059,MN,Isanti,,2012,7,18942,20376,1434
27059,MN,Isanti,,2013,6.1,18994,20226,1232
27059,MN,Isanti,,2014,5.2,19238,20287,1049
27059,MN,Isanti,,2015,4.4,19358,20248,890
27059,MN,Isanti,,2016,4.7,19697,20661,964
27059,MN,Isanti,,2017,4.4,20179,21097,918
27059,MN,Isanti,,2018,4,20460,21309,849
27059,MN,Isanti,,2019,4.3,20908,21843,935
27059,MN,Isanti,,2020,6.9,20462,21987,1525
27059,MN,Isanti,,2021,4.1,20476,21344,868
27061,MN,Itasca,,2007,7.3,20576,22196,1620
27061,MN,Itasca,,2008,7.9,20405,22144,1739
27061,MN,Itasca,,2009,11,20321,22824,2503
27061,MN,Itasca,,2010,10.2,20225,22514,2289
27061,MN,Itasca,,2011,9.1,20516,22573,2057
27061,MN,Itasca,,2012,7.9,20517,22279,1762
27061,MN,Itasca,,2013,7.8,20243,21954,1711
27061,MN,Itasca,,2014,6.8,20526,22015,1489
27061,MN,Itasca,,2015,6.6,20884,22367,1483
27061,MN,Itasca,,2016,8.5,20132,22014,1882
27061,MN,Itasca,,2017,7,20312,21850,1538
27061,MN,Itasca,,2018,5.8,20653,21921,1268
27061,MN,Itasca,,2019,6.3,20823,22223,1400
27061,MN,Itasca,,2020,8.8,20337,22295,1958
27061,MN,Itasca,,2021,4.7,20154,21147,993
27063,MN,Jackson,,2007,3.9,6262,6515,253
27063,MN,Jackson,,2008,4.2,6321,6597,276
27063,MN,Jackson,,2009,5.5,6565,6949,384
27063,MN,Jackson,,2010,5.9,5677,6031,354
27063,MN,Jackson,,2011,5.4,5771,6103,332
27063,MN,Jackson,,2012,4.6,5928,6212,284
27063,MN,Jackson,,2013,4.2,5972,6234,262
27063,MN,Jackson,,2014,4.3,6046,6317,271
27063,MN,Jackson,,2015,4.1,6043,6303,260
27063,MN,Jackson,,2016,4.5,5819,6094,275
27063,MN,Jackson,,2017,3.7,5570,5782,212
27063,MN,Jackson,,2018,3.1,5560,5739,179
27063,MN,Jackson,,2019,3.7,5563,5774,211
27063,MN,Jackson,,2020,5.4,5519,5832,313
27063,MN,Jackson,,2021,3.1,5232,5402,170
27065,MN,Kanabec,,2007,8.3,7242,7899,657
27065,MN,Kanabec,,2008,10.2,7166,7983,817
27065,MN,Kanabec,,2009,13.3,7021,8098,1077
27065,MN,Kanabec,,2010,11.2,7804,8793,989
27065,MN,Kanabec,,2011,10.1,7849,8730,881
27065,MN,Kanabec,,2012,9.1,7952,8744,792
27065,MN,Kanabec,,2013,8.3,8079,8807,728
27065,MN,Kanabec,,2014,7.6,8202,8877,675
27065,MN,Kanabec,,2015,6.7,8266,8861,595
27065,MN,Kanabec,,2016,6.5,8402,8987,585
27065,MN,Kanabec,,2017,6.1,8519,9077,558
27065,MN,Kanabec,,2018,5.8,8471,8996,525
27065,MN,Kanabec,,2019,6.2,8613,9185,572
27065,MN,Kanabec,,2020,8.3,8412,9178,766
27065,MN,Kanabec,,2021,5.3,8415,8885,470
27067,MN,Kandiyohi,,2007,4.3,22364,23373,1009
27067,MN,Kandiyohi,,2008,4.9,22329,23489,1160
27067,MN,Kandiyohi,,2009,6.8,22258,23884,1626
27067,MN,Kandiyohi,,2010,6.7,22009,23588,1579
27067,MN,Kandiyohi,,2011,6,22270,23694,1424
27067,MN,Kandiyohi,,2012,5.3,22283,23520,1237
27067,MN,Kandiyohi,,2013,4.8,22362,23495,1133
27067,MN,Kandiyohi,,2014,4.3,22697,23727,1030
27067,MN,Kandiyohi,,2015,3.8,23198,24118,920
27067,MN,Kandiyohi,,2016,3.8,23256,24175,919
27067,MN,Kandiyohi,,2017,3.3,24126,24946,820
27067,MN,Kandiyohi,,2018,3.1,24060,24842,782
27067,MN,Kandiyohi,,2019,3.7,23661,24580,919
27067,MN,Kandiyohi,,2020,5,23547,24779,1232
27067,MN,Kandiyohi,,2021,3.6,22142,22957,815
27069,MN,Kittson,,2007,5.8,2337,2480,143
27069,MN,Kittson,,2008,5.6,2328,2467,139
27069,MN,Kittson,,2009,7.3,2330,2514,184
27069,MN,Kittson,,2010,7.6,2384,2579,195
27069,MN,Kittson,,2011,6.9,2430,2609,179
27069,MN,Kittson,,2012,5.8,2415,2565,150
27069,MN,Kittson,,2013,6.1,2274,2421,147
27069,MN,Kittson,,2014,5,2276,2396,120
27069,MN,Kittson,,2015,4.7,2362,2479,117
27069,MN,Kittson,,2016,4.6,2293,2403,110
27069,MN,Kittson,,2017,3.7,2288,2377,89
27069,MN,Kittson,,2018,3.1,2272,2345,73
27069,MN,Kittson,,2019,3.8,2304,2396,92
27069,MN,Kittson,,2020,4.8,2290,2405,115
27069,MN,Kittson,,2021,2.9,2159,2223,64
27071,MN,Koochiching,,2007,7,6045,6501,456
27071,MN,Koochiching,,2008,7.7,6009,6508,499
27071,MN,Koochiching,,2009,9.6,6020,6659,639
27071,MN,Koochiching,,2010,8.7,6340,6945,605
27071,MN,Koochiching,,2011,8.4,6253,6826,573
27071,MN,Koochiching,,2012,8,6171,6710,539
27071,MN,Koochiching,,2013,8.4,6170,6737,567
27071,MN,Koochiching,,2014,8.7,5897,6456,559
27071,MN,Koochiching,,2015,8.3,5755,6276,521
27071,MN,Koochiching,,2016,8.5,5636,6159,523
27071,MN,Koochiching,,2017,7.2,5572,6003,431
27071,MN,Koochiching,,2018,6.6,5587,5979,392
27071,MN,Koochiching,,2019,6.7,5652,6059,407
27071,MN,Koochiching,,2020,7.6,5405,5851,446
27071,MN,Koochiching,,2021,4.4,5336,5582,246
27073,MN,Lac qui Parle,,2007,4.2,3876,4045,169
27073,MN,Lac qui Parle,,2008,4.8,3901,4098,197
27073,MN,Lac qui Parle,,2009,6.2,4049,4317,268
27073,MN,Lac qui Parle,,2010,6.7,3812,4085,273
27073,MN,Lac qui Parle,,2011,6.1,3740,3982,242
27073,MN,Lac qui Parle,,2012,5.1,3665,3860,195
27073,MN,Lac qui Parle,,2013,5.7,3462,3670,208
27073,MN,Lac qui Parle,,2014,4.9,3482,3660,178
27073,MN,Lac qui Parle,,2015,4.2,3615,3773,158
27073,MN,Lac qui Parle,,2016,4.3,3462,3617,155
27073,MN,Lac qui Parle,,2017,3.5,3416,3539,123
27073,MN,Lac qui Parle,,2018,3.9,3399,3536,137
27073,MN,Lac qui Parle,,2019,4,3438,3580,142
27073,MN,Lac qui Parle,,2020,4.9,3361,3536,175
27073,MN,Lac qui Parle,,2021,2.8,3209,3303,94
27075,MN,Lake,,2007,4.5,5839,6115,276
27075,MN,Lake,,2008,5.3,5822,6145,323
27075,MN,Lake,,2009,9.2,5606,6176,570
27075,MN,Lake,,2010,8.3,5319,5802,483
27075,MN,Lake,,2011,6.9,5424,5827,403
27075,MN,Lake,,2012,6,5482,5835,353
27075,MN,Lake,,2013,6.3,5418,5782,364
27075,MN,Lake,,2014,4.7,5428,5696,268
27075,MN,Lake,,2015,4.9,5350,5626,276
27075,MN,Lake,,2016,6.4,5069,5414,345
27075,MN,Lake,,2017,3.9,5316,5531,215
27075,MN,Lake,,2018,3.4,5316,5502,186
27075,MN,Lake,,2019,3.8,5347,5561,214
27075,MN,Lake,,2020,7.4,4967,5363,396
27075,MN,Lake,,2021,3.6,5060,5249,189
27077,MN,Lake of the Woods,,2007,5.1,2176,2293,117
27077,MN,Lake of the Woods,,2008,6,2128,2264,136
27077,MN,Lake of the Woods,,2009,7.7,2090,2265,175
27077,MN,Lake of the Woods,,2010,6.5,2135,2283,148
27077,MN,Lake of the Woods,,2011,6.2,2199,2345,146
27077,MN,Lake of the Woods,,2012,6.1,2206,2350,144
27077,MN,Lake of the Woods,,2013,5.8,2240,2377,137
27077,MN,Lake of the Woods,,2014,4.9,2276,2393,117
27077,MN,Lake of the Woods,,2015,4.6,2318,2429,111
27077,MN,Lake of the Woods,,2016,4.8,2267,2382,115
27077,MN,Lake of the Woods,,2017,4.7,2282,2395,113
27077,MN,Lake of the Woods,,2018,4.1,2313,2411,98
27077,MN,Lake of the Woods,,2019,4.4,2366,2476,110
27077,MN,Lake of the Woods,,2020,6.3,2295,2449,154
27077,MN,Lake of the Woods,,2021,3.7,2275,2362,87
27079,MN,Le Sueur,,2007,6.2,13272,14149,877
27079,MN,Le Sueur,,2008,7.3,13259,14309,1050
27079,MN,Le Sueur,,2009,10.8,12836,14389,1553
27079,MN,Le Sueur,,2010,8.8,14331,15722,1391
27079,MN,Le Sueur,,2011,7.6,14521,15713,1192
27079,MN,Le Sueur,,2012,6.5,14492,15506,1014
27079,MN,Le Sueur,,2013,6.2,14557,15517,960
27079,MN,Le Sueur,,2014,5.5,14667,15522,855
27079,MN,Le Sueur,,2015,4.9,14811,15577,766
27079,MN,Le Sueur,,2016,4.9,14790,15550,760
27079,MN,Le Sueur,,2017,4.7,15178,15928,750
27079,MN,Le Sueur,,2018,4.4,15445,16157,712
27079,MN,Le Sueur,,2019,4.7,15755,16539,784
27079,MN,Le Sueur,,2020,7,15077,16215,1138
27079,MN,Le Sueur,,2021,4.1,14995,15633,638
27081,MN,Lincoln,,2007,4.6,3055,3202,147
27081,MN,Lincoln,,2008,5,3084,3248,164
27081,MN,Lincoln,,2009,5.9,3165,3365,200
27081,MN,Lincoln,,2010,5.5,3257,3448,191
27081,MN,Lincoln,,2011,5.2,3276,3455,179
27081,MN,Lincoln,,2012,4.8,3262,3425,163
27081,MN,Lincoln,,2013,4.7,3158,3313,155
27081,MN,Lincoln,,2014,4.4,3141,3287,146
27081,MN,Lincoln,,2015,3.6,3278,3399,121
27081,MN,Lincoln,,2016,3.6,3257,3380,123
27081,MN,Lincoln,,2017,3.2,3263,3372,109
27081,MN,Lincoln,,2018,3.2,3169,3274,105
27081,MN,Lincoln,,2019,4,3158,3290,132
27081,MN,Lincoln,,2020,4.6,3005,3151,146
27081,MN,Lincoln,,2021,3.3,2858,2957,99
27083,MN,Lyon,,2007,3.8,13862,14416,554
27083,MN,Lyon,,2008,4.4,13864,14504,640
27083,MN,Lyon,,2009,5.9,13839,14707,868
27083,MN,Lyon,,2010,5.6,14382,15237,855
27083,MN,Lyon,,2011,5.3,14613,15429,816
27083,MN,Lyon,,2012,4.4,14568,15245,677
27083,MN,Lyon,,2013,4.2,14653,15295,642
27083,MN,Lyon,,2014,3.7,14750,15316,566
27083,MN,Lyon,,2015,3.3,14816,15319,503
27083,MN,Lyon,,2016,3.6,14637,15176,539
27083,MN,Lyon,,2017,3.2,14549,15034,485
27083,MN,Lyon,,2018,3,14371,14823,452
27083,MN,Lyon,,2019,3.4,14175,14672,497
27083,MN,Lyon,,2020,4.6,13999,14667,668
27083,MN,Lyon,,2021,2.7,13583,13966,383
27085,MN,McLeod,,2007,5.1,19309,20336,1027
27085,MN,McLeod,,2008,6,19198,20427,1229
27085,MN,McLeod,,2009,9.7,18151,20095,1944
27085,MN,McLeod,,2010,9,18497,20320,1823
27085,MN,McLeod,,2011,7.7,18824,20386,1562
27085,MN,McLeod,,2012,6.8,18593,19954,1361
27085,MN,McLeod,,2013,5.7,18903,20041,1138
27085,MN,McLeod,,2014,4.7,18930,19869,939
27085,MN,McLeod,,2015,4,19438,20251,813
27085,MN,McLeod,,2016,4.4,18893,19765,872
27085,MN,McLeod,,2017,3.8,18844,19594,750
27085,MN,McLeod,,2018,3.3,18955,19612,657
27085,MN,McLeod,,2019,3.9,18778,19547,769
27085,MN,McLeod,,2020,5.9,18289,19429,1140
27085,MN,McLeod,,2021,3.4,18118,18763,645
27087,MN,Mahnomen,,2007,6.8,2259,2424,165
27087,MN,Mahnomen,,2008,7.2,2231,2404,173
27087,MN,Mahnomen,,2009,7.9,2237,2429,192
27087,MN,Mahnomen,,2010,8.3,2297,2504,207
27087,MN,Mahnomen,,2011,7.6,2309,2499,190
27087,MN,Mahnomen,,2012,7,2307,2480,173
27087,MN,Mahnomen,,2013,5.9,2259,2400,141
27087,MN,Mahnomen,,2014,5.8,2231,2368,137
27087,MN,Mahnomen,,2015,5.9,2270,2413,143
27087,MN,Mahnomen,,2016,5.8,2250,2388,138
27087,MN,Mahnomen,,2017,5.1,2252,2372,120
27087,MN,Mahnomen,,2018,4.9,2221,2336,115
27087,MN,Mahnomen,,2019,5,2208,2325,117
27087,MN,Mahnomen,,2020,13.3,1925,2220,295
27087,MN,Mahnomen,,2021,5.9,2014,2141,127
27089,MN,Marshall,,2007,8.1,4745,5161,416
27089,MN,Marshall,,2008,7.8,4745,5149,404
27089,MN,Marshall,,2009,10,4803,5336,533
27089,MN,Marshall,,2010,9.3,5172,5703,531
27089,MN,Marshall,,2011,8.4,5314,5800,486
27089,MN,Marshall,,2012,7.7,5310,5754,444
27089,MN,Marshall,,2013,7.8,5144,5577,433
27089,MN,Marshall,,2014,6.9,5219,5606,387
27089,MN,Marshall,,2015,7,5355,5761,406
27089,MN,Marshall,,2016,7.3,5204,5615,411
27089,MN,Marshall,,2017,7,5118,5503,385
27089,MN,Marshall,,2018,6.2,5115,5452,337
27089,MN,Marshall,,2019,6.2,5132,5473,341
27089,MN,Marshall,,2020,6.8,5115,5489,374
27089,MN,Marshall,,2021,4.2,4958,5173,215
27091,MN,Martin,,2007,4.4,10731,11228,497
27091,MN,Martin,,2008,4.9,10891,11449,558
27091,MN,Martin,,2009,7.6,10762,11649,887
27091,MN,Martin,,2010,7.3,10670,11513,843
27091,MN,Martin,,2011,6.7,10488,11236,748
27091,MN,Martin,,2012,5.6,10271,10886,615
27091,MN,Martin,,2013,5.3,9793,10346,553
27091,MN,Martin,,2014,4.8,9751,10245,494
27091,MN,Martin,,2015,4.2,10038,10473,435
27091,MN,Martin,,2016,4.1,10025,10455,430
27091,MN,Martin,,2017,3.5,10094,10459,365
27091,MN,Martin,,2018,3.4,9961,10309,348
27091,MN,Martin,,2019,4,9758,10166,408
27091,MN,Martin,,2020,5.5,9546,10099,553
27091,MN,Martin,,2021,3.2,9164,9468,304
27093,MN,Meeker,,2007,6,11612,12350,738
27093,MN,Meeker,,2008,6.6,11632,12451,819
27093,MN,Meeker,,2009,9.7,11298,12515,1217
27093,MN,Meeker,,2010,8.8,11690,12821,1131
27093,MN,Meeker,,2011,7.8,11875,12873,998
27093,MN,Meeker,,2012,6.6,11906,12752,846
27093,MN,Meeker,,2013,5.6,12039,12756,717
27093,MN,Meeker,,2014,4.7,12284,12890,606
27093,MN,Meeker,,2015,4.3,12800,13373,573
27093,MN,Meeker,,2016,4.5,12659,13254,595
27093,MN,Meeker,,2017,4.1,12760,13303,543
27093,MN,Meeker,,2018,3.7,12731,13223,492
27093,MN,Meeker,,2019,4.1,12945,13499,554
27093,MN,Meeker,,2020,5.5,12642,13372,730
27093,MN,Meeker,,2021,3.4,12470,12907,437
27095,MN,Mille Lacs,,2007,7.7,11309,12253,944
27095,MN,Mille Lacs,,2008,9,11164,12271,1107
27095,MN,Mille Lacs,,2009,12.8,10812,12395,1583
27095,MN,Mille Lacs,,2010,11.1,11701,13165,1464
27095,MN,Mille Lacs,,2011,9.6,11705,12955,1250
27095,MN,Mille Lacs,,2012,8.4,11643,12709,1066
27095,MN,Mille Lacs,,2013,7.6,11730,12695,965
27095,MN,Mille Lacs,,2014,6.9,11846,12719,873
27095,MN,Mille Lacs,,2015,5.9,11901,12650,749
27095,MN,Mille Lacs,,2016,6,11958,12717,759
27095,MN,Mille Lacs,,2017,5.6,12071,12789,718
27095,MN,Mille Lacs,,2018,5.1,12244,12908,664
27095,MN,Mille Lacs,,2019,5.7,12385,13139,754
27095,MN,Mille Lacs,,2020,8.8,11833,12969,1136
27095,MN,Mille Lacs,,2021,5.2,11820,12462,642
27097,MN,Morrison,,2007,6.2,16203,17274,1071
27097,MN,Morrison,,2008,7.5,16289,17617,1328
27097,MN,Morrison,,2009,11.2,16240,18294,2054
27097,MN,Morrison,,2010,9.5,16858,18629,1771
27097,MN,Morrison,,2011,8.3,17242,18793,1551
27097,MN,Morrison,,2012,7.1,16682,17958,1276
27097,MN,Morrison,,2013,6.8,16490,17702,1212
27097,MN,Morrison,,2014,6.4,16327,17441,1114
27097,MN,Morrison,,2015,5.5,16861,17845,984
27097,MN,Morrison,,2016,5.6,16853,17856,1003
27097,MN,Morrison,,2017,5.4,16795,17748,953
27097,MN,Morrison,,2018,5,16756,17639,883
27097,MN,Morrison,,2019,5.5,16803,17784,981
27097,MN,Morrison,,2020,7,16780,18043,1263
27097,MN,Morrison,,2021,4.4,16388,17149,761
27099,MN,Mower,,2007,4.1,19466,20292,826
27099,MN,Mower,,2008,4.6,19441,20373,932
27099,MN,Mower,,2009,6.4,19611,20943,1332
27099,MN,Mower,,2010,6.1,19644,20923,1279
27099,MN,Mower,,2011,5.7,19677,20863,1186
27099,MN,Mower,,2012,5,19644,20684,1040
27099,MN,Mower,,2013,4.5,19562,20494,932
27099,MN,Mower,,2014,3.9,19529,20324,795
27099,MN,Mower,,2015,3.3,19738,20407,669
27099,MN,Mower,,2016,3.2,19858,20506,648
27099,MN,Mower,,2017,2.8,20065,20653,588
27099,MN,Mower,,2018,2.9,19882,20477,595
27099,MN,Mower,,2019,3.2,19971,20634,663
27099,MN,Mower,,2020,5.1,19879,20956,1077
27099,MN,Mower,,2021,3.1,19538,20169,631
27101,MN,Murray,,2007,4.3,5137,5368,231
27101,MN,Murray,,2008,5.1,5137,5412,275
27101,MN,Murray,,2009,5.8,5402,5735,333
27101,MN,Murray,,2010,6.9,4680,5026,346
27101,MN,Murray,,2011,6.3,4734,5050,316
27101,MN,Murray,,2012,5.2,4739,5001,262
27101,MN,Murray,,2013,5.4,4580,4842,262
27101,MN,Murray,,2014,5,4627,4870,243
27101,MN,Murray,,2015,4.5,4846,5075,229
27101,MN,Murray,,2016,4.7,4719,4953,234
27101,MN,Murray,,2017,4.4,4689,4907,218
27101,MN,Murray,,2018,4,4707,4902,195
27101,MN,Murray,,2019,4.5,4679,4902,223
27101,MN,Murray,,2020,5.3,4624,4881,257
27101,MN,Murray,,2021,3.8,4424,4599,175
27103,MN,Nicollet,,2007,3.7,18511,19213,702
27103,MN,Nicollet,,2008,4.3,18912,19768,856
27103,MN,Nicollet,,2009,6.4,18611,19877,1266
27103,MN,Nicollet,,2010,6.1,18584,19796,1212
27103,MN,Nicollet,,2011,5.1,18959,19981,1022
27103,MN,Nicollet,,2012,4.6,18853,19760,907
27103,MN,Nicollet,,2013,3.8,18983,19732,749
27103,MN,Nicollet,,2014,3.1,19190,19810,620
27103,MN,Nicollet,,2015,2.7,19801,20349,548
27103,MN,Nicollet,,2016,2.8,19767,20343,576
27103,MN,Nicollet,,2017,2.6,20177,20707,530
27103,MN,Nicollet,,2018,2.4,20376,20871,495
27103,MN,Nicollet,,2019,2.7,20589,21161,572
27103,MN,Nicollet,,2020,4.9,19912,20944,1032
27103,MN,Nicollet,,2021,2.8,19567,20123,556
27105,MN,Nobles,,2007,3.5,10716,11104,388
27105,MN,Nobles,,2008,4.1,10643,11103,460
27105,MN,Nobles,,2009,5.3,10954,11570,616
27105,MN,Nobles,,2010,5.6,10882,11531,649
27105,MN,Nobles,,2011,5.3,10900,11509,609
27105,MN,Nobles,,2012,4.4,10807,11302,495
27105,MN,Nobles,,2013,4.1,10618,11071,453
27105,MN,Nobles,,2014,3.5,10862,11256,394
27105,MN,Nobles,,2015,3.3,11174,11552,378
27105,MN,Nobles,,2016,3.8,11018,11450,432
27105,MN,Nobles,,2017,3.2,11027,11392,365
27105,MN,Nobles,,2018,2.8,11023,11340,317
27105,MN,Nobles,,2019,3.2,10977,11336,359
27105,MN,Nobles,,2020,4.3,11159,11665,506
27105,MN,Nobles,,2021,2.9,10760,11076,316
27107,MN,Norman,,2007,5.1,3360,3542,182
27107,MN,Norman,,2008,5.6,3326,3524,198
27107,MN,Norman,,2009,6.5,3349,3582,233
27107,MN,Norman,,2010,6.9,3357,3607,250
27107,MN,Norman,,2011,6.7,3411,3657,246
27107,MN,Norman,,2012,6,3317,3527,210
27107,MN,Norman,,2013,5.8,3123,3316,193
27107,MN,Norman,,2014,5.1,3153,3323,170
27107,MN,Norman,,2015,4.8,3286,3450,164
27107,MN,Norman,,2016,4.8,3275,3439,164
27107,MN,Norman,,2017,4.7,3250,3412,162
27107,MN,Norman,,2018,4.6,3220,3376,156
27107,MN,Norman,,2019,5.1,3123,3291,168
27107,MN,Norman,,2020,6.5,3113,3330,217
27107,MN,Norman,,2021,3.9,3030,3154,124
27109,MN,Olmsted,,2007,3.8,76706,79739,3033
27109,MN,Olmsted,,2008,4.4,76145,79671,3526
27109,MN,Olmsted,,2009,6.2,76186,81242,5056
27109,MN,Olmsted,,2010,6,76408,81257,4849
27109,MN,Olmsted,,2011,5.3,77180,81487,4307
27109,MN,Olmsted,,2012,4.5,78949,82629,3680
27109,MN,Olmsted,,2013,4.1,80055,83450,3395
27109,MN,Olmsted,,2014,3.5,80284,83226,2942
27109,MN,Olmsted,,2015,3,81573,84080,2507
27109,MN,Olmsted,,2016,3,82628,85163,2535
27109,MN,Olmsted,,2017,2.7,84728,87102,2374
27109,MN,Olmsted,,2018,2.5,85948,88123,2175
27109,MN,Olmsted,,2019,2.7,87653,90117,2464
27109,MN,Olmsted,,2020,5.5,86794,91855,5061
27109,MN,Olmsted,,2021,2.8,87173,89697,2524
27111,MN,Otter Tail,,2007,5.3,27692,29248,1556
27111,MN,Otter Tail,,2008,6.1,27739,29533,1794
27111,MN,Otter Tail,,2009,8.1,27685,30131,2446
27111,MN,Otter Tail,,2010,7.2,28673,30896,2223
27111,MN,Otter Tail,,2011,6.4,28969,30957,1988
27111,MN,Otter Tail,,2012,5.6,29088,30810,1722
27111,MN,Otter Tail,,2013,5.3,29252,30899,1647
27111,MN,Otter Tail,,2014,4.6,29517,30955,1438
27111,MN,Otter Tail,,2015,4.3,29856,31194,1338
27111,MN,Otter Tail,,2016,4.4,29913,31275,1362
27111,MN,Otter Tail,,2017,4,30413,31683,1270
27111,MN,Otter Tail,,2018,3.9,30295,31510,1215
27111,MN,Otter Tail,,2019,4.4,30364,31773,1409
27111,MN,Otter Tail,,2020,5.6,29957,31735,1778
27111,MN,Otter Tail,,2021,3.4,29566,30602,1036
27113,MN,Pennington,,2007,6.9,7937,8529,592
27113,MN,Pennington,,2008,7.1,8071,8686,615
27113,MN,Pennington,,2009,9,8143,8949,806
27113,MN,Pennington,,2010,9.1,7643,8406,763
27113,MN,Pennington,,2011,7.7,7917,8579,662
27113,MN,Pennington,,2012,6.7,8028,8601,573
27113,MN,Pennington,,2013,6.4,8111,8667,556
27113,MN,Pennington,,2014,5.3,8399,8865,466
27113,MN,Pennington,,2015,5.2,8626,9102,476
27113,MN,Pennington,,2016,5.8,8518,9039,521
27113,MN,Pennington,,2017,5.7,8333,8837,504
27113,MN,Pennington,,2018,4.5,8419,8812,393
27113,MN,Pennington,,2019,4.8,8384,8810,426
27113,MN,Pennington,,2020,6.4,8175,8732,557
27113,MN,Pennington,,2021,3.7,8211,8527,316
27115,MN,Pine,,2007,7.7,12626,13680,1054
27115,MN,Pine,,2008,8.5,12905,14108,1203
27115,MN,Pine,,2009,11.4,12855,14507,1652
27115,MN,Pine,,2010,9.9,13856,15371,1515
27115,MN,Pine,,2011,8.8,13843,15186,1343
27115,MN,Pine,,2012,7.6,13771,14901,1130
27115,MN,Pine,,2013,7,13808,14851,1043
27115,MN,Pine,,2014,6.3,13726,14645,919
27115,MN,Pine,,2015,5.7,13983,14825,842
27115,MN,Pine,,2016,5.8,13963,14830,867
27115,MN,Pine,,2017,5.8,14191,15058,867
27115,MN,Pine,,2018,5.2,14176,14952,776
27115,MN,Pine,,2019,5.8,14351,15242,891
27115,MN,Pine,,2020,8.9,13379,14689,1310
27115,MN,Pine,,2021,5,13277,13970,693
27117,MN,Pipestone,,2007,3.8,5079,5278,199
27117,MN,Pipestone,,2008,4.4,5347,5595,248
27117,MN,Pipestone,,2009,6.4,5199,5557,358
27117,MN,Pipestone,,2010,6.6,4812,5152,340
27117,MN,Pipestone,,2011,6.5,4712,5041,329
27117,MN,Pipestone,,2012,5,4665,4911,246
27117,MN,Pipestone,,2013,4.7,4474,4693,219
27117,MN,Pipestone,,2014,3.9,4607,4792,185
27117,MN,Pipestone,,2015,3.4,4818,4988,170
27117,MN,Pipestone,,2016,3.8,4712,4899,187
27117,MN,Pipestone,,2017,3.4,4716,4880,164
27117,MN,Pipestone,,2018,3.1,4800,4952,152
27117,MN,Pipestone,,2019,3.7,4784,4968,184
27117,MN,Pipestone,,2020,4.2,4513,4711,198
27117,MN,Pipestone,,2021,2.9,4317,4444,127
27119,MN,Polk,,2007,4.6,15863,16631,768
27119,MN,Polk,,2008,5,15987,16830,843
27119,MN,Polk,,2009,6,16061,17086,1025
27119,MN,Polk,,2010,6.7,16028,17171,1143
27119,MN,Polk,,2011,7.1,16227,17461,1234
27119,MN,Polk,,2012,6.3,16430,17527,1097
27119,MN,Polk,,2013,5.5,16184,17119,935
27119,MN,Polk,,2014,4.7,16320,17128,808
27119,MN,Polk,,2015,4.3,16466,17208,742
27119,MN,Polk,,2016,4.3,16392,17136,744
27119,MN,Polk,,2017,4.2,16348,17072,724
27119,MN,Polk,,2018,3.9,16119,16781,662
27119,MN,Polk,,2019,4.2,16172,16881,709
27119,MN,Polk,,2020,5.8,15434,16390,956
27119,MN,Polk,,2021,3.8,15100,15699,599
27121,MN,Pope,,2007,4.5,5813,6085,272
27121,MN,Pope,,2008,5.3,5748,6070,322
27121,MN,Pope,,2009,7.3,5776,6228,452
27121,MN,Pope,,2010,7.1,5464,5884,420
27121,MN,Pope,,2011,5.9,5526,5873,347
27121,MN,Pope,,2012,4.7,5671,5951,280
27121,MN,Pope,,2013,4.3,5711,5969,258
27121,MN,Pope,,2014,3.7,6004,6237,233
27121,MN,Pope,,2015,3.5,6176,6403,227
27121,MN,Pope,,2016,3.6,6075,6299,224
27121,MN,Pope,,2017,3.1,6190,6388,198
27121,MN,Pope,,2018,2.8,6258,6438,180
27121,MN,Pope,,2019,3.3,6378,6597,219
27121,MN,Pope,,2020,4.6,6280,6582,302
27121,MN,Pope,,2021,2.8,6109,6285,176
27123,MN,Ramsey,,2007,4.4,258795,270757,11962
27123,MN,Ramsey,,2008,5.2,256640,270816,14176
27123,MN,Ramsey,,2009,7.8,248761,269667,20906
27123,MN,Ramsey,,2010,7.5,250065,270269,20204
27123,MN,Ramsey,,2011,6.7,254784,273002,18218
27123,MN,Ramsey,,2012,5.8,257449,273270,15821
27123,MN,Ramsey,,2013,5,261780,275512,13732
27123,MN,Ramsey,,2014,4.1,266524,278003,11479
27123,MN,Ramsey,,2015,3.6,270141,280242,10101
27123,MN,Ramsey,,2016,3.6,272058,282227,10169
27123,MN,Ramsey,,2017,3.3,278748,288172,9424
27123,MN,Ramsey,,2018,2.9,281073,289445,8372
27123,MN,Ramsey,,2019,3.2,282808,292145,9337
27123,MN,Ramsey,,2020,7.1,269924,290469,20545
27123,MN,Ramsey,,2021,3.8,270690,281343,10653
27125,MN,Red Lake,,2007,8.2,2105,2292,187
27125,MN,Red Lake,,2008,7.9,2167,2353,186
27125,MN,Red Lake,,2009,10.3,2176,2426,250
27125,MN,Red Lake,,2010,9.6,2188,2421,233
27125,MN,Red Lake,,2011,8.1,2232,2428,196
27125,MN,Red Lake,,2012,7.3,2173,2344,171
27125,MN,Red Lake,,2013,6.8,2104,2258,154
27125,MN,Red Lake,,2014,5.9,2131,2265,134
27125,MN,Red Lake,,2015,6,2196,2336,140
27125,MN,Red Lake,,2016,7.3,2121,2289,168
27125,MN,Red Lake,,2017,6.7,2111,2262,151
27125,MN,Red Lake,,2018,5.5,2117,2240,123
27125,MN,Red Lake,,2019,5.6,2127,2252,125
27125,MN,Red Lake,,2020,6.7,2094,2244,150
27125,MN,Red Lake,,2021,4,2065,2150,85
27127,MN,Redwood,,2007,4.7,7859,8250,391
27127,MN,Redwood,,2008,5.4,7624,8059,435
27127,MN,Redwood,,2009,6.9,7831,8408,577
27127,MN,Redwood,,2010,6.8,8006,8587,581
27127,MN,Redwood,,2011,6.1,7892,8403,511
27127,MN,Redwood,,2012,5.6,7758,8215,457
27127,MN,Redwood,,2013,5.6,7611,8059,448
27127,MN,Redwood,,2014,4.5,7658,8020,362
27127,MN,Redwood,,2015,4,7957,8288,331
27127,MN,Redwood,,2016,4.1,7974,8315,341
27127,MN,Redwood,,2017,4.1,7394,7712,318
27127,MN,Redwood,,2018,3.8,7355,7648,293
27127,MN,Redwood,,2019,3.9,7388,7690,302
27127,MN,Redwood,,2020,5.7,7369,7811,442
27127,MN,Redwood,,2021,3.4,7128,7379,251
27129,MN,Renville,,2007,5.3,8013,8460,447
27129,MN,Renville,,2008,5.8,8153,8651,498
27129,MN,Renville,,2009,8,8043,8742,699
27129,MN,Renville,,2010,8,8274,8998,724
27129,MN,Renville,,2011,7.4,7934,8565,631
27129,MN,Renville,,2012,6.8,7861,8438,577
27129,MN,Renville,,2013,6.6,7704,8249,545
27129,MN,Renville,,2014,5.7,7763,8228,465
27129,MN,Renville,,2015,4.9,8192,8615,423
27129,MN,Renville,,2016,5.3,7969,8411,442
27129,MN,Renville,,2017,4.5,8522,8920,398
27129,MN,Renville,,2018,4.2,8389,8759,370
27129,MN,Renville,,2019,4.8,8315,8735,420
27129,MN,Renville,,2020,5.9,8034,8540,506
27129,MN,Renville,,2021,3.9,7838,8153,315
27131,MN,Rice,,2007,5,30456,32056,1600
27131,MN,Rice,,2008,5.9,30696,32609,1913
27131,MN,Rice,,2009,8.7,30622,33522,2900
27131,MN,Rice,,2010,7.8,32281,35007,2726
27131,MN,Rice,,2011,6.7,32525,34848,2323
27131,MN,Rice,,2012,5.9,32860,34904,2044
27131,MN,Rice,,2013,5,33269,35028,1759
27131,MN,Rice,,2014,4.2,33704,35186,1482
27131,MN,Rice,,2015,3.6,34222,35507,1285
27131,MN,Rice,,2016,3.5,34818,36083,1265
27131,MN,Rice,,2017,3.2,35518,36695,1177
27131,MN,Rice,,2018,3,35969,37070,1101
27131,MN,Rice,,2019,3.3,36375,37620,1245
27131,MN,Rice,,2020,5.4,35481,37521,2040
27131,MN,Rice,,2021,3.2,35190,36354,1164
27133,MN,Rock,,2007,3.2,4756,4913,157
27133,MN,Rock,,2008,3.9,4737,4927,190
27133,MN,Rock,,2009,5.4,4760,5032,272
27133,MN,Rock,,2010,5.1,5107,5380,273
27133,MN,Rock,,2011,4.2,5390,5628,238
27133,MN,Rock,,2012,3.7,5348,5552,204
27133,MN,Rock,,2013,3.2,5448,5631,183
27133,MN,Rock,,2014,2.6,5535,5682,147
27133,MN,Rock,,2015,2.2,5792,5920,128
27133,MN,Rock,,2016,2.3,5770,5907,137
27133,MN,Rock,,2017,2.1,5774,5899,125
27133,MN,Rock,,2018,2.5,5579,5720,141
27133,MN,Rock,,2019,2.4,5566,5705,139
27133,MN,Rock,,2020,3.2,5679,5864,185
27133,MN,Rock,,2021,1.9,5691,5801,110
27135,MN,Roseau,,2007,6.4,9113,9731,618
27135,MN,Roseau,,2008,4.9,9056,9526,470
27135,MN,Roseau,,2009,7.8,8765,9502,737
27135,MN,Roseau,,2010,6.4,8134,8692,558
27135,MN,Roseau,,2011,5.4,8087,8547,460
27135,MN,Roseau,,2012,4.8,8140,8547,407
27135,MN,Roseau,,2013,4.5,8237,8622,385
27135,MN,Roseau,,2014,3.8,8499,8831,332
27135,MN,Roseau,,2015,4.1,8273,8623,350
27135,MN,Roseau,,2016,5.1,7822,8244,422
27135,MN,Roseau,,2017,4.9,7776,8178,402
27135,MN,Roseau,,2018,3.6,7643,7928,285
27135,MN,Roseau,,2019,4.1,7601,7928,327
27135,MN,Roseau,,2020,5.9,7504,7974,470
27135,MN,Roseau,,2021,2.9,7521,7748,227
27137,MN,St. Louis,,2007,5.6,97306,103076,5770
27137,MN,St. Louis,,2008,6.3,97480,104049,6569
27137,MN,St. Louis,,2009,9.3,95489,105286,9797
27137,MN,St. Louis,,2010,8.1,95040,103461,8421
27137,MN,St. Louis,,2011,7.4,94935,102503,7568
27137,MN,St. Louis,,2012,6.5,95033,101690,6657
27137,MN,St. Louis,,2013,6.1,96053,102344,6291
27137,MN,St. Louis,,2014,5.2,97198,102538,5340
27137,MN,St. Louis,,2015,5.1,97018,102211,5193
27137,MN,St. Louis,,2016,5.7,96688,102556,5868
27137,MN,St. Louis,,2017,4.7,98204,103006,4802
27137,MN,St. Louis,,2018,4,98376,102435,4059
27137,MN,St. Louis,,2019,4.3,98568,102951,4383
27137,MN,St. Louis,,2020,7.4,94186,101666,7480
27137,MN,St. Louis,,2021,3.8,93880,97613,3733
27139,MN,Scott,,2007,4.1,69939,72908,2969
27139,MN,Scott,,2008,5,70397,74064,3667
27139,MN,Scott,,2009,7.4,69155,74688,5533
27139,MN,Scott,,2010,6.9,69100,74208,5108
27139,MN,Scott,,2011,5.8,70709,75059,4350
27139,MN,Scott,,2012,5,72077,75885,3808
27139,MN,Scott,,2013,4.5,73616,77045,3429
27139,MN,Scott,,2014,3.7,75442,78333,2891
27139,MN,Scott,,2015,3.2,76799,79335,2536
27139,MN,Scott,,2016,3.2,78068,80660,2592
27139,MN,Scott,,2017,2.9,80090,82507,2417
27139,MN,Scott,,2018,2.7,81289,83529,2240
27139,MN,Scott,,2019,2.9,82678,85170,2492
27139,MN,Scott,,2020,6,80122,85225,5103
27139,MN,Scott,,2021,3,80313,82810,2497
27141,MN,Sherburne,,2007,5,46164,48614,2450
27141,MN,Sherburne,,2008,6.2,46366,49406,3040
27141,MN,Sherburne,,2009,9.2,44599,49143,4544
27141,MN,Sherburne,,2010,8.4,44890,49033,4143
27141,MN,Sherburne,,2011,7.2,45468,48983,3515
27141,MN,Sherburne,,2012,6.2,45645,48680,3035
27141,MN,Sherburne,,2013,5.4,46196,48841,2645
27141,MN,Sherburne,,2014,4.6,47028,49319,2291
27141,MN,Sherburne,,2015,4.1,47561,49591,2030
27141,MN,Sherburne,,2016,4.1,48603,50664,2061
27141,MN,Sherburne,,2017,3.8,49655,51597,1942
27141,MN,Sherburne,,2018,3.4,50640,52406,1766
27141,MN,Sherburne,,2019,3.7,51580,53575,1995
27141,MN,Sherburne,,2020,6.2,50229,53570,3341
27141,MN,Sherburne,,2021,3.5,50294,52101,1807
27143,MN,Sibley,,2007,5.1,8232,8672,440
27143,MN,Sibley,,2008,6.2,8080,8617,537
27143,MN,Sibley,,2009,8,8153,8863,710
27143,MN,Sibley,,2010,7.9,7841,8516,675
27143,MN,Sibley,,2011,6.9,7929,8519,590
27143,MN,Sibley,,2012,6,7921,8428,507
27143,MN,Sibley,,2013,5.6,7865,8329,464
27143,MN,Sibley,,2014,4.7,7896,8288,392
27143,MN,Sibley,,2015,4.2,8169,8530,361
27143,MN,Sibley,,2016,4.3,8125,8488,363
27143,MN,Sibley,,2017,3.6,8145,8451,306
27143,MN,Sibley,,2018,3.4,8259,8548,289
27143,MN,Sibley,,2019,4.1,8225,8576,351
27143,MN,Sibley,,2020,5.8,7869,8351,482
27143,MN,Sibley,,2021,3.6,7677,7965,288
27145,MN,Stearns,,2007,4.6,79194,83008,3814
27145,MN,Stearns,,2008,5.5,78595,83201,4606
27145,MN,Stearns,,2009,7.9,77349,83993,6644
27145,MN,Stearns,,2010,7.2,79536,85722,6186
27145,MN,Stearns,,2011,6.3,80762,86172,5410
27145,MN,Stearns,,2012,5.4,81673,86366,4693
27145,MN,Stearns,,2013,5,82466,86778,4312
27145,MN,Stearns,,2014,4.2,84245,87919,3674
27145,MN,Stearns,,2015,3.7,85079,88340,3261
27145,MN,Stearns,,2016,3.8,85541,88889,3348
27145,MN,Stearns,,2017,3.4,87377,90470,3093
27145,MN,Stearns,,2018,3.2,87616,90469,2853
27145,MN,Stearns,,2019,3.4,88564,91669,3105
27145,MN,Stearns,,2020,5.9,86347,91724,5377
27145,MN,Stearns,,2021,3.6,85060,88222,3162
27147,MN,Steele,,2007,4.3,19466,20347,881
27147,MN,Steele,,2008,5.1,19672,20720,1048
27147,MN,Steele,,2009,8.7,18931,20746,1815
27147,MN,Steele,,2010,7.8,19436,21080,1644
27147,MN,Steele,,2011,6.5,19790,21165,1375
27147,MN,Steele,,2012,5.5,20415,21595,1180
27147,MN,Steele,,2013,4.6,20423,21415,992
27147,MN,Steele,,2014,3.9,20523,21349,826
27147,MN,Steele,,2015,3.4,20526,21251,725
27147,MN,Steele,,2016,3.6,20422,21176,754
27147,MN,Steele,,2017,3.4,19925,20627,702
27147,MN,Steele,,2018,3.2,19907,20560,653
27147,MN,Steele,,2019,3.4,20666,21386,720
27147,MN,Steele,,2020,5.6,19505,20658,1153
27147,MN,Steele,,2021,3.3,19294,19944,650
27149,MN,Stevens,,2007,3.8,5415,5626,211
27149,MN,Stevens,,2008,4.7,5346,5607,261
27149,MN,Stevens,,2009,5.5,5302,5608,306
27149,MN,Stevens,,2010,5.6,5241,5551,310
27149,MN,Stevens,,2011,4.9,5325,5599,274
27149,MN,Stevens,,2012,4.3,5373,5612,239
27149,MN,Stevens,,2013,3.8,5304,5514,210
27149,MN,Stevens,,2014,3.3,5395,5580,185
27149,MN,Stevens,,2015,2.9,5557,5721,164
27149,MN,Stevens,,2016,3,5478,5647,169
27149,MN,Stevens,,2017,2.7,5383,5531,148
27149,MN,Stevens,,2018,2.5,5328,5467,139
27149,MN,Stevens,,2019,2.9,5347,5504,157
27149,MN,Stevens,,2020,3.3,5283,5466,183
27149,MN,Stevens,,2021,2.4,5060,5182,122
27151,MN,Swift,,2007,5.3,5022,5301,279
27151,MN,Swift,,2008,6.1,4888,5204,316
27151,MN,Swift,,2009,7.3,5088,5488,400
27151,MN,Swift,,2010,8.1,4818,5244,426
27151,MN,Swift,,2011,7.2,4832,5205,373
27151,MN,Swift,,2012,6.2,4775,5090,315
27151,MN,Swift,,2013,5.9,4611,4900,289
27151,MN,Swift,,2014,4.9,4638,4879,241
27151,MN,Swift,,2015,6.2,4867,5186,319
27151,MN,Swift,,2016,5.4,4773,5045,272
27151,MN,Swift,,2017,4.1,4862,5072,210
27151,MN,Swift,,2018,3.9,4843,5039,196
27151,MN,Swift,,2019,4.6,4727,4957,230
27151,MN,Swift,,2020,6,4612,4906,294
27151,MN,Swift,,2021,3.7,4470,4640,170
27153,MN,Todd,,2007,5.5,11531,12197,666
27153,MN,Todd,,2008,6.5,11356,12149,793
27153,MN,Todd,,2009,9.1,11360,12495,1135
27153,MN,Todd,,2010,7.8,12477,13526,1049
27153,MN,Todd,,2011,6.8,12417,13323,906
27153,MN,Todd,,2012,5.8,12286,13047,761
27153,MN,Todd,,2013,5.4,12169,12864,695
27153,MN,Todd,,2014,4.8,12236,12847,611
27153,MN,Todd,,2015,4.5,12457,13040,583
27153,MN,Todd,,2016,4.7,12292,12900,608
27153,MN,Todd,,2017,4,13021,13561,540
27153,MN,Todd,,2018,4.2,12982,13548,566
27153,MN,Todd,,2019,4.7,13064,13705,641
27153,MN,Todd,,2020,5.5,13110,13875,765
27153,MN,Todd,,2021,3.7,12672,13158,486
27155,MN,Traverse,,2007,5.2,1739,1834,95
27155,MN,Traverse,,2008,5.4,1656,1751,95
27155,MN,Traverse,,2009,6.8,1664,1785,121
27155,MN,Traverse,,2010,6.2,1765,1882,117
27155,MN,Traverse,,2011,6,1736,1847,111
27155,MN,Traverse,,2012,5.1,1687,1777,90
27155,MN,Traverse,,2013,5.1,1576,1661,85
27155,MN,Traverse,,2014,4.7,1635,1716,81
27155,MN,Traverse,,2015,4.2,1762,1840,78
27155,MN,Traverse,,2016,3.9,1639,1705,66
27155,MN,Traverse,,2017,3.6,1716,1780,64
27155,MN,Traverse,,2018,3.5,1722,1784,62
27155,MN,Traverse,,2019,3.9,1715,1784,69
27155,MN,Traverse,,2020,4.6,1684,1765,81
27155,MN,Traverse,,2021,3.1,1582,1632,50
27157,MN,Wabasha,,2007,4.5,11638,12184,546
27157,MN,Wabasha,,2008,5,11436,12041,605
27157,MN,Wabasha,,2009,7.7,11273,12219,946
27157,MN,Wabasha,,2010,7.2,11249,12117,868
27157,MN,Wabasha,,2011,6.2,11238,11980,742
27157,MN,Wabasha,,2012,5.2,11348,11972,624
27157,MN,Wabasha,,2013,4.7,11287,11841,554
27157,MN,Wabasha,,2014,4.1,11268,11753,485
27157,MN,Wabasha,,2015,3.9,11557,12021,464
27157,MN,Wabasha,,2016,3.7,11564,12007,443
27157,MN,Wabasha,,2017,3.4,11806,12218,412
27157,MN,Wabasha,,2018,3.2,11880,12269,389
27157,MN,Wabasha,,2019,3.6,11958,12399,441
27157,MN,Wabasha,,2020,5.5,11820,12506,686
27157,MN,Wabasha,,2021,3,11656,12017,361
27159,MN,Wadena,,2007,7.5,5788,6257,469
27159,MN,Wadena,,2008,8.1,5954,6482,528
27159,MN,Wadena,,2009,11.1,5817,6543,726
27159,MN,Wadena,,2010,10.2,5825,6486,661
27159,MN,Wadena,,2011,9,5760,6332,572
27159,MN,Wadena,,2012,7.9,5748,6238,490
27159,MN,Wadena,,2013,7.1,5737,6174,437
27159,MN,Wadena,,2014,6.3,5767,6158,391
27159,MN,Wadena,,2015,6,5963,6346,383
27159,MN,Wadena,,2016,5.9,5875,6246,371
27159,MN,Wadena,,2017,5.6,5530,5859,329
27159,MN,Wadena,,2018,5.6,5612,5944,332
27159,MN,Wadena,,2019,6.6,5616,6010,394
27159,MN,Wadena,,2020,8,5571,6054,483
27159,MN,Wadena,,2021,4.5,5593,5854,261
27161,MN,Waseca,,2007,4.8,9741,10231,490
27161,MN,Waseca,,2008,5.4,9893,10455,562
27161,MN,Waseca,,2009,8.3,9586,10459,873
27161,MN,Waseca,,2010,7.5,9791,10584,793
27161,MN,Waseca,,2011,6.3,9935,10605,670
27161,MN,Waseca,,2012,5.8,9632,10225,593
27161,MN,Waseca,,2013,5.6,9382,9937,555
27161,MN,Waseca,,2014,4.9,9217,9695,478
27161,MN,Waseca,,2015,4.2,9363,9776,413
27161,MN,Waseca,,2016,4.3,9055,9461,406
27161,MN,Waseca,,2017,3.9,8972,9338,366
27161,MN,Waseca,,2018,4.3,8628,9020,392
27161,MN,Waseca,,2019,4.1,8760,9135,375
27161,MN,Waseca,,2020,6.4,8599,9189,590
27161,MN,Waseca,,2021,3.9,8323,8665,342
27163,MN,Washington,,2007,4,122373,127500,5127
27163,MN,Washington,,2008,5,122424,128837,6413
27163,MN,Washington,,2009,7.4,118957,128435,9478
27163,MN,Washington,,2010,6.7,123252,132144,8892
27163,MN,Washington,,2011,5.9,125454,133346,7892
27163,MN,Washington,,2012,5.2,126905,133838,6933
27163,MN,Washington,,2013,4.5,128944,135014,6070
27163,MN,Washington,,2014,3.7,131262,136346,5084
27163,MN,Washington,,2015,3.2,133023,137465,4442
27163,MN,Washington,,2016,3.3,134104,138733,4629
27163,MN,Washington,,2017,3,137267,141557,4290
27163,MN,Washington,,2018,2.7,139391,143247,3856
27163,MN,Washington,,2019,3,141973,146365,4392
27163,MN,Washington,,2020,5.7,137581,145942,8361
27163,MN,Washington,,2021,2.9,137850,141988,4138
27165,MN,Watonwan,,2007,5.1,5196,5473,277
27165,MN,Watonwan,,2008,6.5,5095,5449,354
27165,MN,Watonwan,,2009,9,5067,5568,501
27165,MN,Watonwan,,2010,7.3,5853,6316,463
27165,MN,Watonwan,,2011,6.4,5882,6281,399
27165,MN,Watonwan,,2012,5.7,5936,6292,356
27165,MN,Watonwan,,2013,5.4,5855,6186,331
27165,MN,Watonwan,,2014,5,5864,6175,311
27165,MN,Watonwan,,2015,4.8,5968,6268,300
27165,MN,Watonwan,,2016,4.9,6253,6573,320
27165,MN,Watonwan,,2017,4.4,6245,6530,285
27165,MN,Watonwan,,2018,3.7,6311,6553,242
27165,MN,Watonwan,,2019,4.3,6301,6584,283
27165,MN,Watonwan,,2020,4.8,6376,6697,321
27165,MN,Watonwan,,2021,3,6204,6396,192
27167,MN,Wilkin,,2007,3.8,3342,3475,133
27167,MN,Wilkin,,2008,4.4,3325,3477,152
27167,MN,Wilkin,,2009,5.5,3338,3532,194
27167,MN,Wilkin,,2010,5.5,3615,3825,210
27167,MN,Wilkin,,2011,5.6,3612,3827,215
27167,MN,Wilkin,,2012,4.8,3605,3785,180
27167,MN,Wilkin,,2013,4.2,3475,3628,153
27167,MN,Wilkin,,2014,3.5,3475,3600,125
27167,MN,Wilkin,,2015,3.4,3573,3698,125
27167,MN,Wilkin,,2016,3.3,3597,3718,121
27167,MN,Wilkin,,2017,3.1,3456,3568,112
27167,MN,Wilkin,,2018,3.2,3424,3538,114
27167,MN,Wilkin,,2019,3.6,3424,3551,127
27167,MN,Wilkin,,2020,4.2,3337,3485,148
27167,MN,Wilkin,,2021,2.8,3230,3323,93
27169,MN,Winona,,2007,4.2,27331,28528,1197
27169,MN,Winona,,2008,4.8,27450,28822,1372
27169,MN,Winona,,2009,7.8,26540,28784,2244
27169,MN,Winona,,2010,6.9,27210,29234,2024
27169,MN,Winona,,2011,5.8,27773,29498,1725
27169,MN,Winona,,2012,4.9,28384,29856,1472
27169,MN,Winona,,2013,4.4,28295,29609,1314
27169,MN,Winona,,2014,3.8,28286,29409,1123
27169,MN,Winona,,2015,3.4,28539,29540,1001
27169,MN,Winona,,2016,3.5,28213,29250,1037
27169,MN,Winona,,2017,3.1,28187,29101,914
27169,MN,Winona,,2018,2.8,28016,28827,811
27169,MN,Winona,,2019,3.1,28033,28920,887
27169,MN,Winona,,2020,5.1,26971,28410,1439
27169,MN,Winona,,2021,2.9,26494,27272,778
27171,MN,Wright,,2007,5.1,62584,65939,3355
27171,MN,Wright,,2008,6.1,63100,67187,4087
27171,MN,Wright,,2009,9.1,61694,67885,6191
27171,MN,Wright,,2010,8.1,64495,70146,5651
27171,MN,Wright,,2011,6.8,65617,70427,4810
27171,MN,Wright,,2012,5.9,66223,70365,4142
27171,MN,Wright,,2013,5.1,67015,70633,3618
27171,MN,Wright,,2014,4.3,68273,71353,3080
27171,MN,Wright,,2015,3.8,69443,72151,2708
27171,MN,Wright,,2016,3.9,70243,73060,2817
27171,MN,Wright,,2017,3.6,71863,74512,2649
27171,MN,Wright,,2018,3.2,73266,75674,2408
27171,MN,Wright,,2019,3.4,74807,77480,2673
27171,MN,Wright,,2020,5.7,72766,77159,4393
27171,MN,Wright,,2021,3.1,72797,75116,2319
27173,MN,Yellow Medicine,,2007,4.3,5428,5672,244
27173,MN,Yellow Medicine,,2008,5.1,5530,5825,295
27173,MN,Yellow Medicine,,2009,6.5,5469,5852,383
27173,MN,Yellow Medicine,,2010,6.3,5511,5882,371
27173,MN,Yellow Medicine,,2011,5.7,5425,5755,330
27173,MN,Yellow Medicine,,2012,5.1,5398,5686,288
27173,MN,Yellow Medicine,,2013,5,5270,5546,276
27173,MN,Yellow Medicine,,2014,4.2,5266,5499,233
27173,MN,Yellow Medicine,,2015,3.8,5379,5589,210
27173,MN,Yellow Medicine,,2016,3.8,5265,5475,210
27173,MN,Yellow Medicine,,2017,3.5,5188,5376,188
27173,MN,Yellow Medicine,,2018,3.2,5199,5371,172
27173,MN,Yellow Medicine,,2019,4,5196,5415,219
27173,MN,Yellow Medicine,,2020,4.7,5084,5335,251
27173,MN,Yellow Medicine,,2021,3,4813,4961,148
28000,MS,Mississippi,,2007,6.2,1213549,1293338,79789
28000,MS,Mississippi,,2008,6.7,1206858,1293375,86517
28000,MS,Mississippi,,2009,9.4,1149831,1268505,118674
28000,MS,Mississippi,,2010,10.1,1176938,1309128,132190
28000,MS,Mississippi,,2011,9.8,1214638,1345990,131352
28000,MS,Mississippi,,2012,8.8,1213245,1330450,117205
28000,MS,Mississippi,,2013,8.5,1164832,1273057,108225
28000,MS,Mississippi,,2014,7.6,1149277,1243934,94657
28000,MS,Mississippi,,2015,6.5,1178018,1260015,81997
28000,MS,Mississippi,,2016,5.9,1196241,1271836,75595
28000,MS,Mississippi,,2017,5.2,1206102,1272685,66583
28000,MS,Mississippi,,2018,4.9,1205737,1268435,62698
28000,MS,Mississippi,,2019,5.4,1207543,1277143,69600
28000,MS,Mississippi,,2020,7.9,1145211,1243515,98304
28000,MS,Mississippi,,2021,5.6,1184401,1254239,69838
28001,MS,Adams,,2007,6.4,12431,13288,857
28001,MS,Adams,,2008,6.6,12468,13350,882
28001,MS,Adams,,2009,9,11646,12800,1154
28001,MS,Adams,,2010,11.2,11220,12630,1410
28001,MS,Adams,,2011,10.6,11579,12948,1369
28001,MS,Adams,,2012,9.7,11281,12496,1215
28001,MS,Adams,,2013,9.3,10742,11841,1099
28001,MS,Adams,,2014,8.4,10592,11568,976
28001,MS,Adams,,2015,8.1,10461,11380,919
28001,MS,Adams,,2016,8.4,10261,11207,946
28001,MS,Adams,,2017,7.5,10368,11207,839
28001,MS,Adams,,2018,6.5,10494,11221,727
28001,MS,Adams,,2019,7.1,10353,11145,792
28001,MS,Adams,,2020,10.7,9310,10429,1119
28001,MS,Adams,,2021,8.2,9762,10634,872
28003,MS,Alcorn,,2007,6.9,14236,15297,1061
28003,MS,Alcorn,,2008,7.7,13927,15096,1169
28003,MS,Alcorn,,2009,11.7,13120,14861,1741
28003,MS,Alcorn,,2010,11.2,13978,15745,1767
28003,MS,Alcorn,,2011,10.6,14506,16227,1721
28003,MS,Alcorn,,2012,8.5,14789,16169,1380
28003,MS,Alcorn,,2013,7.7,14198,15387,1189
28003,MS,Alcorn,,2014,6.7,14071,15083,1012
28003,MS,Alcorn,,2015,5.7,14777,15671,894
28003,MS,Alcorn,,2016,5.3,14911,15747,836
28003,MS,Alcorn,,2017,4.5,15271,15998,727
28003,MS,Alcorn,,2018,4.3,15407,16092,685
28003,MS,Alcorn,,2019,4.7,15399,16165,766
28003,MS,Alcorn,,2020,6.1,14189,15117,928
28003,MS,Alcorn,,2021,4.8,14407,15128,721
28005,MS,Amite,,2007,6.4,4792,5118,326
28005,MS,Amite,,2008,7.1,4792,5158,366
28005,MS,Amite,,2009,10.5,4427,4947,520
28005,MS,Amite,,2010,11.6,4408,4987,579
28005,MS,Amite,,2011,11.2,4443,5003,560
28005,MS,Amite,,2012,9.9,4338,4812,474
28005,MS,Amite,,2013,9.1,4138,4552,414
28005,MS,Amite,,2014,8.1,4076,4435,359
28005,MS,Amite,,2015,7.7,4156,4501,345
28005,MS,Amite,,2016,7.5,4153,4489,336
28005,MS,Amite,,2017,7,4144,4454,310
28005,MS,Amite,,2018,6.3,4103,4381,278
28005,MS,Amite,,2019,7,4129,4438,309
28005,MS,Amite,,2020,8.2,4016,4375,359
28005,MS,Amite,,2021,7.3,4079,4398,319
28007,MS,Attala,,2007,7.6,6737,7294,557
28007,MS,Attala,,2008,9.1,6578,7233,655
28007,MS,Attala,,2009,13.2,6016,6929,913
28007,MS,Attala,,2010,12.2,6994,7966,972
28007,MS,Attala,,2011,10.9,7124,7999,875
28007,MS,Attala,,2012,9.6,6927,7664,737
28007,MS,Attala,,2013,9.3,6578,7253,675
28007,MS,Attala,,2014,8.8,6403,7022,619
28007,MS,Attala,,2015,7.7,6427,6964,537
28007,MS,Attala,,2016,6.8,6506,6984,478
28007,MS,Attala,,2017,6.2,6514,6945,431
28007,MS,Attala,,2018,5.8,6550,6952,402
28007,MS,Attala,,2019,6.3,6578,7020,442
28007,MS,Attala,,2020,8.2,6280,6840,560
28007,MS,Attala,,2021,6,6469,6882,413
28009,MS,Benton,,2007,9.4,2618,2891,273
28009,MS,Benton,,2008,11.2,2536,2856,320
28009,MS,Benton,,2009,14,2395,2785,390
28009,MS,Benton,,2010,12.1,2880,3278,398
28009,MS,Benton,,2011,12.1,2984,3394,410
28009,MS,Benton,,2012,10.4,2978,3324,346
28009,MS,Benton,,2013,10.4,2811,3138,327
28009,MS,Benton,,2014,9.5,2690,2971,281
28009,MS,Benton,,2015,8.1,2735,2976,241
28009,MS,Benton,,2016,6.9,2826,3034,208
28009,MS,Benton,,2017,5.7,2854,3028,174
28009,MS,Benton,,2018,5.7,2853,3027,174
28009,MS,Benton,,2019,6.2,2864,3054,190
28009,MS,Benton,,2020,8.1,2748,2991,243
28009,MS,Benton,,2021,6.4,2846,3041,195
28011,MS,Bolivar,,2007,8.1,14200,15454,1254
28011,MS,Bolivar,,2008,8.6,13820,15119,1299
28011,MS,Bolivar,,2009,10.5,13186,14729,1543
28011,MS,Bolivar,,2010,11.1,13280,14930,1650
28011,MS,Bolivar,,2011,10.9,13413,15051,1638
28011,MS,Bolivar,,2012,10.4,13033,14545,1512
28011,MS,Bolivar,,2013,10.6,12332,13800,1468
28011,MS,Bolivar,,2014,9.7,11989,13270,1281
28011,MS,Bolivar,,2015,8,12288,13351,1063
28011,MS,Bolivar,,2016,7.4,12360,13346,986
28011,MS,Bolivar,,2017,6.6,12023,12871,848
28011,MS,Bolivar,,2018,6.3,11609,12384,775
28011,MS,Bolivar,,2019,7.1,11100,11945,845
28011,MS,Bolivar,,2020,8.5,10386,11350,964
28011,MS,Bolivar,,2021,6.9,10578,11364,786
28013,MS,Calhoun,,2007,8.2,5534,6027,493
28013,MS,Calhoun,,2008,9,5395,5928,533
28013,MS,Calhoun,,2009,11,5218,5860,642
28013,MS,Calhoun,,2010,9,6409,7042,633
28013,MS,Calhoun,,2011,8.5,6527,7133,606
28013,MS,Calhoun,,2012,8.2,6263,6820,557
28013,MS,Calhoun,,2013,8.4,5870,6406,536
28013,MS,Calhoun,,2014,7.5,5751,6219,468
28013,MS,Calhoun,,2015,6.3,5737,6120,383
28013,MS,Calhoun,,2016,5.5,5819,6156,337
28013,MS,Calhoun,,2017,4.8,5348,5618,270
28013,MS,Calhoun,,2018,4.8,5289,5555,266
28013,MS,Calhoun,,2019,5.6,5268,5581,313
28013,MS,Calhoun,,2020,7.9,5077,5514,437
28013,MS,Calhoun,,2021,5.2,5138,5422,284
28015,MS,Carroll,,2007,6.4,4640,4957,317
28015,MS,Carroll,,2008,7.1,4499,4845,346
28015,MS,Carroll,,2009,10.6,4235,4737,502
28015,MS,Carroll,,2010,12.8,3347,3837,490
28015,MS,Carroll,,2011,11.9,3358,3812,454
28015,MS,Carroll,,2012,10.8,3312,3714,402
28015,MS,Carroll,,2013,10.5,3109,3474,365
28015,MS,Carroll,,2014,9.6,3076,3402,326
28015,MS,Carroll,,2015,8.3,3164,3451,287
28015,MS,Carroll,,2016,7.4,3286,3549,263
28015,MS,Carroll,,2017,6,3315,3526,211
28015,MS,Carroll,,2018,5.8,3243,3443,200
28015,MS,Carroll,,2019,6.2,3311,3530,219
28015,MS,Carroll,,2020,7.6,3134,3391,257
28015,MS,Carroll,,2021,5.8,3269,3471,202
28017,MS,Chickasaw,,2007,10.1,6631,7374,743
28017,MS,Chickasaw,,2008,10.9,6402,7185,783
28017,MS,Chickasaw,,2009,13.1,6166,7095,929
28017,MS,Chickasaw,,2010,11.7,7025,7955,930
28017,MS,Chickasaw,,2011,11.2,7347,8271,924
28017,MS,Chickasaw,,2012,10,7263,8073,810
28017,MS,Chickasaw,,2013,10.6,6805,7615,810
28017,MS,Chickasaw,,2014,9.8,6480,7186,706
28017,MS,Chickasaw,,2015,7.8,6575,7130,555
28017,MS,Chickasaw,,2016,6.7,6588,7062,474
28017,MS,Chickasaw,,2017,5.4,6673,7052,379
28017,MS,Chickasaw,,2018,5.1,6642,7002,360
28017,MS,Chickasaw,,2019,5.7,6531,6926,395
28017,MS,Chickasaw,,2020,10.6,6140,6867,727
28017,MS,Chickasaw,,2021,6.3,6437,6870,433
28019,MS,Choctaw,,2007,7.6,3192,3454,262
28019,MS,Choctaw,,2008,8,3121,3394,273
28019,MS,Choctaw,,2009,12.1,2925,3326,401
28019,MS,Choctaw,,2010,11.5,3339,3772,433
28019,MS,Choctaw,,2011,10,3436,3817,381
28019,MS,Choctaw,,2012,8.9,3429,3766,337
28019,MS,Choctaw,,2013,8.5,3431,3749,318
28019,MS,Choctaw,,2014,8.2,3273,3567,294
28019,MS,Choctaw,,2015,6.4,3465,3700,235
28019,MS,Choctaw,,2016,5.8,3496,3710,214
28019,MS,Choctaw,,2017,5.1,3425,3610,185
28019,MS,Choctaw,,2018,5,3521,3708,187
28019,MS,Choctaw,,2019,5.6,3500,3706,206
28019,MS,Choctaw,,2020,6.2,3324,3545,221
28019,MS,Choctaw,,2021,4.8,3394,3565,171
28021,MS,Claiborne,,2007,11.1,3154,3547,393
28021,MS,Claiborne,,2008,10.9,3203,3595,392
28021,MS,Claiborne,,2009,15.4,3103,3669,566
28021,MS,Claiborne,,2010,16.3,2998,3581,583
28021,MS,Claiborne,,2011,15.6,3117,3693,576
28021,MS,Claiborne,,2012,15.1,3023,3562,539
28021,MS,Claiborne,,2013,16.9,2741,3299,558
28021,MS,Claiborne,,2014,14.8,2645,3103,458
28021,MS,Claiborne,,2015,12.7,2716,3112,396
28021,MS,Claiborne,,2016,11.6,2725,3082,357
28021,MS,Claiborne,,2017,10,2718,3021,303
28021,MS,Claiborne,,2018,9.4,2731,3015,284
28021,MS,Claiborne,,2019,10.6,2766,3095,329
28021,MS,Claiborne,,2020,14.1,2630,3062,432
28021,MS,Claiborne,,2021,11.7,2632,2980,348
28023,MS,Clarke,,2007,7.4,6508,7028,520
28023,MS,Clarke,,2008,7.7,6416,6954,538
28023,MS,Clarke,,2009,11,5949,6681,732
28023,MS,Clarke,,2010,12.2,5806,6615,809
28023,MS,Clarke,,2011,11.5,5987,6767,780
28023,MS,Clarke,,2012,10.5,6081,6798,717
28023,MS,Clarke,,2013,9.9,5998,6658,660
28023,MS,Clarke,,2014,9.1,5682,6251,569
28023,MS,Clarke,,2015,8,5577,6060,483
28023,MS,Clarke,,2016,6.9,5631,6049,418
28023,MS,Clarke,,2017,6.2,5766,6146,380
28023,MS,Clarke,,2018,5.7,5605,5944,339
28023,MS,Clarke,,2019,6.2,5583,5954,371
28023,MS,Clarke,,2020,8.3,5230,5701,471
28023,MS,Clarke,,2021,6.3,5313,5669,356
28025,MS,Clay,,2007,15,6692,7876,1184
28025,MS,Clay,,2008,13.1,6306,7253,947
28025,MS,Clay,,2009,17.5,5882,7133,1251
28025,MS,Clay,,2010,16,7295,8684,1389
28025,MS,Clay,,2011,14.6,7437,8707,1270
28025,MS,Clay,,2012,13.8,7472,8668,1196
28025,MS,Clay,,2013,15.4,7101,8390,1289
28025,MS,Clay,,2014,13.4,6895,7962,1067
28025,MS,Clay,,2015,9.7,7221,7997,776
28025,MS,Clay,,2016,8.3,7326,7988,662
28025,MS,Clay,,2017,7,7184,7722,538
28025,MS,Clay,,2018,6.2,7207,7686,479
28025,MS,Clay,,2019,7.5,7264,7849,585
28025,MS,Clay,,2020,11.4,6925,7817,892
28025,MS,Clay,,2021,7.2,7453,8027,574
28027,MS,Coahoma,,2007,9,9405,10336,931
28027,MS,Coahoma,,2008,9.2,9150,10072,922
28027,MS,Coahoma,,2009,12,8722,9906,1184
28027,MS,Coahoma,,2010,13.3,9091,10489,1398
28027,MS,Coahoma,,2011,13.6,9251,10701,1450
28027,MS,Coahoma,,2012,12.3,9043,10317,1274
28027,MS,Coahoma,,2013,12.8,8555,9815,1260
28027,MS,Coahoma,,2014,11.9,8399,9532,1133
28027,MS,Coahoma,,2015,10.2,8466,9427,961
28027,MS,Coahoma,,2016,8.9,8368,9181,813
28027,MS,Coahoma,,2017,7.6,7947,8604,657
28027,MS,Coahoma,,2018,7.2,7774,8378,604
28027,MS,Coahoma,,2019,7.7,7691,8330,639
28027,MS,Coahoma,,2020,12.2,7255,8262,1007
28027,MS,Coahoma,,2021,8.8,7316,8022,706
28029,MS,Copiah,,2007,7.4,11182,12081,899
28029,MS,Copiah,,2008,7.2,11062,11926,864
28029,MS,Copiah,,2009,10.1,10539,11719,1180
28029,MS,Copiah,,2010,11.1,10677,12012,1335
28029,MS,Copiah,,2011,11.3,10893,12279,1386
28029,MS,Copiah,,2012,10.8,10695,11993,1298
28029,MS,Copiah,,2013,10.5,10278,11478,1200
28029,MS,Copiah,,2014,9,10136,11135,999
28029,MS,Copiah,,2015,7.3,10405,11227,822
28029,MS,Copiah,,2016,6.7,10482,11230,748
28029,MS,Copiah,,2017,5.9,10569,11226,657
28029,MS,Copiah,,2018,5.7,10491,11129,638
28029,MS,Copiah,,2019,6.6,10353,11090,737
28029,MS,Copiah,,2020,8.1,9782,10644,862
28029,MS,Copiah,,2021,6.5,10073,10772,699
28031,MS,Covington,,2007,5.4,8273,8745,472
28031,MS,Covington,,2008,6,8196,8721,525
28031,MS,Covington,,2009,8.1,7889,8587,698
28031,MS,Covington,,2010,9.8,7440,8252,812
28031,MS,Covington,,2011,9.1,7775,8558,783
28031,MS,Covington,,2012,8.3,7748,8449,701
28031,MS,Covington,,2013,7.8,7336,7960,624
28031,MS,Covington,,2014,6.7,7292,7813,521
28031,MS,Covington,,2015,5.9,7471,7941,470
28031,MS,Covington,,2016,5.5,7666,8116,450
28031,MS,Covington,,2017,5,7682,8083,401
28031,MS,Covington,,2018,4.6,7696,8066,370
28031,MS,Covington,,2019,4.8,7811,8207,396
28031,MS,Covington,,2020,6.7,7670,8225,555
28031,MS,Covington,,2021,5.1,7791,8214,423
28033,MS,DeSoto,,2007,3.9,73181,76189,3008
28033,MS,DeSoto,,2008,4.7,74091,77771,3680
28033,MS,DeSoto,,2009,7,70946,76313,5367
28033,MS,DeSoto,,2010,7.2,74061,79838,5777
28033,MS,DeSoto,,2011,7,77539,83395,5856
28033,MS,DeSoto,,2012,6.3,78719,84039,5320
28033,MS,DeSoto,,2013,5.9,76379,81152,4773
28033,MS,DeSoto,,2014,5.4,76686,81070,4384
28033,MS,DeSoto,,2015,4.9,80182,84286,4104
28033,MS,DeSoto,,2016,4.3,83114,86854,3740
28033,MS,DeSoto,,2017,3.9,84967,88457,3490
28033,MS,DeSoto,,2018,3.9,86949,90482,3533
28033,MS,DeSoto,,2019,4.4,88767,92898,4131
28033,MS,DeSoto,,2020,5.9,85724,91089,5365
28033,MS,DeSoto,,2021,4.4,88834,92926,4092
28035,MS,Forrest,,2007,5,34921,36769,1848
28035,MS,Forrest,,2008,5.7,34408,36495,2087
28035,MS,Forrest,,2009,7.7,33501,36309,2808
28035,MS,Forrest,,2010,9.5,30915,34157,3242
28035,MS,Forrest,,2011,9.9,31676,35146,3470
28035,MS,Forrest,,2012,8.8,31709,34775,3066
28035,MS,Forrest,,2013,8.4,30338,33107,2769
28035,MS,Forrest,,2014,7.5,29768,32177,2409
28035,MS,Forrest,,2015,6.4,30654,32740,2086
28035,MS,Forrest,,2016,5.8,31288,33231,1943
28035,MS,Forrest,,2017,5,31730,33394,1664
28035,MS,Forrest,,2018,4.6,31562,33084,1522
28035,MS,Forrest,,2019,5.2,31407,33130,1723
28035,MS,Forrest,,2020,7.9,29866,32429,2563
28035,MS,Forrest,,2021,5.7,31333,33213,1880
28037,MS,Franklin,,2007,7,2895,3114,219
28037,MS,Franklin,,2008,7.6,2820,3052,232
28037,MS,Franklin,,2009,11,2665,2994,329
28037,MS,Franklin,,2010,11.1,2881,3240,359
28037,MS,Franklin,,2011,10.6,2884,3225,341
28037,MS,Franklin,,2012,9.6,2806,3103,297
28037,MS,Franklin,,2013,9.2,2684,2956,272
28037,MS,Franklin,,2014,8.5,2653,2899,246
28037,MS,Franklin,,2015,7.8,2702,2930,228
28037,MS,Franklin,,2016,7.3,2633,2841,208
28037,MS,Franklin,,2017,7,2657,2856,199
28037,MS,Franklin,,2018,6.1,2634,2804,170
28037,MS,Franklin,,2019,6.9,2588,2780,192
28037,MS,Franklin,,2020,8.1,2487,2707,220
28037,MS,Franklin,,2021,6.8,2478,2660,182
28039,MS,George,,2007,7.2,8390,9037,647
28039,MS,George,,2008,7.5,8758,9468,710
28039,MS,George,,2009,9.9,8450,9378,928
28039,MS,George,,2010,11.2,7793,8775,982
28039,MS,George,,2011,11.9,7993,9071,1078
28039,MS,George,,2012,10,8018,8913,895
28039,MS,George,,2013,9.4,7764,8568,804
28039,MS,George,,2014,8.3,8150,8891,741
28039,MS,George,,2015,7.6,8160,8831,671
28039,MS,George,,2016,7.6,8113,8777,664
28039,MS,George,,2017,7.3,8171,8819,648
28039,MS,George,,2018,6.7,8192,8779,587
28039,MS,George,,2019,7.4,8271,8933,662
28039,MS,George,,2020,8.9,8063,8852,789
28039,MS,George,,2021,7,8136,8749,613
28041,MS,Greene,,2007,7.6,4523,4896,373
28041,MS,Greene,,2008,9.2,4460,4911,451
28041,MS,Greene,,2009,11.4,4273,4824,551
28041,MS,Greene,,2010,11.6,4055,4587,532
28041,MS,Greene,,2011,11.8,4145,4701,556
28041,MS,Greene,,2012,11,4106,4615,509
28041,MS,Greene,,2013,10.1,3988,4438,450
28041,MS,Greene,,2014,9,3987,4379,392
28041,MS,Greene,,2015,7.6,3988,4318,330
28041,MS,Greene,,2016,7.4,3951,4268,317
28041,MS,Greene,,2017,7.7,4032,4368,336
28041,MS,Greene,,2018,6.4,4008,4284,276
28041,MS,Greene,,2019,7.9,4013,4357,344
28041,MS,Greene,,2020,9.5,3843,4247,404
28041,MS,Greene,,2021,7.6,3879,4197,318
28043,MS,Grenada,,2007,7.3,8882,9577,695
28043,MS,Grenada,,2008,7.4,8791,9497,706
28043,MS,Grenada,,2009,12.1,7856,8939,1083
28043,MS,Grenada,,2010,11.2,8385,9447,1062
28043,MS,Grenada,,2011,10,8757,9731,974
28043,MS,Grenada,,2012,9,8835,9713,878
28043,MS,Grenada,,2013,8.8,8517,9337,820
28043,MS,Grenada,,2014,7.3,8591,9263,672
28043,MS,Grenada,,2015,6,8881,9449,568
28043,MS,Grenada,,2016,5.2,9063,9563,500
28043,MS,Grenada,,2017,4.7,9171,9625,454
28043,MS,Grenada,,2018,4.4,9129,9549,420
28043,MS,Grenada,,2019,5,9137,9617,480
28043,MS,Grenada,,2020,7,8506,9151,645
28043,MS,Grenada,,2021,5,8630,9083,453
28045,MS,Hancock,,2007,5.3,17200,18154,954
28045,MS,Hancock,,2008,5.6,17178,18205,1027
28045,MS,Hancock,,2009,7.9,16664,18089,1425
28045,MS,Hancock,,2010,8.7,17980,19700,1720
28045,MS,Hancock,,2011,9.3,18246,20111,1865
28045,MS,Hancock,,2012,8.3,18167,19807,1640
28045,MS,Hancock,,2013,7.8,17461,18939,1478
28045,MS,Hancock,,2014,7.3,17070,18415,1345
28045,MS,Hancock,,2015,6.6,17396,18619,1223
28045,MS,Hancock,,2016,6.2,17620,18788,1168
28045,MS,Hancock,,2017,5.7,17620,18687,1067
28045,MS,Hancock,,2018,5.2,17670,18646,976
28045,MS,Hancock,,2019,5.7,17775,18841,1066
28045,MS,Hancock,,2020,8.2,17037,18566,1529
28045,MS,Hancock,,2021,5.8,17931,19045,1114
28047,MS,Harrison,,2007,5.3,81114,85695,4581
28047,MS,Harrison,,2008,5.5,81168,85905,4737
28047,MS,Harrison,,2009,7.6,78336,84750,6414
28047,MS,Harrison,,2010,8.5,81369,88949,7580
28047,MS,Harrison,,2011,8.7,82898,90808,7910
28047,MS,Harrison,,2012,8,82714,89926,7212
28047,MS,Harrison,,2013,7.5,80193,86667,6474
28047,MS,Harrison,,2014,6.8,78755,84498,5743
28047,MS,Harrison,,2015,6,80244,85384,5140
28047,MS,Harrison,,2016,5.6,81468,86334,4866
28047,MS,Harrison,,2017,5,81617,85907,4290
28047,MS,Harrison,,2018,4.7,81731,85804,4073
28047,MS,Harrison,,2019,5.2,82294,86822,4528
28047,MS,Harrison,,2020,9.2,78493,86485,7992
28047,MS,Harrison,,2021,5.5,82697,87481,4784
28049,MS,Hinds,,2007,5.6,110451,116961,6510
28049,MS,Hinds,,2008,6,108551,115473,6922
28049,MS,Hinds,,2009,8.1,104252,113484,9232
28049,MS,Hinds,,2010,9.6,103236,114138,10902
28049,MS,Hinds,,2011,9.3,107566,118621,11055
28049,MS,Hinds,,2012,8.6,106870,116938,10068
28049,MS,Hinds,,2013,8.4,101471,110799,9328
28049,MS,Hinds,,2014,7.3,99866,107739,7873
28049,MS,Hinds,,2015,6.1,102227,108864,6637
28049,MS,Hinds,,2016,5.6,103402,109481,6079
28049,MS,Hinds,,2017,5,103552,108990,5438
28049,MS,Hinds,,2018,4.8,101675,106847,5172
28049,MS,Hinds,,2019,5.3,99638,105194,5556
28049,MS,Hinds,,2020,9.2,92650,102032,9382
28049,MS,Hinds,,2021,6.2,95588,101911,6323
28051,MS,Holmes,,2007,10.9,6339,7112,773
28051,MS,Holmes,,2008,13.1,6151,7078,927
28051,MS,Holmes,,2009,19,5625,6942,1317
28051,MS,Holmes,,2010,19.1,5535,6842,1307
28051,MS,Holmes,,2011,17.5,5688,6897,1209
28051,MS,Holmes,,2012,16.2,5593,6677,1084
28051,MS,Holmes,,2013,16.7,5252,6302,1050
28051,MS,Holmes,,2014,15.1,5198,6126,928
28051,MS,Holmes,,2015,12.2,5360,6103,743
28051,MS,Holmes,,2016,11.2,5290,5958,668
28051,MS,Holmes,,2017,9.6,5250,5810,560
28051,MS,Holmes,,2018,9.2,5165,5686,521
28051,MS,Holmes,,2019,10.2,5031,5604,573
28051,MS,Holmes,,2020,15.9,4576,5440,864
28051,MS,Holmes,,2021,11,4635,5208,573
28053,MS,Humphreys,,2007,8.8,3940,4322,382
28053,MS,Humphreys,,2008,9.8,3874,4295,421
28053,MS,Humphreys,,2009,12.4,3635,4150,515
28053,MS,Humphreys,,2010,16.8,2897,3481,584
28053,MS,Humphreys,,2011,18.1,2803,3424,621
28053,MS,Humphreys,,2012,18.7,2599,3198,599
28053,MS,Humphreys,,2013,17.1,2531,3052,521
28053,MS,Humphreys,,2014,16,2148,2557,409
28053,MS,Humphreys,,2015,12.8,2147,2462,315
28053,MS,Humphreys,,2016,11.6,2091,2366,275
28053,MS,Humphreys,,2017,9.7,1987,2200,213
28053,MS,Humphreys,,2018,9,1995,2193,198
28053,MS,Humphreys,,2019,10.2,1963,2186,223
28053,MS,Humphreys,,2020,14.4,1866,2181,315
28053,MS,Humphreys,,2021,12.7,1805,2068,263
28055,MS,Issaquena,,2007,7.7,647,701,54
28055,MS,Issaquena,,2008,8.7,621,680,59
28055,MS,Issaquena,,2009,11.3,586,661,75
28055,MS,Issaquena,,2010,15.6,442,524,82
28055,MS,Issaquena,,2011,19.8,414,516,102
28055,MS,Issaquena,,2012,17.3,393,475,82
28055,MS,Issaquena,,2013,20.4,355,446,91
28055,MS,Issaquena,,2014,17.6,351,426,75
28055,MS,Issaquena,,2015,17.2,346,418,72
28055,MS,Issaquena,,2016,14.3,343,400,57
28055,MS,Issaquena,,2017,12.2,344,392,48
28055,MS,Issaquena,,2018,9.2,336,370,34
28055,MS,Issaquena,,2019,11.9,318,361,43
28055,MS,Issaquena,,2020,8.6,298,326,28
28055,MS,Issaquena,,2021,9.3,292,322,30
28057,MS,Itawamba,,2007,7.2,9246,9960,714
28057,MS,Itawamba,,2008,8.1,9156,9967,811
28057,MS,Itawamba,,2009,11.4,8497,9588,1091
28057,MS,Itawamba,,2010,11,9236,10373,1137
28057,MS,Itawamba,,2011,9.8,9563,10597,1034
28057,MS,Itawamba,,2012,8.2,9660,10526,866
28057,MS,Itawamba,,2013,8,9232,10033,801
28057,MS,Itawamba,,2014,7.2,9153,9867,714
28057,MS,Itawamba,,2015,5.8,9587,10177,590
28057,MS,Itawamba,,2016,5.2,9818,10354,536
28057,MS,Itawamba,,2017,4.3,10038,10491,453
28057,MS,Itawamba,,2018,4.2,9939,10370,431
28057,MS,Itawamba,,2019,4.7,10009,10507,498
28057,MS,Itawamba,,2020,6.8,9461,10154,693
28057,MS,Itawamba,,2021,4.3,9883,10326,443
28059,MS,Jackson,,2007,5.5,55891,59149,3258
28059,MS,Jackson,,2008,5.8,57380,60927,3547
28059,MS,Jackson,,2009,8.2,55625,60563,4938
28059,MS,Jackson,,2010,9.2,58594,64564,5970
28059,MS,Jackson,,2011,10.2,59024,65709,6685
28059,MS,Jackson,,2012,9.3,57974,63893,5919
28059,MS,Jackson,,2013,8.8,55587,60970,5383
28059,MS,Jackson,,2014,8.1,54152,58907,4755
28059,MS,Jackson,,2015,7.1,54606,58800,4194
28059,MS,Jackson,,2016,6.7,54898,58850,3952
28059,MS,Jackson,,2017,6.1,54842,58393,3551
28059,MS,Jackson,,2018,5.8,54849,58221,3372
28059,MS,Jackson,,2019,6.1,54983,58559,3576
28059,MS,Jackson,,2020,9.3,52314,57693,5379
28059,MS,Jackson,,2021,6,55139,58667,3528
28061,MS,Jasper,,2007,6.1,7041,7498,457
28061,MS,Jasper,,2008,7.1,6910,7439,529
28061,MS,Jasper,,2009,10.5,6352,7097,745
28061,MS,Jasper,,2010,11.9,6186,7024,838
28061,MS,Jasper,,2011,11.2,6390,7199,809
28061,MS,Jasper,,2012,10,6270,6964,694
28061,MS,Jasper,,2013,9.9,5872,6516,644
28061,MS,Jasper,,2014,8.6,5862,6413,551
28061,MS,Jasper,,2015,7.9,5843,6345,502
28061,MS,Jasper,,2016,7.8,5684,6166,482
28061,MS,Jasper,,2017,6.7,5664,6072,408
28061,MS,Jasper,,2018,6.1,5624,5987,363
28061,MS,Jasper,,2019,6.8,5814,6240,426
28061,MS,Jasper,,2020,8.8,5449,5972,523
28061,MS,Jasper,,2021,7.3,5395,5817,422
28063,MS,Jefferson,,2007,13.3,2395,2761,366
28063,MS,Jefferson,,2008,13.3,2407,2777,370
28063,MS,Jefferson,,2009,16.5,2337,2798,461
28063,MS,Jefferson,,2010,18.3,2017,2470,453
28063,MS,Jefferson,,2011,18.2,2077,2540,463
28063,MS,Jefferson,,2012,17.1,2106,2539,433
28063,MS,Jefferson,,2013,19.2,2005,2480,475
28063,MS,Jefferson,,2014,16.3,2009,2399,390
28063,MS,Jefferson,,2015,15.1,1930,2273,343
28063,MS,Jefferson,,2016,15.2,1884,2221,337
28063,MS,Jefferson,,2017,15,1802,2120,318
28063,MS,Jefferson,,2018,13.4,1752,2024,272
28063,MS,Jefferson,,2019,15.7,1695,2011,316
28063,MS,Jefferson,,2020,18,1605,1957,352
28063,MS,Jefferson,,2021,16.6,1601,1919,318
28065,MS,Jefferson Davis,,2007,7.1,4843,5213,370
28065,MS,Jefferson Davis,,2008,7,5176,5565,389
28065,MS,Jefferson Davis,,2009,10.3,4600,5129,529
28065,MS,Jefferson Davis,,2010,13.7,3982,4613,631
28065,MS,Jefferson Davis,,2011,13.6,4011,4644,633
28065,MS,Jefferson Davis,,2012,12.7,3931,4502,571
28065,MS,Jefferson Davis,,2013,12.6,3690,4220,530
28065,MS,Jefferson Davis,,2014,10.3,3682,4107,425
28065,MS,Jefferson Davis,,2015,8.8,3753,4117,364
28065,MS,Jefferson Davis,,2016,8.4,3814,4165,351
28065,MS,Jefferson Davis,,2017,7,3933,4229,296
28065,MS,Jefferson Davis,,2018,6.9,3814,4095,281
28065,MS,Jefferson Davis,,2019,6.9,3817,4102,285
28065,MS,Jefferson Davis,,2020,9.4,3573,3944,371
28065,MS,Jefferson Davis,,2021,7.7,3596,3897,301
28067,MS,Jones,,2007,4.6,29630,31064,1434
28067,MS,Jones,,2008,5.3,28975,30588,1613
28067,MS,Jones,,2009,7.3,27334,29500,2166
28067,MS,Jones,,2010,8.9,25515,27996,2481
28067,MS,Jones,,2011,8.4,26760,29204,2444
28067,MS,Jones,,2012,7.4,26893,29047,2154
28067,MS,Jones,,2013,7,25441,27362,1921
28067,MS,Jones,,2014,6.2,24921,26582,1661
28067,MS,Jones,,2015,6.1,24860,26470,1610
28067,MS,Jones,,2016,6.3,24075,25680,1605
28067,MS,Jones,,2017,5.3,24004,25352,1348
28067,MS,Jones,,2018,5,24270,25550,1280
28067,MS,Jones,,2019,5.3,24996,26402,1406
28067,MS,Jones,,2020,6.9,23412,25160,1748
28067,MS,Jones,,2021,5.7,23206,24598,1392
28069,MS,Kemper,,2007,7.8,3757,4077,320
28069,MS,Kemper,,2008,8.3,3658,3987,329
28069,MS,Kemper,,2009,12.4,3379,3858,479
28069,MS,Kemper,,2010,14.4,3348,3909,561
28069,MS,Kemper,,2011,14,3374,3922,548
28069,MS,Kemper,,2012,12.9,3494,4011,517
28069,MS,Kemper,,2013,12.8,3450,3957,507
28069,MS,Kemper,,2014,12.9,3259,3741,482
28069,MS,Kemper,,2015,10.5,3194,3568,374
28069,MS,Kemper,,2016,8.9,3225,3540,315
28069,MS,Kemper,,2017,8,3302,3588,286
28069,MS,Kemper,,2018,7.6,3293,3565,272
28069,MS,Kemper,,2019,7.8,3208,3481,273
28069,MS,Kemper,,2020,9.4,3000,3311,311
28069,MS,Kemper,,2021,7.4,3038,3282,244
28071,MS,Lafayette,,2007,4.8,20891,21939,1048
28071,MS,Lafayette,,2008,5.3,20845,22014,1169
28071,MS,Lafayette,,2009,7.9,19778,21469,1691
28071,MS,Lafayette,,2010,9.1,19732,21700,1968
28071,MS,Lafayette,,2011,8.4,21063,22995,1932
28071,MS,Lafayette,,2012,7.6,21823,23608,1785
28071,MS,Lafayette,,2013,7.1,21408,23049,1641
28071,MS,Lafayette,,2014,6.5,21699,23202,1503
28071,MS,Lafayette,,2015,5.5,23018,24368,1350
28071,MS,Lafayette,,2016,5,24579,25868,1289
28071,MS,Lafayette,,2017,4.3,26294,27467,1173
28071,MS,Lafayette,,2018,4,26963,28093,1130
28071,MS,Lafayette,,2019,4.4,26782,28013,1231
28071,MS,Lafayette,,2020,5.9,24724,26288,1564
28071,MS,Lafayette,,2021,4.1,26498,27635,1137
28073,MS,Lamar,,2007,4.3,22664,23673,1009
28073,MS,Lamar,,2008,4.7,22654,23780,1126
28073,MS,Lamar,,2009,6.6,21985,23536,1551
28073,MS,Lamar,,2010,7,25805,27740,1935
28073,MS,Lamar,,2011,7,26602,28595,1993
28073,MS,Lamar,,2012,6.3,26659,28456,1797
28073,MS,Lamar,,2013,5.9,25929,27548,1619
28073,MS,Lamar,,2014,5.2,26247,27681,1434
28073,MS,Lamar,,2015,4.9,27400,28807,1407
28073,MS,Lamar,,2016,4.6,28097,29464,1367
28073,MS,Lamar,,2017,3.9,28912,30096,1184
28073,MS,Lamar,,2018,3.8,29429,30586,1157
28073,MS,Lamar,,2019,4.3,29752,31074,1322
28073,MS,Lamar,,2020,5.9,28592,30383,1791
28073,MS,Lamar,,2021,4.1,30012,31299,1287
28075,MS,Lauderdale,,2007,6.4,30896,33017,2121
28075,MS,Lauderdale,,2008,6.8,30945,33206,2261
28075,MS,Lauderdale,,2009,9.3,29319,32343,3024
28075,MS,Lauderdale,,2010,10.3,29694,33113,3419
28075,MS,Lauderdale,,2011,10,31008,34452,3444
28075,MS,Lauderdale,,2012,8.9,31846,34940,3094
28075,MS,Lauderdale,,2013,8.3,31730,34600,2870
28075,MS,Lauderdale,,2014,7.6,30006,32464,2458
28075,MS,Lauderdale,,2015,6.6,29466,31562,2096
28075,MS,Lauderdale,,2016,6,29740,31639,1899
28075,MS,Lauderdale,,2017,5.5,29988,31724,1736
28075,MS,Lauderdale,,2018,5.1,29162,30736,1574
28075,MS,Lauderdale,,2019,5.5,28678,30347,1669
28075,MS,Lauderdale,,2020,7.4,27065,29215,2150
28075,MS,Lauderdale,,2021,5.4,27504,29077,1573
28077,MS,Lawrence,,2007,7.6,4723,5111,388
28077,MS,Lawrence,,2008,7.9,4857,5271,414
28077,MS,Lawrence,,2009,11,4559,5122,563
28077,MS,Lawrence,,2010,11.6,4558,5156,598
28077,MS,Lawrence,,2011,11.4,4509,5087,578
28077,MS,Lawrence,,2012,10.1,4489,4993,504
28077,MS,Lawrence,,2013,9.2,4285,4719,434
28077,MS,Lawrence,,2014,8.4,4128,4506,378
28077,MS,Lawrence,,2015,7.3,4386,4732,346
28077,MS,Lawrence,,2016,7.3,4317,4655,338
28077,MS,Lawrence,,2017,6.7,4364,4678,314
28077,MS,Lawrence,,2018,6.1,4355,4637,282
28077,MS,Lawrence,,2019,6.9,4319,4638,319
28077,MS,Lawrence,,2020,8.5,4212,4604,392
28077,MS,Lawrence,,2021,6.9,4294,4613,319
28079,MS,Leake,,2007,6.4,7571,8089,518
28079,MS,Leake,,2008,6.8,7792,8362,570
28079,MS,Leake,,2009,9.1,7666,8434,768
28079,MS,Leake,,2010,9.4,8332,9196,864
28079,MS,Leake,,2011,9.5,8046,8890,844
28079,MS,Leake,,2012,9,7724,8492,768
28079,MS,Leake,,2013,8.5,7422,8112,690
28079,MS,Leake,,2014,7.2,7245,7806,561
28079,MS,Leake,,2015,6.2,7376,7866,490
28079,MS,Leake,,2016,6.2,7242,7720,478
28079,MS,Leake,,2017,5.9,7130,7576,446
28079,MS,Leake,,2018,5.2,7424,7828,404
28079,MS,Leake,,2019,5.6,7593,8040,447
28079,MS,Leake,,2020,7.7,7319,7930,611
28079,MS,Leake,,2021,5.6,7457,7900,443
28081,MS,Lee,,2007,6.2,35054,37358,2304
28081,MS,Lee,,2008,7,34840,37456,2616
28081,MS,Lee,,2009,10.4,32890,36704,3814
28081,MS,Lee,,2010,10.1,35293,39265,3972
28081,MS,Lee,,2011,9.4,37285,41168,3883
28081,MS,Lee,,2012,8.2,38101,41488,3387
28081,MS,Lee,,2013,7.9,36430,39576,3146
28081,MS,Lee,,2014,7.3,35890,38705,2815
28081,MS,Lee,,2015,5.6,37495,39726,2231
28081,MS,Lee,,2016,5,38598,40620,2022
28081,MS,Lee,,2017,4.1,39344,41036,1692
28081,MS,Lee,,2018,4,39067,40687,1620
28081,MS,Lee,,2019,4.4,39628,41443,1815
28081,MS,Lee,,2020,8,37573,40820,3247
28081,MS,Lee,,2021,4.6,39311,41213,1902
28083,MS,Leflore,,2007,8,12621,13722,1101
28083,MS,Leflore,,2008,8.9,12197,13391,1194
28083,MS,Leflore,,2009,12.4,11375,12984,1609
28083,MS,Leflore,,2010,14.9,9876,11608,1732
28083,MS,Leflore,,2011,14.6,9943,11639,1696
28083,MS,Leflore,,2012,13.8,9757,11315,1558
28083,MS,Leflore,,2013,14.2,9215,10740,1525
28083,MS,Leflore,,2014,12.7,9186,10528,1342
28083,MS,Leflore,,2015,10.9,9325,10466,1141
28083,MS,Leflore,,2016,9.3,9343,10296,953
28083,MS,Leflore,,2017,7.6,9342,10115,773
28083,MS,Leflore,,2018,7.1,9235,9942,707
28083,MS,Leflore,,2019,7.6,9158,9909,751
28083,MS,Leflore,,2020,10.4,8741,9760,1019
28083,MS,Leflore,,2021,8.1,9131,9941,810
28085,MS,Lincoln,,2007,6.5,13197,14112,915
28085,MS,Lincoln,,2008,7.3,12961,13983,1022
28085,MS,Lincoln,,2009,10.1,12205,13581,1376
28085,MS,Lincoln,,2010,10.2,13007,14487,1480
28085,MS,Lincoln,,2011,9.5,13448,14865,1417
28085,MS,Lincoln,,2012,8.4,13334,14564,1230
28085,MS,Lincoln,,2013,7.6,12859,13924,1065
28085,MS,Lincoln,,2014,6.7,12783,13698,915
28085,MS,Lincoln,,2015,6.1,13310,14182,872
28085,MS,Lincoln,,2016,5.8,13524,14358,834
28085,MS,Lincoln,,2017,5.3,13740,14516,776
28085,MS,Lincoln,,2018,4.8,13870,14576,706
28085,MS,Lincoln,,2019,5.6,13811,14636,825
28085,MS,Lincoln,,2020,7.2,13256,14288,1032
28085,MS,Lincoln,,2021,5,14032,14774,742
28087,MS,Lowndes,,2007,7.5,24055,26010,1955
28087,MS,Lowndes,,2008,7.7,23663,25637,1974
28087,MS,Lowndes,,2009,10.5,22368,24979,2611
28087,MS,Lowndes,,2010,11.5,23166,26184,3018
28087,MS,Lowndes,,2011,10.3,24565,27382,2817
28087,MS,Lowndes,,2012,9,25319,27811,2492
28087,MS,Lowndes,,2013,9.2,24493,26987,2494
28087,MS,Lowndes,,2014,8.8,22968,25189,2221
28087,MS,Lowndes,,2015,7.1,23264,25047,1783
28087,MS,Lowndes,,2016,6.3,23813,25405,1592
28087,MS,Lowndes,,2017,5.5,23851,25241,1390
28087,MS,Lowndes,,2018,5,23874,25130,1256
28087,MS,Lowndes,,2019,5.3,24376,25732,1356
28087,MS,Lowndes,,2020,8.2,22625,24640,2015
28087,MS,Lowndes,,2021,5.9,23333,24797,1464
28089,MS,Madison,,2007,4.7,42895,45024,2129
28089,MS,Madison,,2008,5.2,43354,45719,2365
28089,MS,Madison,,2009,6.8,42427,45510,3083
28089,MS,Madison,,2010,7.2,45347,48853,3506
28089,MS,Madison,,2011,6.7,47452,50872,3420
28089,MS,Madison,,2012,6.1,47856,50971,3115
28089,MS,Madison,,2013,5.8,46896,49794,2898
28089,MS,Madison,,2014,5.3,46959,49596,2637
28089,MS,Madison,,2015,4.6,49085,51473,2388
28089,MS,Madison,,2016,4.4,50769,53109,2340
28089,MS,Madison,,2017,4,50971,53096,2125
28089,MS,Madison,,2018,3.8,51080,53114,2034
28089,MS,Madison,,2019,4.4,51497,53868,2371
28089,MS,Madison,,2020,6.4,48986,52326,3340
28089,MS,Madison,,2021,4.3,50539,52799,2260
28091,MS,Marion,,2007,6.3,9600,10249,649
28091,MS,Marion,,2008,7.1,9573,10303,730
28091,MS,Marion,,2009,10,9248,10281,1033
28091,MS,Marion,,2010,11.9,9307,10560,1253
28091,MS,Marion,,2011,10.4,9804,10948,1144
28091,MS,Marion,,2012,10,9391,10440,1049
28091,MS,Marion,,2013,9.4,9008,9940,932
28091,MS,Marion,,2014,8.3,9044,9862,818
28091,MS,Marion,,2015,7.4,9241,9979,738
28091,MS,Marion,,2016,6.7,9537,10221,684
28091,MS,Marion,,2017,5.6,9604,10179,575
28091,MS,Marion,,2018,5.3,9488,10018,530
28091,MS,Marion,,2019,5.5,9450,10003,553
28091,MS,Marion,,2020,7,9293,9988,695
28091,MS,Marion,,2021,5.3,9725,10268,543
28093,MS,Marshall,,2007,7.5,14147,15293,1146
28093,MS,Marshall,,2008,8.2,13981,15225,1244
28093,MS,Marshall,,2009,11.7,12982,14696,1714
28093,MS,Marshall,,2010,11.7,13696,15519,1823
28093,MS,Marshall,,2011,11.4,13995,15803,1808
28093,MS,Marshall,,2012,10.6,13898,15553,1655
28093,MS,Marshall,,2013,10.1,13316,14812,1496
28093,MS,Marshall,,2014,8.8,13059,14315,1256
28093,MS,Marshall,,2015,7.3,13349,14402,1053
28093,MS,Marshall,,2016,6.2,13600,14492,892
28093,MS,Marshall,,2017,5.3,13588,14350,762
28093,MS,Marshall,,2018,5.1,13604,14342,738
28093,MS,Marshall,,2019,5.8,13610,14445,835
28093,MS,Marshall,,2020,7.4,12929,13964,1035
28093,MS,Marshall,,2021,5.8,13391,14217,826
28095,MS,Monroe,,2007,9.3,14893,16416,1523
28095,MS,Monroe,,2008,9.8,14175,15711,1536
28095,MS,Monroe,,2009,13.6,13363,15472,2109
28095,MS,Monroe,,2010,12.8,14231,16319,2088
28095,MS,Monroe,,2011,11.8,14651,16607,1956
28095,MS,Monroe,,2012,10.8,14536,16305,1769
28095,MS,Monroe,,2013,11.7,13693,15510,1817
28095,MS,Monroe,,2014,10.2,13848,15418,1570
28095,MS,Monroe,,2015,7.5,14285,15439,1154
28095,MS,Monroe,,2016,6.4,14567,15569,1002
28095,MS,Monroe,,2017,5.3,14720,15544,824
28095,MS,Monroe,,2018,5,14634,15409,775
28095,MS,Monroe,,2019,5.4,14777,15627,850
28095,MS,Monroe,,2020,8.7,14118,15464,1346
28095,MS,Monroe,,2021,5.2,14938,15758,820
28097,MS,Montgomery,,2007,9.2,4049,4459,410
28097,MS,Montgomery,,2008,8.8,4057,4448,391
28097,MS,Montgomery,,2009,13.7,3879,4497,618
28097,MS,Montgomery,,2010,13.4,4051,4678,627
28097,MS,Montgomery,,2011,12.1,4117,4685,568
28097,MS,Montgomery,,2012,11.4,4064,4589,525
28097,MS,Montgomery,,2013,11.2,3884,4376,492
28097,MS,Montgomery,,2014,9.3,3791,4181,390
28097,MS,Montgomery,,2015,7.9,3859,4188,329
28097,MS,Montgomery,,2016,6.5,3943,4218,275
28097,MS,Montgomery,,2017,5.2,3936,4153,217
28097,MS,Montgomery,,2018,5.5,3781,3999,218
28097,MS,Montgomery,,2019,6,3709,3946,237
28097,MS,Montgomery,,2020,7.9,3556,3860,304
28097,MS,Montgomery,,2021,6.1,3641,3877,236
28099,MS,Neshoba,,2007,5.1,13171,13878,707
28099,MS,Neshoba,,2008,5.4,13195,13949,754
28099,MS,Neshoba,,2009,9.1,12113,13331,1218
28099,MS,Neshoba,,2010,10.1,10634,11829,1195
28099,MS,Neshoba,,2011,9.1,10908,12001,1093
28099,MS,Neshoba,,2012,8.2,10813,11777,964
28099,MS,Neshoba,,2013,7.8,10114,10964,850
28099,MS,Neshoba,,2014,6.9,10007,10743,736
28099,MS,Neshoba,,2015,6.2,9933,10592,659
28099,MS,Neshoba,,2016,5.9,10027,10652,625
28099,MS,Neshoba,,2017,5.3,9813,10364,551
28099,MS,Neshoba,,2018,5.2,9629,10152,523
28099,MS,Neshoba,,2019,5.9,9730,10343,613
28099,MS,Neshoba,,2020,9.1,9313,10246,933
28099,MS,Neshoba,,2021,5.6,9472,10035,563
28101,MS,Newton,,2007,5.6,8959,9495,536
28101,MS,Newton,,2008,6.6,8736,9354,618
28101,MS,Newton,,2009,9.1,8213,9033,820
28101,MS,Newton,,2010,9.8,8317,9221,904
28101,MS,Newton,,2011,9,8568,9418,850
28101,MS,Newton,,2012,7.8,8631,9361,730
28101,MS,Newton,,2013,7.4,8319,8985,666
28101,MS,Newton,,2014,6.7,8154,8743,589
28101,MS,Newton,,2015,6.2,8152,8692,540
28101,MS,Newton,,2016,6,8085,8603,518
28101,MS,Newton,,2017,5.2,8436,8900,464
28101,MS,Newton,,2018,4.9,8328,8758,430
28101,MS,Newton,,2019,5.7,7899,8374,475
28101,MS,Newton,,2020,7.8,7324,7940,616
28101,MS,Newton,,2021,5.4,7703,8146,443
28103,MS,Noxubee,,2007,12.6,3488,3990,502
28103,MS,Noxubee,,2008,13.8,3258,3778,520
28103,MS,Noxubee,,2009,18.3,3001,3675,674
28103,MS,Noxubee,,2010,15.4,3751,4432,681
28103,MS,Noxubee,,2011,14.2,3760,4384,624
28103,MS,Noxubee,,2012,12.9,3705,4252,547
28103,MS,Noxubee,,2013,13.4,3543,4089,546
28103,MS,Noxubee,,2014,12.6,3491,3996,505
28103,MS,Noxubee,,2015,9.9,3553,3944,391
28103,MS,Noxubee,,2016,8.4,3616,3949,333
28103,MS,Noxubee,,2017,7.5,3601,3894,293
28103,MS,Noxubee,,2018,6.9,3539,3802,263
28103,MS,Noxubee,,2019,7.3,3497,3773,276
28103,MS,Noxubee,,2020,10.9,3365,3776,411
28103,MS,Noxubee,,2021,8.9,3276,3597,321
28105,MS,Oktibbeha,,2007,6.6,18458,19768,1310
28105,MS,Oktibbeha,,2008,6.3,18972,20248,1276
28105,MS,Oktibbeha,,2009,8.7,18117,19835,1718
28105,MS,Oktibbeha,,2010,9.9,19580,21743,2163
28105,MS,Oktibbeha,,2011,9.3,20694,22826,2132
28105,MS,Oktibbeha,,2012,8.2,21137,23029,1892
28105,MS,Oktibbeha,,2013,7.9,20463,22220,1757
28105,MS,Oktibbeha,,2014,7.2,20411,22002,1591
28105,MS,Oktibbeha,,2015,6.2,21034,22425,1391
28105,MS,Oktibbeha,,2016,5.5,21675,22946,1271
28105,MS,Oktibbeha,,2017,5.1,21047,22181,1134
28105,MS,Oktibbeha,,2018,4.9,21248,22334,1086
28105,MS,Oktibbeha,,2019,5.6,21470,22752,1282
28105,MS,Oktibbeha,,2020,7.5,20156,21799,1643
28105,MS,Oktibbeha,,2021,5.5,21246,22478,1232
28107,MS,Panola,,2007,8,13689,14879,1190
28107,MS,Panola,,2008,8.5,13336,14570,1234
28107,MS,Panola,,2009,12.1,12770,14525,1755
28107,MS,Panola,,2010,13.2,12521,14422,1901
28107,MS,Panola,,2011,12.9,12830,14731,1901
28107,MS,Panola,,2012,11.9,12728,14449,1721
28107,MS,Panola,,2013,11.9,12058,13679,1621
28107,MS,Panola,,2014,10.7,11951,13377,1426
28107,MS,Panola,,2015,8.8,12222,13404,1182
28107,MS,Panola,,2016,7.5,12143,13128,985
28107,MS,Panola,,2017,6.9,12135,13035,900
28107,MS,Panola,,2018,6.2,12024,12822,798
28107,MS,Panola,,2019,6.6,11823,12660,837
28107,MS,Panola,,2020,9.6,11350,12554,1204
28107,MS,Panola,,2021,7.1,11686,12578,892
28109,MS,Pearl River,,2007,6,20159,21435,1276
28109,MS,Pearl River,,2008,6.7,19810,21237,1427
28109,MS,Pearl River,,2009,8.9,19045,20910,1865
28109,MS,Pearl River,,2010,9.2,21307,23474,2167
28109,MS,Pearl River,,2011,9.1,22152,24373,2221
28109,MS,Pearl River,,2012,8.1,22093,24032,1939
28109,MS,Pearl River,,2013,7.4,21155,22838,1683
28109,MS,Pearl River,,2014,6.7,20754,22256,1502
28109,MS,Pearl River,,2015,6.2,21374,22794,1420
28109,MS,Pearl River,,2016,6.1,21706,23116,1410
28109,MS,Pearl River,,2017,5.4,22137,23403,1266
28109,MS,Pearl River,,2018,4.9,22346,23491,1145
28109,MS,Pearl River,,2019,5.3,22472,23729,1257
28109,MS,Pearl River,,2020,7.1,21303,22926,1623
28109,MS,Pearl River,,2021,5.6,22005,23318,1313
28111,MS,Perry,,2007,6.8,4743,5090,347
28111,MS,Perry,,2008,8.2,4615,5029,414
28111,MS,Perry,,2009,10.6,4330,4844,514
28111,MS,Perry,,2010,13.3,4024,4642,618
28111,MS,Perry,,2011,12.9,4074,4680,606
28111,MS,Perry,,2012,11.3,3977,4483,506
28111,MS,Perry,,2013,10.4,3811,4251,440
28111,MS,Perry,,2014,9.2,3807,4195,388
28111,MS,Perry,,2015,8.1,3956,4303,347
28111,MS,Perry,,2016,7.3,4023,4339,316
28111,MS,Perry,,2017,6.5,4032,4312,280
28111,MS,Perry,,2018,6.1,4000,4258,258
28111,MS,Perry,,2019,6.8,4005,4298,293
28111,MS,Perry,,2020,8.6,3777,4132,355
28111,MS,Perry,,2021,6.5,3957,4234,277
28113,MS,Pike,,2007,6.7,14281,15301,1020
28113,MS,Pike,,2008,7.1,14447,15543,1096
28113,MS,Pike,,2009,10,13517,15015,1498
28113,MS,Pike,,2010,11.3,13871,15636,1765
28113,MS,Pike,,2011,11.3,14010,15795,1785
28113,MS,Pike,,2012,10.3,13834,15426,1592
28113,MS,Pike,,2013,9.8,13219,14650,1431
28113,MS,Pike,,2014,8.4,13285,14498,1213
28113,MS,Pike,,2015,7.4,13568,14652,1084
28113,MS,Pike,,2016,6.9,13597,14608,1011
28113,MS,Pike,,2017,6.2,13539,14441,902
28113,MS,Pike,,2018,6,13586,14448,862
28113,MS,Pike,,2019,6.6,13577,14531,954
28113,MS,Pike,,2020,8.8,13142,14404,1262
28113,MS,Pike,,2021,7.1,13381,14405,1024
28115,MS,Pontotoc,,2007,6.5,12239,13093,854
28115,MS,Pontotoc,,2008,7.8,12105,13128,1023
28115,MS,Pontotoc,,2009,10.1,11416,12694,1278
28115,MS,Pontotoc,,2010,9.9,12344,13700,1356
28115,MS,Pontotoc,,2011,9.1,12772,14052,1280
28115,MS,Pontotoc,,2012,7.6,13143,14230,1087
28115,MS,Pontotoc,,2013,7.3,12671,13676,1005
28115,MS,Pontotoc,,2014,6.9,12518,13439,921
28115,MS,Pontotoc,,2015,5.6,13050,13831,781
28115,MS,Pontotoc,,2016,4.8,13673,14367,694
28115,MS,Pontotoc,,2017,4,14040,14619,579
28115,MS,Pontotoc,,2018,4,14013,14591,578
28115,MS,Pontotoc,,2019,4.4,14324,14978,654
28115,MS,Pontotoc,,2020,7.5,13723,14843,1120
28115,MS,Pontotoc,,2021,4.4,14341,15007,666
28117,MS,Prentiss,,2007,7.5,10189,11021,832
28117,MS,Prentiss,,2008,8.1,10156,11056,900
28117,MS,Prentiss,,2009,12.7,9431,10807,1376
28117,MS,Prentiss,,2010,11.5,10288,11621,1333
28117,MS,Prentiss,,2011,10.2,10562,11758,1196
28117,MS,Prentiss,,2012,8.4,10568,11543,975
28117,MS,Prentiss,,2013,8.4,10032,10952,920
28117,MS,Prentiss,,2014,7.6,10004,10822,818
28117,MS,Prentiss,,2015,6.1,10287,10960,673
28117,MS,Prentiss,,2016,5.6,10398,11011,613
28117,MS,Prentiss,,2017,4.7,10656,11179,523
28117,MS,Prentiss,,2018,4.4,10729,11226,497
28117,MS,Prentiss,,2019,4.9,10812,11365,553
28117,MS,Prentiss,,2020,6.8,10290,11038,748
28117,MS,Prentiss,,2021,4.4,10777,11272,495
28119,MS,Quitman,,2007,8.3,3440,3750,310
28119,MS,Quitman,,2008,8.9,3262,3581,319
28119,MS,Quitman,,2009,12.3,3008,3428,420
28119,MS,Quitman,,2010,14.5,2735,3198,463
28119,MS,Quitman,,2011,14.6,2671,3126,455
28119,MS,Quitman,,2012,13.7,2589,2999,410
28119,MS,Quitman,,2013,14.8,2436,2858,422
28119,MS,Quitman,,2014,13.2,2382,2744,362
28119,MS,Quitman,,2015,10.9,2389,2681,292
28119,MS,Quitman,,2016,9.9,2348,2607,259
28119,MS,Quitman,,2017,9.2,2204,2426,222
28119,MS,Quitman,,2018,7.9,2170,2356,186
28119,MS,Quitman,,2019,8.2,2136,2327,191
28119,MS,Quitman,,2020,10.6,2082,2329,247
28119,MS,Quitman,,2021,8.5,2137,2335,198
28121,MS,Rankin,,2007,4,69528,72413,2885
28121,MS,Rankin,,2008,4.2,70010,73086,3076
28121,MS,Rankin,,2009,5.9,68303,72610,4307
28121,MS,Rankin,,2010,6.7,66343,71072,4729
28121,MS,Rankin,,2011,6.2,69149,73738,4589
28121,MS,Rankin,,2012,5.6,69466,73608,4142
28121,MS,Rankin,,2013,5.2,67569,71275,3706
28121,MS,Rankin,,2014,4.7,67418,70738,3320
28121,MS,Rankin,,2015,4.2,69701,72763,3062
28121,MS,Rankin,,2016,4,71558,74573,3015
28121,MS,Rankin,,2017,3.7,73065,75855,2790
28121,MS,Rankin,,2018,3.6,73331,76035,2704
28121,MS,Rankin,,2019,4,74146,77216,3070
28121,MS,Rankin,,2020,5.2,70439,74275,3836
28121,MS,Rankin,,2021,3.6,72669,75393,2724
28123,MS,Scott,,2007,4.9,12510,13160,650
28123,MS,Scott,,2008,5.1,12668,13343,675
28123,MS,Scott,,2009,6.9,12482,13410,928
28123,MS,Scott,,2010,7.8,12534,13588,1054
28123,MS,Scott,,2011,8.3,12574,13706,1132
28123,MS,Scott,,2012,7.5,12248,13235,987
28123,MS,Scott,,2013,6.6,11911,12748,837
28123,MS,Scott,,2014,5.5,11926,12626,700
28123,MS,Scott,,2015,4.9,12310,12940,630
28123,MS,Scott,,2016,4.7,12579,13197,618
28123,MS,Scott,,2017,4.2,12445,12996,551
28123,MS,Scott,,2018,4.1,12378,12903,525
28123,MS,Scott,,2019,4.5,12246,12820,574
28123,MS,Scott,,2020,5.8,11718,12433,715
28123,MS,Scott,,2021,4.7,11763,12338,575
28125,MS,Sharkey,,2007,8.3,2319,2529,210
28125,MS,Sharkey,,2008,8.6,2247,2458,211
28125,MS,Sharkey,,2009,10.6,2126,2379,253
28125,MS,Sharkey,,2010,14.1,1769,2060,291
28125,MS,Sharkey,,2011,14.3,1738,2027,289
28125,MS,Sharkey,,2012,13.3,1696,1956,260
28125,MS,Sharkey,,2013,13,1605,1844,239
28125,MS,Sharkey,,2014,11.1,1568,1764,196
28125,MS,Sharkey,,2015,9.8,1555,1723,168
28125,MS,Sharkey,,2016,9,1555,1708,153
28125,MS,Sharkey,,2017,8.2,1479,1611,132
28125,MS,Sharkey,,2018,7.5,1485,1606,121
28125,MS,Sharkey,,2019,9.1,1344,1479,135
28125,MS,Sharkey,,2020,10.7,1296,1451,155
28125,MS,Sharkey,,2021,9.4,1270,1401,131
28127,MS,Simpson,,2007,5.5,10839,11474,635
28127,MS,Simpson,,2008,6,10798,11482,684
28127,MS,Simpson,,2009,8.5,10329,11285,956
28127,MS,Simpson,,2010,9.1,10358,11401,1043
28127,MS,Simpson,,2011,8.9,10574,11610,1036
28127,MS,Simpson,,2012,8.1,10485,11407,922
28127,MS,Simpson,,2013,7.4,10147,10954,807
28127,MS,Simpson,,2014,6.5,10032,10726,694
28127,MS,Simpson,,2015,6,10216,10864,648
28127,MS,Simpson,,2016,5.6,10278,10882,604
28127,MS,Simpson,,2017,5,10368,10916,548
28127,MS,Simpson,,2018,4.7,10213,10718,505
28127,MS,Simpson,,2019,5.2,10209,10770,561
28127,MS,Simpson,,2020,6.7,9677,10367,690
28127,MS,Simpson,,2021,5.2,9967,10514,547
28129,MS,Smith,,2007,5.4,6315,6678,363
28129,MS,Smith,,2008,6.5,6008,6428,420
28129,MS,Smith,,2009,9,5712,6278,566
28129,MS,Smith,,2010,8.8,6684,7330,646
28129,MS,Smith,,2011,8,6825,7419,594
28129,MS,Smith,,2012,7.1,6662,7173,511
28129,MS,Smith,,2013,6.7,6386,6844,458
28129,MS,Smith,,2014,5.8,6311,6702,391
28129,MS,Smith,,2015,5.4,6367,6732,365
28129,MS,Smith,,2016,5.4,6346,6707,361
28129,MS,Smith,,2017,4.9,6413,6742,329
28129,MS,Smith,,2018,4.6,6440,6748,308
28129,MS,Smith,,2019,5.2,6453,6810,357
28129,MS,Smith,,2020,5.7,6170,6540,370
28129,MS,Smith,,2021,4.5,6264,6560,296
28131,MS,Stone,,2007,5.7,7205,7639,434
28131,MS,Stone,,2008,5.9,7249,7701,452
28131,MS,Stone,,2009,7.9,7145,7754,609
28131,MS,Stone,,2010,10.3,6149,6855,706
28131,MS,Stone,,2011,10.5,6314,7056,742
28131,MS,Stone,,2012,10.1,6079,6763,684
28131,MS,Stone,,2013,9.5,5851,6464,613
28131,MS,Stone,,2014,8.6,5768,6313,545
28131,MS,Stone,,2015,7.5,5911,6391,480
28131,MS,Stone,,2016,6.9,6021,6465,444
28131,MS,Stone,,2017,6.3,6147,6559,412
28131,MS,Stone,,2018,6,6309,6709,400
28131,MS,Stone,,2019,6.1,6485,6908,423
28131,MS,Stone,,2020,7.4,6331,6840,509
28131,MS,Stone,,2021,5.4,6555,6931,376
28133,MS,Sunflower,,2007,9.6,9769,10810,1041
28133,MS,Sunflower,,2008,10.4,9464,10557,1093
28133,MS,Sunflower,,2009,12.6,8958,10246,1288
28133,MS,Sunflower,,2010,15,8391,9872,1481
28133,MS,Sunflower,,2011,14.8,8403,9858,1455
28133,MS,Sunflower,,2012,14.1,8225,9574,1349
28133,MS,Sunflower,,2013,13.8,7751,8996,1245
28133,MS,Sunflower,,2014,12.6,7548,8637,1089
28133,MS,Sunflower,,2015,10.6,7555,8454,899
28133,MS,Sunflower,,2016,9.5,7520,8307,787
28133,MS,Sunflower,,2017,8.5,7267,7944,677
28133,MS,Sunflower,,2018,8,7149,7774,625
28133,MS,Sunflower,,2019,9.1,6775,7457,682
28133,MS,Sunflower,,2020,10.9,6626,7435,809
28133,MS,Sunflower,,2021,9.1,6715,7389,674
28135,MS,Tallahatchie,,2007,7.8,5523,5987,464
28135,MS,Tallahatchie,,2008,8.4,5427,5926,499
28135,MS,Tallahatchie,,2009,11.1,5217,5866,649
28135,MS,Tallahatchie,,2010,11.9,5193,5894,701
28135,MS,Tallahatchie,,2011,11.9,5367,6090,723
28135,MS,Tallahatchie,,2012,11.1,5188,5833,645
28135,MS,Tallahatchie,,2013,11.1,5166,5810,644
28135,MS,Tallahatchie,,2014,9.4,5278,5823,545
28135,MS,Tallahatchie,,2015,7.6,5350,5793,443
28135,MS,Tallahatchie,,2016,6.9,5316,5711,395
28135,MS,Tallahatchie,,2017,5.5,5162,5463,301
28135,MS,Tallahatchie,,2018,5.5,4970,5259,289
28135,MS,Tallahatchie,,2019,5.7,5064,5368,304
28135,MS,Tallahatchie,,2020,7.3,4716,5089,373
28135,MS,Tallahatchie,,2021,6.1,4507,4800,293
28137,MS,Tate,,2007,6,11036,11745,709
28137,MS,Tate,,2008,6.8,10893,11687,794
28137,MS,Tate,,2009,10.6,10230,11440,1210
28137,MS,Tate,,2010,10.5,11329,12654,1325
28137,MS,Tate,,2011,10.1,11560,12863,1303
28137,MS,Tate,,2012,9.1,11423,12560,1137
28137,MS,Tate,,2013,8.9,10912,11972,1060
28137,MS,Tate,,2014,8.6,10733,11739,1006
28137,MS,Tate,,2015,7.2,11104,11960,856
28137,MS,Tate,,2016,6,11308,12026,718
28137,MS,Tate,,2017,5.2,11441,12070,629
28137,MS,Tate,,2018,5.1,11627,12252,625
28137,MS,Tate,,2019,5.6,11517,12205,688
28137,MS,Tate,,2020,7.5,11049,11944,895
28137,MS,Tate,,2021,5.6,11429,12106,677
28139,MS,Tippah,,2007,7.1,8512,9166,654
28139,MS,Tippah,,2008,10.1,7835,8716,881
28139,MS,Tippah,,2009,14.5,7112,8322,1210
28139,MS,Tippah,,2010,13.1,7817,8999,1182
28139,MS,Tippah,,2011,11.6,8231,9307,1076
28139,MS,Tippah,,2012,9.9,8229,9131,902
28139,MS,Tippah,,2013,9.8,7886,8738,852
28139,MS,Tippah,,2014,8.4,7970,8699,729
28139,MS,Tippah,,2015,6.4,8804,9410,606
28139,MS,Tippah,,2016,5.7,8823,9353,530
28139,MS,Tippah,,2017,4.6,9007,9440,433
28139,MS,Tippah,,2018,4.5,9011,9431,420
28139,MS,Tippah,,2019,5.1,9071,9560,489
28139,MS,Tippah,,2020,6.9,8552,9182,630
28139,MS,Tippah,,2021,4.6,8993,9427,434
28141,MS,Tishomingo,,2007,8,7279,7914,635
28141,MS,Tishomingo,,2008,8.9,7157,7859,702
28141,MS,Tishomingo,,2009,12.4,6609,7541,932
28141,MS,Tishomingo,,2010,12.4,6852,7821,969
28141,MS,Tishomingo,,2011,11.8,7131,8084,953
28141,MS,Tishomingo,,2012,10.1,7164,7970,806
28141,MS,Tishomingo,,2013,9.2,6991,7698,707
28141,MS,Tishomingo,,2014,7.8,6979,7568,589
28141,MS,Tishomingo,,2015,6.4,7472,7987,515
28141,MS,Tishomingo,,2016,5.6,7757,8217,460
28141,MS,Tishomingo,,2017,5.1,7912,8337,425
28141,MS,Tishomingo,,2018,4.7,8093,8492,399
28141,MS,Tishomingo,,2019,5.1,8235,8679,444
28141,MS,Tishomingo,,2020,6.5,7714,8246,532
28141,MS,Tishomingo,,2021,4.6,7938,8317,379
28143,MS,Tunica,,2007,7.9,4013,4357,344
28143,MS,Tunica,,2008,10.7,3920,4388,468
28143,MS,Tunica,,2009,14.4,3656,4269,613
28143,MS,Tunica,,2010,13.3,4362,5031,669
28143,MS,Tunica,,2011,14.1,4418,5146,728
28143,MS,Tunica,,2012,12.1,4351,4949,598
28143,MS,Tunica,,2013,12.4,4200,4793,593
28143,MS,Tunica,,2014,11.9,4182,4747,565
28143,MS,Tunica,,2015,9.4,4207,4643,436
28143,MS,Tunica,,2016,7.3,4256,4589,333
28143,MS,Tunica,,2017,6.1,4173,4444,271
28143,MS,Tunica,,2018,5.5,4150,4393,243
28143,MS,Tunica,,2019,6.3,4051,4325,274
28143,MS,Tunica,,2020,14.8,3775,4432,657
28143,MS,Tunica,,2021,8.9,3896,4275,379
28145,MS,Union,,2007,6.2,10991,11716,725
28145,MS,Union,,2008,7.1,11007,11844,837
28145,MS,Union,,2009,10.2,10356,11536,1180
28145,MS,Union,,2010,10.6,10870,12159,1289
28145,MS,Union,,2011,9.7,12039,13325,1286
28145,MS,Union,,2012,7.9,12616,13693,1077
28145,MS,Union,,2013,7.1,12160,13084,924
28145,MS,Union,,2014,6.2,12010,12806,796
28145,MS,Union,,2015,5.2,12488,13168,680
28145,MS,Union,,2016,4.5,12979,13593,614
28145,MS,Union,,2017,3.7,13430,13947,517
28145,MS,Union,,2018,3.6,13498,14007,509
28145,MS,Union,,2019,4.2,13763,14365,602
28145,MS,Union,,2020,7,12960,13932,972
28145,MS,Union,,2021,4.1,13505,14078,573
28147,MS,Walthall,,2007,6.3,5463,5833,370
28147,MS,Walthall,,2008,7.3,5402,5825,423
28147,MS,Walthall,,2009,11.2,4965,5591,626
28147,MS,Walthall,,2010,12.6,5087,5823,736
28147,MS,Walthall,,2011,11.8,5149,5839,690
28147,MS,Walthall,,2012,11,5010,5631,621
28147,MS,Walthall,,2013,10.6,4734,5297,563
28147,MS,Walthall,,2014,9.6,4650,5141,491
28147,MS,Walthall,,2015,8.2,4714,5135,421
28147,MS,Walthall,,2016,7.9,4621,5016,395
28147,MS,Walthall,,2017,6.9,4702,5053,351
28147,MS,Walthall,,2018,6.6,4715,5048,333
28147,MS,Walthall,,2019,7.3,4599,4959,360
28147,MS,Walthall,,2020,8.3,4510,4916,406
28147,MS,Walthall,,2021,6.9,4597,4937,340
28149,MS,Warren,,2007,6.2,20604,21958,1354
28149,MS,Warren,,2008,6.4,20889,22321,1432
28149,MS,Warren,,2009,9.7,19325,21397,2072
28149,MS,Warren,,2010,10.2,20997,23373,2376
28149,MS,Warren,,2011,9.9,21251,23586,2335
28149,MS,Warren,,2012,8.8,21421,23493,2072
28149,MS,Warren,,2013,8.9,19707,21643,1936
28149,MS,Warren,,2014,7.7,19263,20874,1611
28149,MS,Warren,,2015,6.7,19417,20821,1404
28149,MS,Warren,,2016,6.5,19377,20715,1338
28149,MS,Warren,,2017,5.8,19599,20803,1204
28149,MS,Warren,,2018,5.6,19305,20447,1142
28149,MS,Warren,,2019,6,19249,20476,1227
28149,MS,Warren,,2020,8.5,18206,19904,1698
28149,MS,Warren,,2021,6.2,18221,19416,1195
28151,MS,Washington,,2007,8.5,20031,21888,1857
28151,MS,Washington,,2008,9.5,20009,22119,2110
28151,MS,Washington,,2009,13.4,18505,21376,2871
28151,MS,Washington,,2010,15.4,17729,20957,3228
28151,MS,Washington,,2011,15.2,17981,21203,3222
28151,MS,Washington,,2012,14.3,17333,20215,2882
28151,MS,Washington,,2013,14.5,16358,19122,2764
28151,MS,Washington,,2014,12.7,15998,18315,2317
28151,MS,Washington,,2015,10.4,16125,17998,1873
28151,MS,Washington,,2016,9.2,16068,17691,1623
28151,MS,Washington,,2017,7.3,16421,17722,1301
28151,MS,Washington,,2018,6.9,16030,17227,1197
28151,MS,Washington,,2019,7.9,14927,16202,1275
28151,MS,Washington,,2020,10.6,14481,16192,1711
28151,MS,Washington,,2021,8.2,14613,15920,1307
28153,MS,Wayne,,2007,6.5,8052,8610,558
28153,MS,Wayne,,2008,7.6,7837,8480,643
28153,MS,Wayne,,2009,10.7,7261,8127,866
28153,MS,Wayne,,2010,11.8,7628,8644,1016
28153,MS,Wayne,,2011,11.2,7783,8761,978
28153,MS,Wayne,,2012,10.9,7597,8528,931
28153,MS,Wayne,,2013,10.7,7055,7896,841
28153,MS,Wayne,,2014,8.9,7022,7712,690
28153,MS,Wayne,,2015,8,6990,7599,609
28153,MS,Wayne,,2016,7.5,6943,7503,560
28153,MS,Wayne,,2017,6.5,6893,7373,480
28153,MS,Wayne,,2018,5.6,6900,7311,411
28153,MS,Wayne,,2019,6.1,7069,7529,460
28153,MS,Wayne,,2020,8.5,6752,7381,629
28153,MS,Wayne,,2021,6.7,6842,7335,493
28155,MS,Webster,,2007,8.2,3110,3388,278
28155,MS,Webster,,2008,9.3,3067,3383,316
28155,MS,Webster,,2009,13.6,2937,3398,461
28155,MS,Webster,,2010,11.2,3889,4379,490
28155,MS,Webster,,2011,10.2,3960,4409,449
28155,MS,Webster,,2012,9,3894,4277,383
28155,MS,Webster,,2013,9.5,3685,4070,385
28155,MS,Webster,,2014,8.6,3610,3951,341
28155,MS,Webster,,2015,7.3,3642,3928,286
28155,MS,Webster,,2016,6.4,3640,3889,249
28155,MS,Webster,,2017,5.4,3657,3866,209
28155,MS,Webster,,2018,5.1,3698,3897,199
28155,MS,Webster,,2019,5.7,3736,3963,227
28155,MS,Webster,,2020,7.2,3559,3837,278
28155,MS,Webster,,2021,5.4,3729,3941,212
28157,MS,Wilkinson,,2007,8.5,3266,3570,304
28157,MS,Wilkinson,,2008,8,3368,3662,294
28157,MS,Wilkinson,,2009,10.6,3460,3872,412
28157,MS,Wilkinson,,2010,13.5,2983,3447,464
28157,MS,Wilkinson,,2011,12.7,3023,3463,440
28157,MS,Wilkinson,,2012,12,2898,3295,397
28157,MS,Wilkinson,,2013,12.4,2616,2985,369
28157,MS,Wilkinson,,2014,11.6,2501,2828,327
28157,MS,Wilkinson,,2015,10.7,2567,2876,309
28157,MS,Wilkinson,,2016,10.4,2532,2825,293
28157,MS,Wilkinson,,2017,9.1,2572,2828,256
28157,MS,Wilkinson,,2018,8.8,2529,2774,245
28157,MS,Wilkinson,,2019,10.2,2526,2812,286
28157,MS,Wilkinson,,2020,12.8,2372,2721,349
28157,MS,Wilkinson,,2021,11.1,2431,2736,305
28159,MS,Winston,,2007,6.7,7431,7962,531
28159,MS,Winston,,2008,7.6,7352,7953,601
28159,MS,Winston,,2009,16.6,6335,7598,1263
28159,MS,Winston,,2010,16.5,6631,7944,1313
28159,MS,Winston,,2011,13,6970,8015,1045
28159,MS,Winston,,2012,11.3,6923,7802,879
28159,MS,Winston,,2013,11,6581,7391,810
28159,MS,Winston,,2014,10.1,6414,7133,719
28159,MS,Winston,,2015,8.4,6474,7065,591
28159,MS,Winston,,2016,7.2,6563,7076,513
28159,MS,Winston,,2017,6.2,6756,7202,446
28159,MS,Winston,,2018,5.8,6863,7289,426
28159,MS,Winston,,2019,6.1,6965,7416,451
28159,MS,Winston,,2020,8.5,6642,7257,615
28159,MS,Winston,,2021,6.2,6735,7180,445
28161,MS,Yalobusha,,2007,7.7,4869,5278,409
28161,MS,Yalobusha,,2008,8.7,4920,5387,467
28161,MS,Yalobusha,,2009,14,4676,5436,760
28161,MS,Yalobusha,,2010,13.2,4522,5210,688
28161,MS,Yalobusha,,2011,11.5,4763,5382,619
28161,MS,Yalobusha,,2012,9.9,4946,5488,542
28161,MS,Yalobusha,,2013,9.9,4527,5026,499
28161,MS,Yalobusha,,2014,9.3,4450,4907,457
28161,MS,Yalobusha,,2015,7.2,4556,4912,356
28161,MS,Yalobusha,,2016,6.4,4553,4864,311
28161,MS,Yalobusha,,2017,5.6,4783,5066,283
28161,MS,Yalobusha,,2018,5.1,4848,5106,258
28161,MS,Yalobusha,,2019,5.7,4693,4979,286
28161,MS,Yalobusha,,2020,7.7,4469,4841,372
28161,MS,Yalobusha,,2021,5.5,4633,4902,269
28163,MS,Yazoo,,2007,7.7,9306,10078,772
28163,MS,Yazoo,,2008,8.8,9145,10031,886
28163,MS,Yazoo,,2009,11.5,8798,9944,1146
28163,MS,Yazoo,,2010,11.9,8746,9928,1182
28163,MS,Yazoo,,2011,11.8,8963,10159,1196
28163,MS,Yazoo,,2012,11,8848,9943,1095
28163,MS,Yazoo,,2013,10.9,8412,9446,1034
28163,MS,Yazoo,,2014,10.1,8321,9251,930
28163,MS,Yazoo,,2015,8.3,8420,9181,761
28163,MS,Yazoo,,2016,7.5,8515,9208,693
28163,MS,Yazoo,,2017,6.3,8501,9069,568
28163,MS,Yazoo,,2018,5.7,8817,9353,536
28163,MS,Yazoo,,2019,6.3,9311,9940,629
28163,MS,Yazoo,,2020,10,8067,8964,897
28163,MS,Yazoo,,2021,7.3,8292,8946,654
29000,MO,Missouri,,2007,5.1,2902504,3058119,155615
29000,MO,Missouri,,2008,6.2,2875600,3065251,189651
29000,MO,Missouri,,2009,9,2784890,3061704,276814
29000,MO,Missouri,,2010,9.5,2753910,3043249,289339
29000,MO,Missouri,,2011,8.6,2770662,3032960,262298
29000,MO,Missouri,,2012,7.2,2789025,3004347,215322
29000,MO,Missouri,,2013,6.8,2807115,3011198,204083
29000,MO,Missouri,,2014,6.2,2848571,3035599,187028
29000,MO,Missouri,,2015,5.1,2901467,3057859,156392
29000,MO,Missouri,,2016,4.5,2933457,3072904,139447
29000,MO,Missouri,,2017,3.7,2939306,3053526,114220
29000,MO,Missouri,,2018,3.2,2949910,3045865,95955
29000,MO,Missouri,,2019,3.1,2976643,3072073,95430
29000,MO,Missouri,,2020,6.1,2853353,3037162,183809
29000,MO,Missouri,,2021,4.4,2928368,3062449,134081
29001,MO,Adair,,2007,4.8,12953,13605,652
29001,MO,Adair,,2008,5.3,13033,13763,730
29001,MO,Adair,,2009,6.4,12787,13664,877
29001,MO,Adair,,2010,8.6,10089,11036,947
29001,MO,Adair,,2011,8.8,9914,10866,952
29001,MO,Adair,,2012,7.3,9900,10675,775
29001,MO,Adair,,2013,6.9,10001,10745,744
29001,MO,Adair,,2014,6.5,9873,10557,684
29001,MO,Adair,,2015,5.7,9784,10380,596
29001,MO,Adair,,2016,5.7,9772,10359,587
29001,MO,Adair,,2017,4.2,10016,10460,444
29001,MO,Adair,,2018,3.5,10235,10605,370
29001,MO,Adair,,2019,3.7,9885,10263,378
29001,MO,Adair,,2020,5.1,9536,10046,510
29001,MO,Adair,,2021,4.3,9481,9908,427
29003,MO,Andrew,,2007,3.9,9872,10276,404
29003,MO,Andrew,,2008,4.8,9621,10109,488
29003,MO,Andrew,,2009,7.5,9440,10205,765
29003,MO,Andrew,,2010,8.2,9046,9857,811
29003,MO,Andrew,,2011,7.1,9017,9703,686
29003,MO,Andrew,,2012,5.5,9291,9835,544
29003,MO,Andrew,,2013,5.4,9331,9864,533
29003,MO,Andrew,,2014,5.2,9308,9816,508
29003,MO,Andrew,,2015,4.2,9442,9860,418
29003,MO,Andrew,,2016,3.7,9649,10021,372
29003,MO,Andrew,,2017,3.2,9471,9782,311
29003,MO,Andrew,,2018,2.6,9450,9702,252
29003,MO,Andrew,,2019,2.6,9574,9831,257
29003,MO,Andrew,,2020,4,9324,9712,388
29003,MO,Andrew,,2021,3,9364,9656,292
29005,MO,Atchison,,2007,4.4,3093,3234,141
29005,MO,Atchison,,2008,4.8,3097,3253,156
29005,MO,Atchison,,2009,7.1,3014,3246,232
29005,MO,Atchison,,2010,8.5,2732,2987,255
29005,MO,Atchison,,2011,8.4,2639,2880,241
29005,MO,Atchison,,2012,6.6,2670,2858,188
29005,MO,Atchison,,2013,5.9,2703,2872,169
29005,MO,Atchison,,2014,5.4,2707,2862,155
29005,MO,Atchison,,2015,4.5,2687,2815,128
29005,MO,Atchison,,2016,4.5,2709,2838,129
29005,MO,Atchison,,2017,3.5,2749,2848,99
29005,MO,Atchison,,2018,2.4,2694,2761,67
29005,MO,Atchison,,2019,3.5,2586,2680,94
29005,MO,Atchison,,2020,4,2606,2715,109
29005,MO,Atchison,,2021,3.2,2569,2655,86
29007,MO,Audrain,,2007,4.9,11780,12388,608
29007,MO,Audrain,,2008,6.3,11757,12545,788
29007,MO,Audrain,,2009,9.1,11102,12213,1111
29007,MO,Audrain,,2010,9.5,10032,11090,1058
29007,MO,Audrain,,2011,8.4,10299,11241,942
29007,MO,Audrain,,2012,6.7,10517,11275,758
29007,MO,Audrain,,2013,6.4,10487,11203,716
29007,MO,Audrain,,2014,5.6,10567,11195,628
29007,MO,Audrain,,2015,4.7,10712,11242,530
29007,MO,Audrain,,2016,4.2,10649,11120,471
29007,MO,Audrain,,2017,3.5,10681,11066,385
29007,MO,Audrain,,2018,3,10445,10773,328
29007,MO,Audrain,,2019,3.2,10266,10604,338
29007,MO,Audrain,,2020,5.8,9683,10276,593
29007,MO,Audrain,,2021,3.7,9870,10246,376
29009,MO,Barry,,2007,4.9,17008,17877,869
29009,MO,Barry,,2008,5.5,17006,18002,996
29009,MO,Barry,,2009,8,16053,17451,1398
29009,MO,Barry,,2010,9.6,14059,15549,1490
29009,MO,Barry,,2011,9.1,13802,15191,1389
29009,MO,Barry,,2012,7.3,13928,15025,1097
29009,MO,Barry,,2013,6.9,13837,14860,1023
29009,MO,Barry,,2014,6.2,13843,14753,910
29009,MO,Barry,,2015,5.1,14066,14822,756
29009,MO,Barry,,2016,4.5,14495,15175,680
29009,MO,Barry,,2017,3.3,14946,15461,515
29009,MO,Barry,,2018,2.9,15133,15587,454
29009,MO,Barry,,2019,3.3,14964,15475,511
29009,MO,Barry,,2020,6.5,14628,15642,1014
29009,MO,Barry,,2021,4.6,14406,15094,688
29011,MO,Barton,,2007,8.6,5266,5763,497
29011,MO,Barton,,2008,9.4,4882,5388,506
29011,MO,Barton,,2009,10.4,4716,5263,547
29011,MO,Barton,,2010,10.2,5146,5732,586
29011,MO,Barton,,2011,9,5106,5609,503
29011,MO,Barton,,2012,7.7,5085,5507,422
29011,MO,Barton,,2013,7.2,5078,5474,396
29011,MO,Barton,,2014,6.3,5121,5466,345
29011,MO,Barton,,2015,5.5,5003,5295,292
29011,MO,Barton,,2016,5.2,5036,5313,277
29011,MO,Barton,,2017,4.1,4981,5196,215
29011,MO,Barton,,2018,3,5013,5170,157
29011,MO,Barton,,2019,3.2,4982,5147,165
29011,MO,Barton,,2020,4.9,4903,5154,251
29011,MO,Barton,,2021,3.4,5014,5190,176
29013,MO,Bates,,2007,6.1,7499,7982,483
29013,MO,Bates,,2008,7.2,7380,7954,574
29013,MO,Bates,,2009,10.4,6790,7577,787
29013,MO,Bates,,2010,10.9,7447,8357,910
29013,MO,Bates,,2011,10.3,7489,8346,857
29013,MO,Bates,,2012,8.5,7440,8130,690
29013,MO,Bates,,2013,7.7,7363,7978,615
29013,MO,Bates,,2014,7.1,7496,8069,573
29013,MO,Bates,,2015,6.2,7601,8103,502
29013,MO,Bates,,2016,5.3,7711,8146,435
29013,MO,Bates,,2017,4.4,7610,7964,354
29013,MO,Bates,,2018,3.8,7544,7843,299
29013,MO,Bates,,2019,3.9,7445,7744,299
29013,MO,Bates,,2020,5.3,7191,7595,404
29013,MO,Bates,,2021,4.3,7322,7647,325
29015,MO,Benton,,2007,5.9,7924,8423,499
29015,MO,Benton,,2008,7,7869,8457,588
29015,MO,Benton,,2009,9.7,7509,8316,807
29015,MO,Benton,,2010,12.1,6384,7260,876
29015,MO,Benton,,2011,11.1,6396,7198,802
29015,MO,Benton,,2012,9.3,6438,7102,664
29015,MO,Benton,,2013,8.6,6616,7237,621
29015,MO,Benton,,2014,7.8,6593,7153,560
29015,MO,Benton,,2015,6.7,6675,7151,476
29015,MO,Benton,,2016,6.1,6811,7250,439
29015,MO,Benton,,2017,5.1,6906,7276,370
29015,MO,Benton,,2018,4.5,6834,7153,319
29015,MO,Benton,,2019,4.6,6803,7130,327
29015,MO,Benton,,2020,7.3,6687,7212,525
29015,MO,Benton,,2021,5.7,6905,7322,417
29017,MO,Bollinger,,2007,5.4,5470,5784,314
29017,MO,Bollinger,,2008,6.8,5272,5654,382
29017,MO,Bollinger,,2009,10,5052,5615,563
29017,MO,Bollinger,,2010,10,5236,5817,581
29017,MO,Bollinger,,2011,9.2,5204,5730,526
29017,MO,Bollinger,,2012,7.2,5273,5685,412
29017,MO,Bollinger,,2013,7.1,5325,5735,410
29017,MO,Bollinger,,2014,6.8,5241,5623,382
29017,MO,Bollinger,,2015,5.7,5206,5521,315
29017,MO,Bollinger,,2016,5.2,5169,5454,285
29017,MO,Bollinger,,2017,4.4,5249,5489,240
29017,MO,Bollinger,,2018,3.6,5228,5422,194
29017,MO,Bollinger,,2019,3.7,5225,5425,200
29017,MO,Bollinger,,2020,5.6,5064,5364,300
29017,MO,Bollinger,,2021,4.2,5127,5349,222
29019,MO,Boone,,2007,3.7,84829,88093,3264
29019,MO,Boone,,2008,4.4,83993,87900,3907
29019,MO,Boone,,2009,6.1,83066,88501,5435
29019,MO,Boone,,2010,6.4,86285,92186,5901
29019,MO,Boone,,2011,5.8,88143,93593,5450
29019,MO,Boone,,2012,4.7,91218,95695,4477
29019,MO,Boone,,2013,4.5,92812,97230,4418
29019,MO,Boone,,2014,4.2,93196,97268,4072
29019,MO,Boone,,2015,3.6,94717,98238,3521
29019,MO,Boone,,2016,3.3,94825,98042,3217
29019,MO,Boone,,2017,2.6,94687,97225,2538
29019,MO,Boone,,2018,2.2,95255,97437,2182
29019,MO,Boone,,2019,2.3,95904,98120,2216
29019,MO,Boone,,2020,4.2,91790,95852,4062
29019,MO,Boone,,2021,3,96049,99004,2955
29021,MO,Buchanan,,2007,4.4,46480,48638,2158
29021,MO,Buchanan,,2008,5.3,46666,49255,2589
29021,MO,Buchanan,,2009,8.3,45669,49789,4120
29021,MO,Buchanan,,2010,9.1,42236,46465,4229
29021,MO,Buchanan,,2011,8.3,42429,46246,3817
29021,MO,Buchanan,,2012,6.5,43401,46410,3009
29021,MO,Buchanan,,2013,6.3,43537,46447,2910
29021,MO,Buchanan,,2014,5.7,43456,46094,2638
29021,MO,Buchanan,,2015,4.7,44045,46208,2163
29021,MO,Buchanan,,2016,4.1,44741,46642,1901
29021,MO,Buchanan,,2017,3.5,43428,45023,1595
29021,MO,Buchanan,,2018,2.9,42992,44287,1295
29021,MO,Buchanan,,2019,2.9,42835,44115,1280
29021,MO,Buchanan,,2020,4.9,41457,43593,2136
29021,MO,Buchanan,,2021,3.8,41689,43329,1640
29023,MO,Butler,,2007,6.6,20140,21552,1412
29023,MO,Butler,,2008,6.2,20740,22121,1381
29023,MO,Butler,,2009,7.9,19892,21589,1697
29023,MO,Butler,,2010,9.5,16910,18687,1777
29023,MO,Butler,,2011,9.2,17008,18731,1723
29023,MO,Butler,,2012,8.5,16997,18569,1572
29023,MO,Butler,,2013,7.9,17173,18656,1483
29023,MO,Butler,,2014,7.1,17675,19022,1347
29023,MO,Butler,,2015,6.3,17674,18866,1192
29023,MO,Butler,,2016,5.7,17701,18771,1070
29023,MO,Butler,,2017,4.5,17655,18486,831
29023,MO,Butler,,2018,4.5,17266,18080,814
29023,MO,Butler,,2019,4.4,17064,17856,792
29023,MO,Butler,,2020,6.2,16990,18120,1130
29023,MO,Butler,,2021,4.7,17187,18037,850
29025,MO,Caldwell,,2007,5.4,4168,4408,240
29025,MO,Caldwell,,2008,6.8,4077,4373,296
29025,MO,Caldwell,,2009,9.5,3783,4181,398
29025,MO,Caldwell,,2010,9.5,4110,4541,431
29025,MO,Caldwell,,2011,8.8,4037,4428,391
29025,MO,Caldwell,,2012,7.2,4055,4370,315
29025,MO,Caldwell,,2013,6.8,4042,4335,293
29025,MO,Caldwell,,2014,5.5,4080,4318,238
29025,MO,Caldwell,,2015,4.6,4165,4368,203
29025,MO,Caldwell,,2016,4.7,4259,4469,210
29025,MO,Caldwell,,2017,4,4243,4422,179
29025,MO,Caldwell,,2018,3.1,4211,4346,135
29025,MO,Caldwell,,2019,3,4148,4277,129
29025,MO,Caldwell,,2020,5.3,4011,4236,225
29025,MO,Caldwell,,2021,5.1,4078,4298,220
29027,MO,Callaway,,2007,4.4,21907,22918,1011
29027,MO,Callaway,,2008,5.4,21666,22907,1241
29027,MO,Callaway,,2009,7.9,21179,22985,1806
29027,MO,Callaway,,2010,8.2,20453,22284,1831
29027,MO,Callaway,,2011,7.8,20270,21975,1705
29027,MO,Callaway,,2012,6.4,20291,21677,1386
29027,MO,Callaway,,2013,6.1,20254,21563,1309
29027,MO,Callaway,,2014,5.6,20480,21706,1226
29027,MO,Callaway,,2015,4.8,20507,21542,1035
29027,MO,Callaway,,2016,4.1,20908,21800,892
29027,MO,Callaway,,2017,3.5,20664,21406,742
29027,MO,Callaway,,2018,2.9,20491,21095,604
29027,MO,Callaway,,2019,2.7,20716,21301,585
29027,MO,Callaway,,2020,4.4,20421,21370,949
29027,MO,Callaway,,2021,3.4,20598,21325,727
29029,MO,Camden,,2007,4.9,21112,22192,1080
29029,MO,Camden,,2008,6.3,21278,22713,1435
29029,MO,Camden,,2009,9.4,20078,22173,2095
29029,MO,Camden,,2010,11.9,17069,19373,2304
29029,MO,Camden,,2011,11.4,16904,19069,2165
29029,MO,Camden,,2012,9.9,16996,18854,1858
29029,MO,Camden,,2013,9.3,17009,18757,1748
29029,MO,Camden,,2014,8.2,17206,18738,1532
29029,MO,Camden,,2015,6.7,17400,18644,1244
29029,MO,Camden,,2016,5.8,17620,18705,1085
29029,MO,Camden,,2017,4.8,17961,18861,900
29029,MO,Camden,,2018,4.2,17788,18561,773
29029,MO,Camden,,2019,4.3,17954,18755,801
29029,MO,Camden,,2020,6.9,17442,18738,1296
29029,MO,Camden,,2021,5,18315,19270,955
29031,MO,Cape Girardeau,,2007,4.3,37613,39294,1681
29031,MO,Cape Girardeau,,2008,5.2,36889,38914,2025
29031,MO,Cape Girardeau,,2009,7.1,36141,38898,2757
29031,MO,Cape Girardeau,,2010,7.3,37890,40861,2971
29031,MO,Cape Girardeau,,2011,6.9,37691,40474,2783
29031,MO,Cape Girardeau,,2012,5.7,38199,40512,2313
29031,MO,Cape Girardeau,,2013,5.8,38417,40786,2369
29031,MO,Cape Girardeau,,2014,5.5,38296,40517,2221
29031,MO,Cape Girardeau,,2015,4.4,38827,40612,1785
29031,MO,Cape Girardeau,,2016,4.3,38952,40711,1759
29031,MO,Cape Girardeau,,2017,3.5,38406,39780,1374
29031,MO,Cape Girardeau,,2018,2.7,39093,40179,1086
29031,MO,Cape Girardeau,,2019,2.8,39493,40615,1122
29031,MO,Cape Girardeau,,2020,5.1,38321,40375,2054
29031,MO,Cape Girardeau,,2021,3.6,38992,40445,1453
29033,MO,Carroll,,2007,5,5002,5267,265
29033,MO,Carroll,,2008,7.1,4742,5107,365
29033,MO,Carroll,,2009,10.2,4591,5110,519
29033,MO,Carroll,,2010,11.4,4231,4774,543
29033,MO,Carroll,,2011,10.7,4218,4723,505
29033,MO,Carroll,,2012,8.6,4176,4570,394
29033,MO,Carroll,,2013,7.4,4320,4665,345
29033,MO,Carroll,,2014,7.2,4383,4723,340
29033,MO,Carroll,,2015,6.2,4494,4789,295
29033,MO,Carroll,,2016,5.4,4507,4762,255
29033,MO,Carroll,,2017,4,4586,4779,193
29033,MO,Carroll,,2018,3.1,4512,4656,144
29033,MO,Carroll,,2019,3.1,4623,4769,146
29033,MO,Carroll,,2020,5.5,4357,4611,254
29033,MO,Carroll,,2021,4.4,4306,4504,198
29035,MO,Carter,,2007,6.3,2743,2926,183
29035,MO,Carter,,2008,7.3,2788,3006,218
29035,MO,Carter,,2009,9.5,2818,3114,296
29035,MO,Carter,,2010,11.5,2351,2655,304
29035,MO,Carter,,2011,11.5,2326,2628,302
29035,MO,Carter,,2012,9.8,2285,2532,247
29035,MO,Carter,,2013,9.6,2296,2541,245
29035,MO,Carter,,2014,9,2319,2548,229
29035,MO,Carter,,2015,7.6,2307,2496,189
29035,MO,Carter,,2016,7.1,2360,2540,180
29035,MO,Carter,,2017,5.8,2380,2527,147
29035,MO,Carter,,2018,5,2376,2501,125
29035,MO,Carter,,2019,4.7,2398,2515,117
29035,MO,Carter,,2020,6.5,2355,2518,163
29035,MO,Carter,,2021,5.2,2438,2571,133
29037,MO,Cass,,2007,4.9,48065,50567,2502
29037,MO,Cass,,2008,6,47821,50873,3052
29037,MO,Cass,,2009,9.3,45611,50299,4688
29037,MO,Cass,,2010,9.6,48049,53137,5088
29037,MO,Cass,,2011,8.7,48262,52832,4570
29037,MO,Cass,,2012,6.9,48846,52456,3610
29037,MO,Cass,,2013,6.4,48813,52126,3313
29037,MO,Cass,,2014,5.7,49595,52619,3024
29037,MO,Cass,,2015,4.9,50932,53555,2623
29037,MO,Cass,,2016,4.1,52196,54449,2253
29037,MO,Cass,,2017,3.5,52221,54115,1894
29037,MO,Cass,,2018,3,52536,54177,1641
29037,MO,Cass,,2019,2.9,53092,54652,1560
29037,MO,Cass,,2020,5.3,50977,53829,2852
29037,MO,Cass,,2021,3.9,52278,54398,2120
29039,MO,Cedar,,2007,5.7,6163,6534,371
29039,MO,Cedar,,2008,6.6,6103,6533,430
29039,MO,Cedar,,2009,8.9,5769,6333,564
29039,MO,Cedar,,2010,9.5,5511,6087,576
29039,MO,Cedar,,2011,8.9,5444,5974,530
29039,MO,Cedar,,2012,7.7,5318,5760,442
29039,MO,Cedar,,2013,7.1,5445,5861,416
29039,MO,Cedar,,2014,6.4,5467,5839,372
29039,MO,Cedar,,2015,5.4,5542,5857,315
29039,MO,Cedar,,2016,5,5501,5789,288
29039,MO,Cedar,,2017,4,5514,5746,232
29039,MO,Cedar,,2018,3.4,5498,5690,192
29039,MO,Cedar,,2019,3.5,5538,5740,202
29039,MO,Cedar,,2020,4.4,5465,5719,254
29039,MO,Cedar,,2021,3.7,5578,5790,212
29041,MO,Chariton,,2007,5.5,3746,3965,219
29041,MO,Chariton,,2008,6.2,3777,4027,250
29041,MO,Chariton,,2009,9.5,3673,4059,386
29041,MO,Chariton,,2010,9.4,3723,4111,388
29041,MO,Chariton,,2011,9.1,3706,4079,373
29041,MO,Chariton,,2012,6.8,3734,4005,271
29041,MO,Chariton,,2013,6.3,3493,3729,236
29041,MO,Chariton,,2014,5.8,3614,3837,223
29041,MO,Chariton,,2015,4.8,3646,3830,184
29041,MO,Chariton,,2016,4.3,3684,3851,167
29041,MO,Chariton,,2017,3.4,3713,3845,132
29041,MO,Chariton,,2018,2.8,3655,3759,104
29041,MO,Chariton,,2019,2.8,3586,3691,105
29041,MO,Chariton,,2020,4,3585,3735,150
29041,MO,Chariton,,2021,3.3,3620,3743,123
29043,MO,Christian,,2007,3.9,38550,40102,1552
29043,MO,Christian,,2008,5.1,38408,40463,2055
29043,MO,Christian,,2009,8,37532,40799,3267
29043,MO,Christian,,2010,8.4,37289,40687,3398
29043,MO,Christian,,2011,7.6,37617,40700,3083
29043,MO,Christian,,2012,6,38083,40518,2435
29043,MO,Christian,,2013,5.5,38654,40907,2253
29043,MO,Christian,,2014,4.9,39964,42042,2078
29043,MO,Christian,,2015,4.3,40943,42786,1843
29043,MO,Christian,,2016,3.9,41613,43307,1694
29043,MO,Christian,,2017,3.1,41787,43117,1330
29043,MO,Christian,,2018,2.5,42855,43973,1118
29043,MO,Christian,,2019,2.6,44140,45304,1164
29043,MO,Christian,,2020,4.9,43392,45608,2216
29043,MO,Christian,,2021,3.2,45043,46547,1504
29045,MO,Clark,,2007,5.5,3429,3629,200
29045,MO,Clark,,2008,6.2,3371,3594,223
29045,MO,Clark,,2009,11.7,3170,3590,420
29045,MO,Clark,,2010,12.3,3022,3447,425
29045,MO,Clark,,2011,10.2,3044,3390,346
29045,MO,Clark,,2012,8.3,3047,3324,277
29045,MO,Clark,,2013,8,3083,3351,268
29045,MO,Clark,,2014,7,3188,3427,239
29045,MO,Clark,,2015,7.3,3166,3415,249
29045,MO,Clark,,2016,7.3,3119,3366,247
29045,MO,Clark,,2017,5.6,3022,3200,178
29045,MO,Clark,,2018,3.8,3076,3197,121
29045,MO,Clark,,2019,3.4,3061,3168,107
29045,MO,Clark,,2020,6,2968,3157,189
29045,MO,Clark,,2021,4.6,2982,3127,145
29047,MO,Clay,,2007,4.3,112211,117261,5050
29047,MO,Clay,,2008,5.2,112124,118270,6146
29047,MO,Clay,,2009,8.2,111232,121169,9937
29047,MO,Clay,,2010,8.3,114132,124476,10344
29047,MO,Clay,,2011,7.5,115592,125008,9416
29047,MO,Clay,,2012,6.3,117708,125609,7901
29047,MO,Clay,,2013,6.1,118669,126423,7754
29047,MO,Clay,,2014,5.4,121912,128935,7023
29047,MO,Clay,,2015,4.6,125297,131384,6087
29047,MO,Clay,,2016,3.9,128647,133855,5208
29047,MO,Clay,,2017,3.6,129677,134515,4838
29047,MO,Clay,,2018,2.9,130804,134674,3870
29047,MO,Clay,,2019,2.7,133199,136897,3698
29047,MO,Clay,,2020,6,128154,136387,8233
29047,MO,Clay,,2021,4.9,131555,138370,6815
29049,MO,Clinton,,2007,5.1,9935,10474,539
29049,MO,Clinton,,2008,6,9848,10474,626
29049,MO,Clinton,,2009,9.6,9188,10160,972
29049,MO,Clinton,,2010,9.6,9967,11020,1053
29049,MO,Clinton,,2011,9.1,9983,10977,994
29049,MO,Clinton,,2012,7.2,10000,10780,780
29049,MO,Clinton,,2013,6.7,10005,10721,716
29049,MO,Clinton,,2014,5.9,10019,10647,628
29049,MO,Clinton,,2015,5,10384,10925,541
29049,MO,Clinton,,2016,4.2,10536,10999,463
29049,MO,Clinton,,2017,4,10426,10857,431
29049,MO,Clinton,,2018,3.2,10311,10649,338
29049,MO,Clinton,,2019,2.9,10265,10570,305
29049,MO,Clinton,,2020,5.9,9880,10497,617
29049,MO,Clinton,,2021,5.3,10096,10660,564
29051,MO,Cole,,2007,3.9,38881,40452,1571
29051,MO,Cole,,2008,4.5,38742,40581,1839
29051,MO,Cole,,2009,6.6,38002,40704,2702
29051,MO,Cole,,2010,6.8,37762,40520,2758
29051,MO,Cole,,2011,6.4,37594,40167,2573
29051,MO,Cole,,2012,5.3,37493,39597,2104
29051,MO,Cole,,2013,5.3,37530,39626,2096
29051,MO,Cole,,2014,5,37516,39508,1992
29051,MO,Cole,,2015,4.1,37538,39133,1595
29051,MO,Cole,,2016,3.6,37982,39380,1398
29051,MO,Cole,,2017,2.9,37607,38739,1132
29051,MO,Cole,,2018,2.4,37480,38420,940
29051,MO,Cole,,2019,2.4,38059,39011,952
29051,MO,Cole,,2020,4.4,37065,38765,1700
29051,MO,Cole,,2021,3.1,37445,38648,1203
29053,MO,Cooper,,2007,4.5,8844,9258,414
29053,MO,Cooper,,2008,5.8,8792,9333,541
29053,MO,Cooper,,2009,8.7,8351,9143,792
29053,MO,Cooper,,2010,9.7,7159,7926,767
29053,MO,Cooper,,2011,9.2,7183,7909,726
29053,MO,Cooper,,2012,7.4,7188,7760,572
29053,MO,Cooper,,2013,7,7131,7668,537
29053,MO,Cooper,,2014,6,7165,7622,457
29053,MO,Cooper,,2015,5.9,7123,7569,446
29053,MO,Cooper,,2016,4.9,7106,7473,367
29053,MO,Cooper,,2017,3.6,7178,7448,270
29053,MO,Cooper,,2018,3.1,7182,7408,226
29053,MO,Cooper,,2019,3.5,7142,7403,261
29053,MO,Cooper,,2020,5.4,6767,7155,388
29053,MO,Cooper,,2021,3.6,6824,7080,256
29055,MO,Crawford,,2007,7,11399,12258,859
29055,MO,Crawford,,2008,8.2,11235,12234,999
29055,MO,Crawford,,2009,10.7,10949,12264,1315
29055,MO,Crawford,,2010,12.6,9406,10762,1356
29055,MO,Crawford,,2011,11.1,9612,10811,1199
29055,MO,Crawford,,2012,9.1,9703,10672,969
29055,MO,Crawford,,2013,8.6,9931,10869,938
29055,MO,Crawford,,2014,8,9979,10851,872
29055,MO,Crawford,,2015,6.1,10179,10845,666
29055,MO,Crawford,,2016,5.3,10240,10817,577
29055,MO,Crawford,,2017,4.6,10297,10793,496
29055,MO,Crawford,,2018,3.8,10408,10823,415
29055,MO,Crawford,,2019,3.6,10522,10910,388
29055,MO,Crawford,,2020,6.3,10103,10788,685
29055,MO,Crawford,,2021,4.5,10418,10913,495
29057,MO,Dade,,2007,5.3,3574,3774,200
29057,MO,Dade,,2008,6.3,3385,3613,228
29057,MO,Dade,,2009,8.6,3270,3579,309
29057,MO,Dade,,2010,9.7,3060,3387,327
29057,MO,Dade,,2011,9.5,3093,3418,325
29057,MO,Dade,,2012,7.7,3086,3344,258
29057,MO,Dade,,2013,6.9,3203,3440,237
29057,MO,Dade,,2014,6,3285,3496,211
29057,MO,Dade,,2015,5.2,3364,3549,185
29057,MO,Dade,,2016,4.5,3423,3583,160
29057,MO,Dade,,2017,3.4,3449,3570,121
29057,MO,Dade,,2018,2.7,3466,3561,95
29057,MO,Dade,,2019,3,3419,3524,105
29057,MO,Dade,,2020,4.3,3396,3549,153
29057,MO,Dade,,2021,3.3,3427,3544,117
29059,MO,Dallas,,2007,5.3,7162,7560,398
29059,MO,Dallas,,2008,7.7,6912,7485,573
29059,MO,Dallas,,2009,11.3,6502,7334,832
29059,MO,Dallas,,2010,12.5,6347,7252,905
29059,MO,Dallas,,2011,11.2,6386,7195,809
29059,MO,Dallas,,2012,9.4,6403,7066,663
29059,MO,Dallas,,2013,8.7,6336,6941,605
29059,MO,Dallas,,2014,7.6,6411,6942,531
29059,MO,Dallas,,2015,6.3,6497,6937,440
29059,MO,Dallas,,2016,5.5,6567,6947,380
29059,MO,Dallas,,2017,4.7,6607,6931,324
29059,MO,Dallas,,2018,3.9,6669,6941,272
29059,MO,Dallas,,2019,4.3,6743,7043,300
29059,MO,Dallas,,2020,5.8,6665,7077,412
29059,MO,Dallas,,2021,4.3,6865,7177,312
29061,MO,Daviess,,2007,4.5,3881,4063,182
29061,MO,Daviess,,2008,5.4,3754,3968,214
29061,MO,Daviess,,2009,8.7,3552,3890,338
29061,MO,Daviess,,2010,9.7,3604,3992,388
29061,MO,Daviess,,2011,9.1,3671,4037,366
29061,MO,Daviess,,2012,7.2,3750,4039,289
29061,MO,Daviess,,2013,6.3,3806,4061,255
29061,MO,Daviess,,2014,5.8,3786,4021,235
29061,MO,Daviess,,2015,4.7,3872,4061,189
29061,MO,Daviess,,2016,3.8,3953,4111,158
29061,MO,Daviess,,2017,3.3,3934,4068,134
29061,MO,Daviess,,2018,3,3909,4028,119
29061,MO,Daviess,,2019,3.2,3941,4070,129
29061,MO,Daviess,,2020,4.2,3933,4105,172
29061,MO,Daviess,,2021,3.8,3948,4103,155
29063,MO,DeKalb,,2007,5.2,5025,5299,274
29063,MO,DeKalb,,2008,6.3,4897,5228,331
29063,MO,DeKalb,,2009,9.2,4706,5183,477
29063,MO,DeKalb,,2010,8.7,4565,5002,437
29063,MO,DeKalb,,2011,8.1,4601,5007,406
29063,MO,DeKalb,,2012,6.1,4710,5017,307
29063,MO,DeKalb,,2013,6.1,4720,5025,305
29063,MO,DeKalb,,2014,5.5,4684,4954,270
29063,MO,DeKalb,,2015,4.7,4780,5018,238
29063,MO,DeKalb,,2016,4.4,4856,5077,221
29063,MO,DeKalb,,2017,3.9,4708,4897,189
29063,MO,DeKalb,,2018,3.1,4691,4839,148
29063,MO,DeKalb,,2019,2.9,4668,4808,140
29063,MO,DeKalb,,2020,4.5,4014,4202,188
29063,MO,DeKalb,,2021,3.8,4010,4167,157
29065,MO,Dent,,2007,6.7,6256,6705,449
29065,MO,Dent,,2008,7.7,6371,6904,533
29065,MO,Dent,,2009,9.3,6222,6857,635
29065,MO,Dent,,2010,10.3,5817,6483,666
29065,MO,Dent,,2011,9.9,5757,6389,632
29065,MO,Dent,,2012,8.4,5468,5971,503
29065,MO,Dent,,2013,7.6,5762,6237,475
29065,MO,Dent,,2014,6.8,5823,6247,424
29065,MO,Dent,,2015,5.9,5890,6262,372
29065,MO,Dent,,2016,5.4,5862,6195,333
29065,MO,Dent,,2017,4.2,5911,6167,256
29065,MO,Dent,,2018,3.2,5998,6198,200
29065,MO,Dent,,2019,3.4,6042,6253,211
29065,MO,Dent,,2020,4.8,5996,6298,302
29065,MO,Dent,,2021,4.3,5987,6257,270
29067,MO,Douglas,,2007,5.9,5578,5926,348
29067,MO,Douglas,,2008,6.8,5694,6112,418
29067,MO,Douglas,,2009,8.6,6186,6770,584
29067,MO,Douglas,,2010,12,4596,5225,629
29067,MO,Douglas,,2011,10.4,4635,5172,537
29067,MO,Douglas,,2012,10.1,4602,5121,519
29067,MO,Douglas,,2013,9.5,4579,5058,479
29067,MO,Douglas,,2014,7.7,4625,5011,386
29067,MO,Douglas,,2015,6.9,4663,5010,347
29067,MO,Douglas,,2016,6.1,4767,5075,308
29067,MO,Douglas,,2017,4.6,4830,5062,232
29067,MO,Douglas,,2018,4.4,4831,5054,223
29067,MO,Douglas,,2019,4.8,4821,5063,242
29067,MO,Douglas,,2020,7.6,4745,5134,389
29067,MO,Douglas,,2021,4.3,4941,5162,221
29069,MO,Dunklin,,2007,8,13231,14381,1150
29069,MO,Dunklin,,2008,8,13322,14478,1156
29069,MO,Dunklin,,2009,10.5,13395,14959,1564
29069,MO,Dunklin,,2010,13.4,10595,12234,1639
29069,MO,Dunklin,,2011,12.4,10780,12304,1524
29069,MO,Dunklin,,2012,10.7,10829,12131,1302
29069,MO,Dunklin,,2013,10,11675,12973,1298
29069,MO,Dunklin,,2014,9.1,11900,13092,1192
29069,MO,Dunklin,,2015,8.2,11982,13051,1069
29069,MO,Dunklin,,2016,8.2,11767,12820,1053
29069,MO,Dunklin,,2017,6.5,11612,12414,802
29069,MO,Dunklin,,2018,5.4,11353,12001,648
29069,MO,Dunklin,,2019,5.2,10844,11443,599
29069,MO,Dunklin,,2020,7.3,10679,11515,836
29069,MO,Dunklin,,2021,6.1,10590,11276,686
29071,MO,Franklin,,2007,5.6,49998,52942,2944
29071,MO,Franklin,,2008,7.5,49471,53509,4038
29071,MO,Franklin,,2009,11.7,47506,53824,6318
29071,MO,Franklin,,2010,11.2,47232,53206,5974
29071,MO,Franklin,,2011,9.6,47646,52692,5046
29071,MO,Franklin,,2012,8.1,47472,51673,4201
29071,MO,Franklin,,2013,7.3,47750,51494,3744
29071,MO,Franklin,,2014,6.5,48531,51903,3372
29071,MO,Franklin,,2015,5.2,49509,52207,2698
29071,MO,Franklin,,2016,4.4,50323,52613,2290
29071,MO,Franklin,,2017,3.6,50476,52365,1889
29071,MO,Franklin,,2018,3,50888,52465,1577
29071,MO,Franklin,,2019,3,51779,53392,1613
29071,MO,Franklin,,2020,6.1,49318,52536,3218
29071,MO,Franklin,,2021,4,50639,52747,2108
29073,MO,Gasconade,,2007,5.5,7723,8173,450
29073,MO,Gasconade,,2008,7.7,7372,7986,614
29073,MO,Gasconade,,2009,11.3,7114,8017,903
29073,MO,Gasconade,,2010,10.4,6919,7718,799
29073,MO,Gasconade,,2011,9,6911,7596,685
29073,MO,Gasconade,,2012,7.3,6944,7489,545
29073,MO,Gasconade,,2013,6.4,7038,7518,480
29073,MO,Gasconade,,2014,5.3,7187,7590,403
29073,MO,Gasconade,,2015,4.3,7304,7634,330
29073,MO,Gasconade,,2016,4.3,7361,7692,331
29073,MO,Gasconade,,2017,3.8,7479,7777,298
29073,MO,Gasconade,,2018,2.9,7507,7728,221
29073,MO,Gasconade,,2019,3.2,7460,7705,245
29073,MO,Gasconade,,2020,5.7,7153,7584,431
29073,MO,Gasconade,,2021,3.6,7342,7620,278
29075,MO,Gentry,,2007,4.1,3285,3425,140
29075,MO,Gentry,,2008,4.5,3364,3524,160
29075,MO,Gentry,,2009,6.2,3384,3606,222
29075,MO,Gentry,,2010,7.8,3234,3509,275
29075,MO,Gentry,,2011,7.1,3315,3568,253
29075,MO,Gentry,,2012,5.5,3371,3567,196
29075,MO,Gentry,,2013,5.3,3397,3587,190
29075,MO,Gentry,,2014,5.7,3416,3621,205
29075,MO,Gentry,,2015,4.3,3438,3592,154
29075,MO,Gentry,,2016,3.7,3451,3584,133
29075,MO,Gentry,,2017,2.8,3514,3616,102
29075,MO,Gentry,,2018,2.4,3484,3568,84
29075,MO,Gentry,,2019,2.5,3391,3479,88
29075,MO,Gentry,,2020,3.4,3278,3392,114
29075,MO,Gentry,,2021,2.7,3245,3334,89
29077,MO,Greene,,2007,4,137206,142897,5691
29077,MO,Greene,,2008,5.1,133817,141044,7227
29077,MO,Greene,,2009,8.2,128712,140164,11452
29077,MO,Greene,,2010,8.3,132202,144128,11926
29077,MO,Greene,,2011,7.5,132930,143671,10741
29077,MO,Greene,,2012,6.1,134238,142979,8741
29077,MO,Greene,,2013,5.6,136072,144083,8011
29077,MO,Greene,,2014,4.9,139639,146806,7167
29077,MO,Greene,,2015,4.2,142081,148369,6288
29077,MO,Greene,,2016,3.8,142801,148413,5612
29077,MO,Greene,,2017,3.1,142294,146789,4495
29077,MO,Greene,,2018,2.5,144367,148104,3737
29077,MO,Greene,,2019,2.5,146573,150407,3834
29077,MO,Greene,,2020,5.3,141608,149592,7984
29077,MO,Greene,,2021,3.4,146978,152184,5206
29079,MO,Grundy,,2007,4.8,4608,4841,233
29079,MO,Grundy,,2008,5.6,4708,4988,280
29079,MO,Grundy,,2009,7.5,4571,4940,369
29079,MO,Grundy,,2010,8,4434,4817,383
29079,MO,Grundy,,2011,7.2,4573,4929,356
29079,MO,Grundy,,2012,6.7,4586,4913,327
29079,MO,Grundy,,2013,5.9,4617,4906,289
29079,MO,Grundy,,2014,5.3,4623,4882,259
29079,MO,Grundy,,2015,4.2,4674,4880,206
29079,MO,Grundy,,2016,4.6,4674,4897,223
29079,MO,Grundy,,2017,3.5,4624,4793,169
29079,MO,Grundy,,2018,3.5,4373,4533,160
29079,MO,Grundy,,2019,3.3,4209,4353,144
29079,MO,Grundy,,2020,4.6,4081,4276,195
29079,MO,Grundy,,2021,3.6,4028,4178,150
29081,MO,Harrison,,2007,4.5,4375,4583,208
29081,MO,Harrison,,2008,5,4396,4625,229
29081,MO,Harrison,,2009,7.4,4289,4634,345
29081,MO,Harrison,,2010,9.4,3663,4045,382
29081,MO,Harrison,,2011,8.7,3654,4001,347
29081,MO,Harrison,,2012,7.5,3647,3942,295
29081,MO,Harrison,,2013,7.4,3663,3955,292
29081,MO,Harrison,,2014,6.6,3706,3966,260
29081,MO,Harrison,,2015,5.2,3758,3963,205
29081,MO,Harrison,,2016,4.2,3801,3968,167
29081,MO,Harrison,,2017,3.5,3776,3913,137
29081,MO,Harrison,,2018,3,3722,3837,115
29081,MO,Harrison,,2019,3.2,3657,3777,120
29081,MO,Harrison,,2020,4.5,3615,3786,171
29081,MO,Harrison,,2021,3.5,3629,3761,132
29083,MO,Henry,,2007,5.6,10379,10995,616
29083,MO,Henry,,2008,6.8,10286,11031,745
29083,MO,Henry,,2009,9.3,9977,11000,1023
29083,MO,Henry,,2010,10.7,9013,10095,1082
29083,MO,Henry,,2011,9.9,8905,9879,974
29083,MO,Henry,,2012,8,8999,9785,786
29083,MO,Henry,,2013,7.2,9129,9839,710
29083,MO,Henry,,2014,6.5,9427,10085,658
29083,MO,Henry,,2015,5.6,9491,10050,559
29083,MO,Henry,,2016,5,9388,9880,492
29083,MO,Henry,,2017,4.1,9476,9880,404
29083,MO,Henry,,2018,3.5,9428,9772,344
29083,MO,Henry,,2019,3.5,9326,9668,342
29083,MO,Henry,,2020,5.8,9080,9644,564
29083,MO,Henry,,2021,4,9661,10059,398
29085,MO,Hickory,,2007,7.5,3191,3448,257
29085,MO,Hickory,,2008,9.7,3154,3494,340
29085,MO,Hickory,,2009,13.1,3062,3522,460
29085,MO,Hickory,,2010,12.5,3202,3661,459
29085,MO,Hickory,,2011,11.9,3134,3557,423
29085,MO,Hickory,,2012,12.4,3158,3603,445
29085,MO,Hickory,,2013,10,3310,3679,369
29085,MO,Hickory,,2014,8.4,3374,3683,309
29085,MO,Hickory,,2015,6.8,3450,3700,250
29085,MO,Hickory,,2016,5.6,3484,3691,207
29085,MO,Hickory,,2017,4.4,3589,3756,167
29085,MO,Hickory,,2018,4.1,3679,3836,157
29085,MO,Hickory,,2019,4,3667,3819,152
29085,MO,Hickory,,2020,5,3673,3866,193
29085,MO,Hickory,,2021,4,3805,3963,158
29087,MO,Holt,,2007,5,2587,2724,137
29087,MO,Holt,,2008,5.1,2651,2792,141
29087,MO,Holt,,2009,6.9,2606,2798,192
29087,MO,Holt,,2010,7.9,2470,2681,211
29087,MO,Holt,,2011,7.4,2489,2687,198
29087,MO,Holt,,2012,5.5,2529,2675,146
29087,MO,Holt,,2013,5.4,2585,2734,149
29087,MO,Holt,,2014,4.9,2555,2687,132
29087,MO,Holt,,2015,3.7,2593,2692,99
29087,MO,Holt,,2016,3.2,2595,2682,87
29087,MO,Holt,,2017,2.9,2613,2690,77
29087,MO,Holt,,2018,2.3,2582,2644,62
29087,MO,Holt,,2019,2.6,2501,2569,68
29087,MO,Holt,,2020,3.3,2454,2539,85
29087,MO,Holt,,2021,2.9,2406,2479,73
29089,MO,Howard,,2007,4.4,4946,5176,230
29089,MO,Howard,,2008,6,4855,5165,310
29089,MO,Howard,,2009,8.2,4710,5131,421
29089,MO,Howard,,2010,8.7,4549,4981,432
29089,MO,Howard,,2011,8.4,4435,4842,407
29089,MO,Howard,,2012,7,4473,4809,336
29089,MO,Howard,,2013,6.5,4592,4912,320
29089,MO,Howard,,2014,5.4,4701,4970,269
29089,MO,Howard,,2015,5,4765,5015,250
29089,MO,Howard,,2016,4.4,4802,5024,222
29089,MO,Howard,,2017,3.8,4881,5074,193
29089,MO,Howard,,2018,2.8,4823,4962,139
29089,MO,Howard,,2019,2.9,4714,4856,142
29089,MO,Howard,,2020,4.1,4605,4803,198
29089,MO,Howard,,2021,3.2,4696,4853,157
29091,MO,Howell,,2007,4.6,19039,19966,927
29091,MO,Howell,,2008,5.7,18945,20093,1148
29091,MO,Howell,,2009,9.4,18039,19916,1877
29091,MO,Howell,,2010,10.7,15165,16990,1825
29091,MO,Howell,,2011,9.8,14849,16462,1613
29091,MO,Howell,,2012,8.4,15064,16448,1384
29091,MO,Howell,,2013,7.9,15075,16369,1294
29091,MO,Howell,,2014,7.2,15058,16222,1164
29091,MO,Howell,,2015,6.6,15189,16254,1065
29091,MO,Howell,,2016,6.3,15079,16097,1018
29091,MO,Howell,,2017,4.7,15133,15884,751
29091,MO,Howell,,2018,3.5,15668,16237,569
29091,MO,Howell,,2019,3.8,15743,16372,629
29091,MO,Howell,,2020,6.7,15108,16188,1080
29091,MO,Howell,,2021,4.8,15387,16165,778
29093,MO,Iron,,2007,5.3,5126,5414,288
29093,MO,Iron,,2008,5.7,5469,5801,332
29093,MO,Iron,,2009,8.6,5300,5799,499
29093,MO,Iron,,2010,16.5,2966,3554,588
29093,MO,Iron,,2011,14.3,3048,3557,509
29093,MO,Iron,,2012,11.7,3290,3728,438
29093,MO,Iron,,2013,10.7,3501,3921,420
29093,MO,Iron,,2014,9.9,3523,3911,388
29093,MO,Iron,,2015,8.1,3521,3830,309
29093,MO,Iron,,2016,7.1,3445,3710,265
29093,MO,Iron,,2017,6.4,3349,3578,229
29093,MO,Iron,,2018,5.3,3341,3529,188
29093,MO,Iron,,2019,4.5,3341,3500,159
29093,MO,Iron,,2020,7,3240,3485,245
29093,MO,Iron,,2021,5.8,3289,3491,202
29095,MO,Jackson,,2007,5.8,319386,339184,19798
29095,MO,Jackson,,2008,7,314298,337880,23582
29095,MO,Jackson,,2009,9.9,310957,345229,34272
29095,MO,Jackson,,2010,10.6,321363,359453,38090
29095,MO,Jackson,,2011,9.7,322012,356582,34570
29095,MO,Jackson,,2012,8,325131,353502,28371
29095,MO,Jackson,,2013,7.7,324929,352116,27187
29095,MO,Jackson,,2014,7.1,330689,356144,25455
29095,MO,Jackson,,2015,6,339191,360910,21719
29095,MO,Jackson,,2016,5.1,345196,363794,18598
29095,MO,Jackson,,2017,4.4,345971,361856,15885
29095,MO,Jackson,,2018,3.7,344820,358194,13374
29095,MO,Jackson,,2019,3.5,347620,360405,12785
29095,MO,Jackson,,2020,7.2,331092,356700,25608
29095,MO,Jackson,,2021,5.5,340103,359763,19660
29097,MO,Jasper,,2007,4.5,54451,57011,2560
29097,MO,Jasper,,2008,5.3,54365,57396,3031
29097,MO,Jasper,,2009,8,53505,58129,4624
29097,MO,Jasper,,2010,8.4,53830,58771,4941
29097,MO,Jasper,,2011,7.7,54024,58548,4524
29097,MO,Jasper,,2012,6.1,54307,57832,3525
29097,MO,Jasper,,2013,5.9,54396,57802,3406
29097,MO,Jasper,,2014,5.3,54472,57529,3057
29097,MO,Jasper,,2015,4.4,55185,57705,2520
29097,MO,Jasper,,2016,4.1,55277,57668,2391
29097,MO,Jasper,,2017,3.4,54827,56730,1903
29097,MO,Jasper,,2018,2.7,54869,56404,1535
29097,MO,Jasper,,2019,2.8,55322,56934,1612
29097,MO,Jasper,,2020,5.7,52632,55788,3156
29097,MO,Jasper,,2021,3.7,54820,56953,2133
29099,MO,Jefferson,,2007,5.2,110915,116953,6038
29099,MO,Jefferson,,2008,6.9,109627,117756,8129
29099,MO,Jefferson,,2009,10.3,105552,117697,12145
29099,MO,Jefferson,,2010,10.3,104981,117009,12028
29099,MO,Jefferson,,2011,8.9,105956,116363,10407
29099,MO,Jefferson,,2012,7.4,106005,114493,8488
29099,MO,Jefferson,,2013,6.9,106651,114506,7855
29099,MO,Jefferson,,2014,6.2,108688,115933,7245
29099,MO,Jefferson,,2015,5,111148,116938,5790
29099,MO,Jefferson,,2016,4.3,112461,117502,5041
29099,MO,Jefferson,,2017,3.6,112044,116180,4136
29099,MO,Jefferson,,2018,3.1,112936,116497,3561
29099,MO,Jefferson,,2019,2.9,115151,118605,3454
29099,MO,Jefferson,,2020,6,109659,116697,7038
29099,MO,Jefferson,,2021,4.1,112790,117556,4766
29101,MO,Johnson,,2007,4.6,25252,26475,1223
29101,MO,Johnson,,2008,5.3,25376,26804,1428
29101,MO,Johnson,,2009,8.2,24134,26301,2167
29101,MO,Johnson,,2010,9.9,21084,23393,2309
29101,MO,Johnson,,2011,9.3,21214,23394,2180
29101,MO,Johnson,,2012,7.9,21112,22925,1813
29101,MO,Johnson,,2013,7.3,21203,22876,1673
29101,MO,Johnson,,2014,6.5,21255,22727,1472
29101,MO,Johnson,,2015,5.5,21711,22972,1261
29101,MO,Johnson,,2016,4.9,22024,23156,1132
29101,MO,Johnson,,2017,4.4,22237,23252,1015
29101,MO,Johnson,,2018,3.6,21890,22716,826
29101,MO,Johnson,,2019,3.5,22183,22988,805
29101,MO,Johnson,,2020,5.6,21757,23058,1301
29101,MO,Johnson,,2021,4.4,22060,23074,1014
29103,MO,Knox,,2007,3.8,2273,2363,90
29103,MO,Knox,,2008,4.7,2276,2389,113
29103,MO,Knox,,2009,5.9,2216,2354,138
29103,MO,Knox,,2010,7.7,1845,1999,154
29103,MO,Knox,,2011,7.3,1825,1969,144
29103,MO,Knox,,2012,5.8,1842,1956,114
29103,MO,Knox,,2013,5.6,1869,1979,110
29103,MO,Knox,,2014,4.6,1873,1963,90
29103,MO,Knox,,2015,3.9,1873,1950,77
29103,MO,Knox,,2016,3.6,1910,1982,72
29103,MO,Knox,,2017,3.2,1926,1990,64
29103,MO,Knox,,2018,2.8,1860,1914,54
29103,MO,Knox,,2019,2.8,1713,1762,49
29103,MO,Knox,,2020,4,1676,1745,69
29103,MO,Knox,,2021,3.1,1676,1729,53
29105,MO,Laclede,,2007,5.6,16738,17723,985
29105,MO,Laclede,,2008,7.6,16707,18090,1383
29105,MO,Laclede,,2009,12.2,14560,16584,2024
29105,MO,Laclede,,2010,12.3,13893,15846,1953
29105,MO,Laclede,,2011,11.5,14028,15854,1826
29105,MO,Laclede,,2012,9.5,14200,15697,1497
29105,MO,Laclede,,2013,9.7,14048,15555,1507
29105,MO,Laclede,,2014,8.1,14561,15848,1287
29105,MO,Laclede,,2015,6.5,14817,15843,1026
29105,MO,Laclede,,2016,5.4,15263,16142,879
29105,MO,Laclede,,2017,4.7,15802,16586,784
29105,MO,Laclede,,2018,3.6,16142,16752,610
29105,MO,Laclede,,2019,6.5,16096,17214,1118
29105,MO,Laclede,,2020,8.1,15346,16704,1358
29105,MO,Laclede,,2021,4.3,15802,16514,712
29107,MO,Lafayette,,2007,5.1,15723,16575,852
29107,MO,Lafayette,,2008,6.2,15548,16571,1023
29107,MO,Lafayette,,2009,9.5,14419,15933,1514
29107,MO,Lafayette,,2010,9.7,15775,17474,1699
29107,MO,Lafayette,,2011,9.3,15770,17378,1608
29107,MO,Lafayette,,2012,7.3,15875,17130,1255
29107,MO,Lafayette,,2013,6.5,15773,16869,1096
29107,MO,Lafayette,,2014,6,15889,16900,1011
29107,MO,Lafayette,,2015,4.9,16232,17075,843
29107,MO,Lafayette,,2016,4.3,16434,17173,739
29107,MO,Lafayette,,2017,3.8,16322,16959,637
29107,MO,Lafayette,,2018,3.2,16182,16718,536
29107,MO,Lafayette,,2019,2.9,16213,16700,487
29107,MO,Lafayette,,2020,5.2,15638,16498,860
29107,MO,Lafayette,,2021,4.3,15963,16674,711
29109,MO,Lawrence,,2007,4,18634,19418,784
29109,MO,Lawrence,,2008,4.9,18677,19635,958
29109,MO,Lawrence,,2009,8.1,17637,19191,1554
29109,MO,Lawrence,,2010,9.2,15870,17483,1613
29109,MO,Lawrence,,2011,8.5,15842,17312,1470
29109,MO,Lawrence,,2012,6.7,16037,17194,1157
29109,MO,Lawrence,,2013,6.7,16216,17373,1157
29109,MO,Lawrence,,2014,5.9,16383,17413,1030
29109,MO,Lawrence,,2015,5,16885,17773,888
29109,MO,Lawrence,,2016,4.4,16992,17766,774
29109,MO,Lawrence,,2017,3.5,17210,17839,629
29109,MO,Lawrence,,2018,3,17505,18047,542
29109,MO,Lawrence,,2019,3.3,17289,17884,595
29109,MO,Lawrence,,2020,6,16553,17618,1065
29109,MO,Lawrence,,2021,4,16752,17457,705
29111,MO,Lewis,,2007,3.9,5500,5725,225
29111,MO,Lewis,,2008,4.9,5320,5592,272
29111,MO,Lewis,,2009,8.1,5055,5498,443
29111,MO,Lewis,,2010,8.5,4742,5181,439
29111,MO,Lewis,,2011,7.1,4752,5115,363
29111,MO,Lewis,,2012,5.7,4836,5128,292
29111,MO,Lewis,,2013,5.6,4782,5066,284
29111,MO,Lewis,,2014,5.2,4871,5140,269
29111,MO,Lewis,,2015,5,4921,5181,260
29111,MO,Lewis,,2016,4.5,4900,5132,232
29111,MO,Lewis,,2017,3.4,4931,5105,174
29111,MO,Lewis,,2018,2.8,4924,5065,141
29111,MO,Lewis,,2019,3,4819,4968,149
29111,MO,Lewis,,2020,4.9,4693,4933,240
29111,MO,Lewis,,2021,3.5,4657,4826,169
29113,MO,Lincoln,,2007,5.7,25066,26569,1503
29113,MO,Lincoln,,2008,7.9,25188,27348,2160
29113,MO,Lincoln,,2009,11.5,24345,27521,3176
29113,MO,Lincoln,,2010,11.7,23476,26581,3105
29113,MO,Lincoln,,2011,10.3,23843,26569,2726
29113,MO,Lincoln,,2012,8.6,23944,26193,2249
29113,MO,Lincoln,,2013,7.7,24232,26241,2009
29113,MO,Lincoln,,2014,6.5,24751,26484,1733
29113,MO,Lincoln,,2015,5.3,25383,26795,1412
29113,MO,Lincoln,,2016,4.5,25980,27200,1220
29113,MO,Lincoln,,2017,3.6,26367,27343,976
29113,MO,Lincoln,,2018,3.2,27192,28087,895
29113,MO,Lincoln,,2019,3.1,28193,29094,901
29113,MO,Lincoln,,2020,6.1,27257,29023,1766
29113,MO,Lincoln,,2021,4.6,27956,29307,1351
29115,MO,Linn,,2007,6.4,6090,6504,414
29115,MO,Linn,,2008,7,6147,6609,462
29115,MO,Linn,,2009,9.3,6042,6662,620
29115,MO,Linn,,2010,12.5,4749,5425,676
29115,MO,Linn,,2011,12.1,4669,5312,643
29115,MO,Linn,,2012,9.6,4656,5149,493
29115,MO,Linn,,2013,8.9,4831,5303,472
29115,MO,Linn,,2014,8.2,4777,5203,426
29115,MO,Linn,,2015,7.2,4840,5213,373
29115,MO,Linn,,2016,6.7,4914,5266,352
29115,MO,Linn,,2017,5.8,4951,5255,304
29115,MO,Linn,,2018,4.6,4878,5114,236
29115,MO,Linn,,2019,4.6,4825,5058,233
29115,MO,Linn,,2020,6.1,4738,5048,310
29115,MO,Linn,,2021,5.4,4801,5077,276
29117,MO,Livingston,,2007,4.4,6899,7215,316
29117,MO,Livingston,,2008,5.2,6814,7188,374
29117,MO,Livingston,,2009,7.5,6840,7397,557
29117,MO,Livingston,,2010,8.1,6541,7118,577
29117,MO,Livingston,,2011,7.7,6509,7053,544
29117,MO,Livingston,,2012,6.4,6716,7175,459
29117,MO,Livingston,,2013,5.7,6834,7247,413
29117,MO,Livingston,,2014,5.1,6914,7282,368
29117,MO,Livingston,,2015,4.3,6944,7259,315
29117,MO,Livingston,,2016,3.9,7056,7342,286
29117,MO,Livingston,,2017,2.9,7235,7453,218
29117,MO,Livingston,,2018,2.4,7307,7490,183
29117,MO,Livingston,,2019,2.4,7141,7317,176
29117,MO,Livingston,,2020,3.7,7019,7289,270
29117,MO,Livingston,,2021,3,7037,7256,219
29119,MO,McDonald,,2007,4.1,11115,11593,478
29119,MO,McDonald,,2008,5,10612,11165,553
29119,MO,McDonald,,2009,7.6,9891,10704,813
29119,MO,McDonald,,2010,9.1,9378,10316,938
29119,MO,McDonald,,2011,8.5,9322,10189,867
29119,MO,McDonald,,2012,6.9,9418,10115,697
29119,MO,McDonald,,2013,6.5,9304,9949,645
29119,MO,McDonald,,2014,5.8,9656,10253,597
29119,MO,McDonald,,2015,4.8,9847,10347,500
29119,MO,McDonald,,2016,4.3,10010,10462,452
29119,MO,McDonald,,2017,3.6,10003,10379,376
29119,MO,McDonald,,2018,3,10120,10435,315
29119,MO,McDonald,,2019,3.2,10058,10390,332
29119,MO,McDonald,,2020,5.1,9794,10321,527
29119,MO,McDonald,,2021,3.9,10199,10608,409
29121,MO,Macon,,2007,5,7704,8107,403
29121,MO,Macon,,2008,6,7467,7945,478
29121,MO,Macon,,2009,8.2,7569,8247,678
29121,MO,Macon,,2010,9.2,6765,7450,685
29121,MO,Macon,,2011,8.5,6824,7454,630
29121,MO,Macon,,2012,6.9,6938,7455,517
29121,MO,Macon,,2013,6.6,6915,7403,488
29121,MO,Macon,,2014,6.2,6964,7422,458
29121,MO,Macon,,2015,5.4,7022,7425,403
29121,MO,Macon,,2016,4.8,7243,7606,363
29121,MO,Macon,,2017,3.6,7298,7571,273
29121,MO,Macon,,2018,2.9,7378,7600,222
29121,MO,Macon,,2019,3.2,7225,7464,239
29121,MO,Macon,,2020,4.8,7064,7418,354
29121,MO,Macon,,2021,3.7,7093,7365,272
29123,MO,Madison,,2007,5.7,5756,6103,347
29123,MO,Madison,,2008,6.2,5864,6249,385
29123,MO,Madison,,2009,10,5662,6293,631
29123,MO,Madison,,2010,12.1,4777,5433,656
29123,MO,Madison,,2011,10.6,4771,5338,567
29123,MO,Madison,,2012,8.5,4889,5345,456
29123,MO,Madison,,2013,7.7,5120,5550,430
29123,MO,Madison,,2014,7,5101,5483,382
29123,MO,Madison,,2015,6,5157,5486,329
29123,MO,Madison,,2016,5.5,5172,5472,300
29123,MO,Madison,,2017,4.5,5241,5486,245
29123,MO,Madison,,2018,3.5,5261,5449,188
29123,MO,Madison,,2019,3.2,5257,5432,175
29123,MO,Madison,,2020,6.5,5099,5452,353
29123,MO,Madison,,2021,4.4,5231,5473,242
29125,MO,Maries,,2007,5.2,4560,4809,249
29125,MO,Maries,,2008,6.3,4540,4846,306
29125,MO,Maries,,2009,7.8,4464,4844,380
29125,MO,Maries,,2010,9.4,3840,4239,399
29125,MO,Maries,,2011,8.6,3826,4186,360
29125,MO,Maries,,2012,7.4,3816,4123,307
29125,MO,Maries,,2013,6.6,3889,4166,277
29125,MO,Maries,,2014,6.2,3711,3958,247
29125,MO,Maries,,2015,5.4,3701,3913,212
29125,MO,Maries,,2016,5,3710,3906,196
29125,MO,Maries,,2017,4.3,3746,3914,168
29125,MO,Maries,,2018,3.2,3743,3868,125
29125,MO,Maries,,2019,3.3,3726,3853,127
29125,MO,Maries,,2020,4.9,3707,3896,189
29125,MO,Maries,,2021,3.8,3748,3898,150
29127,MO,Marion,,2007,5.3,13778,14546,768
29127,MO,Marion,,2008,5.7,14034,14880,846
29127,MO,Marion,,2009,9.2,13626,15005,1379
29127,MO,Marion,,2010,9,13380,14707,1327
29127,MO,Marion,,2011,7.6,13369,14473,1104
29127,MO,Marion,,2012,6.3,13484,14389,905
29127,MO,Marion,,2013,6.1,13706,14592,886
29127,MO,Marion,,2014,5.6,13767,14576,809
29127,MO,Marion,,2015,4.5,13995,14659,664
29127,MO,Marion,,2016,4.3,13935,14557,622
29127,MO,Marion,,2017,3.6,14009,14527,518
29127,MO,Marion,,2018,3,13977,14416,439
29127,MO,Marion,,2019,3,13962,14394,432
29127,MO,Marion,,2020,4.8,13546,14226,680
29127,MO,Marion,,2021,3.5,13705,14197,492
29129,MO,Mercer,,2007,4.1,1743,1818,75
29129,MO,Mercer,,2008,4.8,1766,1856,90
29129,MO,Mercer,,2009,7.1,1643,1769,126
29129,MO,Mercer,,2010,8.3,1640,1788,148
29129,MO,Mercer,,2011,6.8,1703,1828,125
29129,MO,Mercer,,2012,5.3,1724,1821,97
29129,MO,Mercer,,2013,5.5,1704,1803,99
29129,MO,Mercer,,2014,5.1,1768,1863,95
29129,MO,Mercer,,2015,4.5,1791,1876,85
29129,MO,Mercer,,2016,4.6,1838,1926,88
29129,MO,Mercer,,2017,3.7,1871,1943,72
29129,MO,Mercer,,2018,3,1846,1904,58
29129,MO,Mercer,,2019,3,1786,1841,55
29129,MO,Mercer,,2020,3.5,1797,1862,65
29129,MO,Mercer,,2021,2.9,1752,1805,53
29131,MO,Miller,,2007,5.2,12743,13448,705
29131,MO,Miller,,2008,6.8,12446,13351,905
29131,MO,Miller,,2009,11.4,11393,12854,1461
29131,MO,Miller,,2010,12.8,10295,11804,1509
29131,MO,Miller,,2011,11.7,10010,11333,1323
29131,MO,Miller,,2012,9.3,10249,11302,1053
29131,MO,Miller,,2013,8.8,10454,11466,1012
29131,MO,Miller,,2014,7.8,10704,11604,900
29131,MO,Miller,,2015,6.1,10873,11584,711
29131,MO,Miller,,2016,5.2,11257,11871,614
29131,MO,Miller,,2017,4.4,11475,12005,530
29131,MO,Miller,,2018,3.6,11670,12105,435
29131,MO,Miller,,2019,3.6,11772,12207,435
29131,MO,Miller,,2020,6,11528,12268,740
29131,MO,Miller,,2021,4.1,12076,12593,517
29133,MO,Mississippi,,2007,6.5,5536,5924,388
29133,MO,Mississippi,,2008,7.3,5459,5890,431
29133,MO,Mississippi,,2009,8.4,5682,6206,524
29133,MO,Mississippi,,2010,9.6,5498,6081,583
29133,MO,Mississippi,,2011,9.8,5451,6044,593
29133,MO,Mississippi,,2012,8.2,5614,6114,500
29133,MO,Mississippi,,2013,7.9,5790,6285,495
29133,MO,Mississippi,,2014,7.3,5788,6244,456
29133,MO,Mississippi,,2015,5.9,5877,6246,369
29133,MO,Mississippi,,2016,6.6,5797,6208,411
29133,MO,Mississippi,,2017,5,5743,6045,302
29133,MO,Mississippi,,2018,3.7,5708,5930,222
29133,MO,Mississippi,,2019,3.8,5498,5718,220
29133,MO,Mississippi,,2020,5.3,5329,5629,300
29133,MO,Mississippi,,2021,4.7,5186,5440,254
29135,MO,Moniteau,,2007,4.6,7197,7544,347
29135,MO,Moniteau,,2008,5.6,7091,7508,417
29135,MO,Moniteau,,2009,8,6895,7491,596
29135,MO,Moniteau,,2010,8.4,6749,7366,617
29135,MO,Moniteau,,2011,7.8,6764,7337,573
29135,MO,Moniteau,,2012,6.8,6777,7273,496
29135,MO,Moniteau,,2013,6.4,6828,7296,468
29135,MO,Moniteau,,2014,6,6914,7356,442
29135,MO,Moniteau,,2015,5,6987,7354,367
29135,MO,Moniteau,,2016,4.3,7140,7463,323
29135,MO,Moniteau,,2017,3.6,7088,7353,265
29135,MO,Moniteau,,2018,2.9,7059,7272,213
29135,MO,Moniteau,,2019,2.8,7107,7310,203
29135,MO,Moniteau,,2020,4.3,6796,7100,304
29135,MO,Moniteau,,2021,3.4,6810,7049,239
29137,MO,Monroe,,2007,5.7,4134,4385,251
29137,MO,Monroe,,2008,7,4088,4397,309
29137,MO,Monroe,,2009,12.6,3709,4245,536
29137,MO,Monroe,,2010,12.2,3600,4099,499
29137,MO,Monroe,,2011,10.1,3664,4074,410
29137,MO,Monroe,,2012,7.9,3714,4032,318
29137,MO,Monroe,,2013,7.4,3796,4100,304
29137,MO,Monroe,,2014,6.4,3902,4171,269
29137,MO,Monroe,,2015,5.3,3962,4184,222
29137,MO,Monroe,,2016,4.8,3956,4157,201
29137,MO,Monroe,,2017,4.3,3891,4064,173
29137,MO,Monroe,,2018,3.5,3814,3953,139
29137,MO,Monroe,,2019,4,3660,3812,152
29137,MO,Monroe,,2020,5.9,3554,3775,221
29137,MO,Monroe,,2021,4.4,3618,3783,165
29139,MO,Montgomery,,2007,5.4,5835,6171,336
29139,MO,Montgomery,,2008,7.2,5751,6200,449
29139,MO,Montgomery,,2009,11.5,5424,6129,705
29139,MO,Montgomery,,2010,11,5355,6018,663
29139,MO,Montgomery,,2011,10.1,5328,5928,600
29139,MO,Montgomery,,2012,8.1,5300,5767,467
29139,MO,Montgomery,,2013,7.3,5288,5703,415
29139,MO,Montgomery,,2014,5.9,5330,5667,337
29139,MO,Montgomery,,2015,5.1,5385,5672,287
29139,MO,Montgomery,,2016,4.6,5481,5743,262
29139,MO,Montgomery,,2017,3.3,5463,5647,184
29139,MO,Montgomery,,2018,2.9,5520,5682,162
29139,MO,Montgomery,,2019,3,5533,5703,170
29139,MO,Montgomery,,2020,4.9,5427,5706,279
29139,MO,Montgomery,,2021,3.7,5573,5788,215
29141,MO,Morgan,,2007,6.2,8828,9407,579
29141,MO,Morgan,,2008,7.6,8740,9459,719
29141,MO,Morgan,,2009,12.3,8182,9325,1143
29141,MO,Morgan,,2010,14.4,6800,7947,1147
29141,MO,Morgan,,2011,12.9,6832,7843,1011
29141,MO,Morgan,,2012,10.3,6968,7764,796
29141,MO,Morgan,,2013,9.6,7082,7830,748
29141,MO,Morgan,,2014,8.7,7247,7939,692
29141,MO,Morgan,,2015,6.9,7479,8031,552
29141,MO,Morgan,,2016,5.9,7491,7958,467
29141,MO,Morgan,,2017,4.9,7546,7935,389
29141,MO,Morgan,,2018,4.2,7620,7955,335
29141,MO,Morgan,,2019,4.1,7742,8074,332
29141,MO,Morgan,,2020,6.2,7693,8202,509
29141,MO,Morgan,,2021,4.7,8137,8540,403
29143,MO,New Madrid,,2007,6.9,8376,8993,617
29143,MO,New Madrid,,2008,7.2,8378,9028,650
29143,MO,New Madrid,,2009,9.1,7739,8512,773
29143,MO,New Madrid,,2010,9.9,7380,8190,810
29143,MO,New Madrid,,2011,9.9,7386,8200,814
29143,MO,New Madrid,,2012,8.3,7409,8084,675
29143,MO,New Madrid,,2013,7.9,7610,8266,656
29143,MO,New Madrid,,2014,7.5,7806,8435,629
29143,MO,New Madrid,,2015,6.3,7990,8531,541
29143,MO,New Madrid,,2016,9.3,7468,8230,762
29143,MO,New Madrid,,2017,6.6,7469,7993,524
29143,MO,New Madrid,,2018,4.7,7642,8016,374
29143,MO,New Madrid,,2019,4.1,7827,8159,332
29143,MO,New Madrid,,2020,5.8,7910,8397,487
29143,MO,New Madrid,,2021,4.8,7930,8326,396
29145,MO,Newton,,2007,4.7,26751,28072,1321
29145,MO,Newton,,2008,5.6,26388,27948,1560
29145,MO,Newton,,2009,7.9,25671,27869,2198
29145,MO,Newton,,2010,8.9,26083,28636,2553
29145,MO,Newton,,2011,8.1,26490,28836,2346
29145,MO,Newton,,2012,6.4,27332,29188,1856
29145,MO,Newton,,2013,6.1,27098,28851,1753
29145,MO,Newton,,2014,5.4,26796,28332,1536
29145,MO,Newton,,2015,4.7,26948,28266,1318
29145,MO,Newton,,2016,4.3,26960,28186,1226
29145,MO,Newton,,2017,3.6,26321,27314,993
29145,MO,Newton,,2018,3,26217,27024,807
29145,MO,Newton,,2019,3.1,26210,27049,839
29145,MO,Newton,,2020,5.8,25048,26580,1532
29145,MO,Newton,,2021,3.8,26014,27045,1031
29147,MO,Nodaway,,2007,3.7,12199,12672,473
29147,MO,Nodaway,,2008,4.3,12470,13024,554
29147,MO,Nodaway,,2009,6.2,12002,12796,794
29147,MO,Nodaway,,2010,7.2,10871,11710,839
29147,MO,Nodaway,,2011,7,10733,11541,808
29147,MO,Nodaway,,2012,5.8,10973,11644,671
29147,MO,Nodaway,,2013,6.6,10575,11323,748
29147,MO,Nodaway,,2014,6.8,10304,11061,757
29147,MO,Nodaway,,2015,5,10399,10947,548
29147,MO,Nodaway,,2016,4.7,10334,10838,504
29147,MO,Nodaway,,2017,3.6,10254,10634,380
29147,MO,Nodaway,,2018,2.9,10330,10635,305
29147,MO,Nodaway,,2019,2.8,10423,10724,301
29147,MO,Nodaway,,2020,4.4,10235,10708,473
29147,MO,Nodaway,,2021,2.9,10473,10791,318
29149,MO,Oregon,,2007,5.2,4352,4589,237
29149,MO,Oregon,,2008,5.9,4356,4629,273
29149,MO,Oregon,,2009,8.9,4265,4683,418
29149,MO,Oregon,,2010,11,3638,4087,449
29149,MO,Oregon,,2011,10,3640,4045,405
29149,MO,Oregon,,2012,8.1,3698,4025,327
29149,MO,Oregon,,2013,8,3794,4125,331
29149,MO,Oregon,,2014,7.5,3818,4129,311
29149,MO,Oregon,,2015,6.5,3871,4138,267
29149,MO,Oregon,,2016,6,3864,4110,246
29149,MO,Oregon,,2017,4.6,3829,4012,183
29149,MO,Oregon,,2018,3.4,3801,3935,134
29149,MO,Oregon,,2019,3.8,3794,3942,148
29149,MO,Oregon,,2020,6.8,3647,3911,264
29149,MO,Oregon,,2021,5.3,3636,3839,203
29151,MO,Osage,,2007,4.7,7079,7429,350
29151,MO,Osage,,2008,6.2,7032,7497,465
29151,MO,Osage,,2009,6.6,6882,7366,484
29151,MO,Osage,,2010,6.9,6926,7436,510
29151,MO,Osage,,2011,6.3,6919,7385,466
29151,MO,Osage,,2012,5.2,6900,7278,378
29151,MO,Osage,,2013,5,6823,7184,361
29151,MO,Osage,,2014,4.7,6862,7198,336
29151,MO,Osage,,2015,3.8,6842,7114,272
29151,MO,Osage,,2016,3.4,6974,7219,245
29151,MO,Osage,,2017,3,6897,7108,211
29151,MO,Osage,,2018,2.4,6879,7045,166
29151,MO,Osage,,2019,2.3,6890,7049,159
29151,MO,Osage,,2020,3.6,6764,7015,251
29151,MO,Osage,,2021,2.6,6801,6985,184
29153,MO,Ozark,,2007,5.2,4191,4422,231
29153,MO,Ozark,,2008,6.1,4189,4461,272
29153,MO,Ozark,,2009,7.9,4165,4523,358
29153,MO,Ozark,,2010,11.7,3168,3587,419
29153,MO,Ozark,,2011,12.1,3136,3568,432
29153,MO,Ozark,,2012,10.5,3200,3575,375
29153,MO,Ozark,,2013,10.4,3285,3668,383
29153,MO,Ozark,,2014,9,3324,3653,329
29153,MO,Ozark,,2015,8.1,3333,3628,295
29153,MO,Ozark,,2016,7.3,3364,3627,263
29153,MO,Ozark,,2017,5.8,3358,3564,206
29153,MO,Ozark,,2018,5.1,3263,3437,174
29153,MO,Ozark,,2019,5.5,3225,3411,186
29153,MO,Ozark,,2020,7.2,3214,3463,249
29153,MO,Ozark,,2021,5.5,3254,3442,188
29155,MO,Pemiscot,,2007,6.6,7654,8192,538
29155,MO,Pemiscot,,2008,7.5,7728,8353,625
29155,MO,Pemiscot,,2009,11.5,7564,8544,980
29155,MO,Pemiscot,,2010,12.3,6300,7187,887
29155,MO,Pemiscot,,2011,11.9,6314,7165,851
29155,MO,Pemiscot,,2012,9.9,6365,7067,702
29155,MO,Pemiscot,,2013,10.4,6344,7083,739
29155,MO,Pemiscot,,2014,9.3,6413,7074,661
29155,MO,Pemiscot,,2015,9.2,6359,7006,647
29155,MO,Pemiscot,,2016,8.9,6401,7023,622
29155,MO,Pemiscot,,2017,7.4,6065,6551,486
29155,MO,Pemiscot,,2018,5.4,5964,6303,339
29155,MO,Pemiscot,,2019,4.7,5993,6291,298
29155,MO,Pemiscot,,2020,8,5760,6258,498
29155,MO,Pemiscot,,2021,7.3,5633,6078,445
29157,MO,Perry,,2007,3.9,10085,10497,412
29157,MO,Perry,,2008,4.7,10069,10563,494
29157,MO,Perry,,2009,6.9,9910,10641,731
29157,MO,Perry,,2010,7.2,9090,9794,704
29157,MO,Perry,,2011,6.8,9154,9820,666
29157,MO,Perry,,2012,5.3,9407,9932,525
29157,MO,Perry,,2013,5.5,9552,10106,554
29157,MO,Perry,,2014,5.5,9684,10243,559
29157,MO,Perry,,2015,4.3,9711,10146,435
29157,MO,Perry,,2016,3.6,9710,10068,358
29157,MO,Perry,,2017,2.6,9834,10101,267
29157,MO,Perry,,2018,2.3,9926,10159,233
29157,MO,Perry,,2019,2.5,9731,9980,249
29157,MO,Perry,,2020,5.5,9269,9809,540
29157,MO,Perry,,2021,3.2,9471,9781,310
29159,MO,Pettis,,2007,5.2,20035,21136,1101
29159,MO,Pettis,,2008,6.3,20152,21496,1344
29159,MO,Pettis,,2009,8.5,19037,20806,1769
29159,MO,Pettis,,2010,9.2,18155,19992,1837
29159,MO,Pettis,,2011,8.4,18382,20072,1690
29159,MO,Pettis,,2012,7.3,18411,19858,1447
29159,MO,Pettis,,2013,6.6,18693,20021,1328
29159,MO,Pettis,,2014,6.2,19315,20583,1268
29159,MO,Pettis,,2015,5.4,19684,20800,1116
29159,MO,Pettis,,2016,4.9,19588,20602,1014
29159,MO,Pettis,,2017,4.1,19987,20850,863
29159,MO,Pettis,,2018,4.1,19871,20713,842
29159,MO,Pettis,,2019,3.3,20098,20793,695
29159,MO,Pettis,,2020,6.7,19188,20573,1385
29159,MO,Pettis,,2021,4.7,19349,20298,949
29161,MO,Phelps,,2007,4.9,21054,22145,1091
29161,MO,Phelps,,2008,5.9,21157,22485,1328
29161,MO,Phelps,,2009,7.1,20567,22138,1571
29161,MO,Phelps,,2010,9,17965,19731,1766
29161,MO,Phelps,,2011,8.6,18131,19839,1708
29161,MO,Phelps,,2012,7.3,18115,19541,1426
29161,MO,Phelps,,2013,7.1,17929,19297,1368
29161,MO,Phelps,,2014,6.5,18110,19371,1261
29161,MO,Phelps,,2015,5.4,18396,19452,1056
29161,MO,Phelps,,2016,4.7,18562,19485,923
29161,MO,Phelps,,2017,3.7,18947,19678,731
29161,MO,Phelps,,2018,3,19046,19642,596
29161,MO,Phelps,,2019,3.1,19030,19639,609
29161,MO,Phelps,,2020,4.7,18792,19727,935
29161,MO,Phelps,,2021,3.7,19284,20030,746
29163,MO,Pike,,2007,5,8505,8954,449
29163,MO,Pike,,2008,5.8,8780,9319,539
29163,MO,Pike,,2009,8.9,8496,9321,825
29163,MO,Pike,,2010,9.7,7407,8203,796
29163,MO,Pike,,2011,8.5,7473,8166,693
29163,MO,Pike,,2012,7.1,7508,8080,572
29163,MO,Pike,,2013,6.6,7542,8073,531
29163,MO,Pike,,2014,5.7,7654,8118,464
29163,MO,Pike,,2015,4.7,7684,8060,376
29163,MO,Pike,,2016,4.5,7694,8056,362
29163,MO,Pike,,2017,3.4,7653,7925,272
29163,MO,Pike,,2018,3.5,7390,7662,272
29163,MO,Pike,,2019,3.3,7222,7472,250
29163,MO,Pike,,2020,5.3,7059,7458,399
29163,MO,Pike,,2021,3.9,7092,7382,290
29165,MO,Platte,,2007,3.9,47135,49063,1928
29165,MO,Platte,,2008,4.8,46832,49218,2386
29165,MO,Platte,,2009,7.5,46333,50091,3758
29165,MO,Platte,,2010,7.7,47425,51366,3941
29165,MO,Platte,,2011,7.1,48111,51765,3654
29165,MO,Platte,,2012,5.7,49141,52098,2957
29165,MO,Platte,,2013,5.7,49573,52579,3006
29165,MO,Platte,,2014,5.1,51030,53791,2761
29165,MO,Platte,,2015,4.3,52734,55094,2360
29165,MO,Platte,,2016,3.6,54601,56646,2045
29165,MO,Platte,,2017,3.2,55769,57596,1827
29165,MO,Platte,,2018,2.5,56436,57905,1469
29165,MO,Platte,,2019,2.5,57419,58901,1482
29165,MO,Platte,,2020,5.4,55594,58753,3159
29165,MO,Platte,,2021,4,57052,59458,2406
29167,MO,Polk,,2007,4.8,13794,14486,692
29167,MO,Polk,,2008,6.1,13387,14261,874
29167,MO,Polk,,2009,9.7,12842,14225,1383
29167,MO,Polk,,2010,10.2,12879,14343,1464
29167,MO,Polk,,2011,9.5,12903,14263,1360
29167,MO,Polk,,2012,8,12876,13990,1114
29167,MO,Polk,,2013,7.2,12880,13878,998
29167,MO,Polk,,2014,6.4,13166,14065,899
29167,MO,Polk,,2015,5.4,13410,14173,763
29167,MO,Polk,,2016,4.9,13516,14205,689
29167,MO,Polk,,2017,4,13615,14178,563
29167,MO,Polk,,2018,3.6,13861,14378,517
29167,MO,Polk,,2019,3.3,13923,14395,472
29167,MO,Polk,,2020,4.7,13623,14290,667
29167,MO,Polk,,2021,3.5,14067,14576,509
29169,MO,Pulaski,,2007,5.2,17897,18871,974
29169,MO,Pulaski,,2008,5.8,18757,19907,1150
29169,MO,Pulaski,,2009,7,19497,20955,1458
29169,MO,Pulaski,,2010,8.7,15186,16636,1450
29169,MO,Pulaski,,2011,8.9,15121,16592,1471
29169,MO,Pulaski,,2012,8.4,14455,15781,1326
29169,MO,Pulaski,,2013,8,14333,15581,1248
29169,MO,Pulaski,,2014,7.3,14064,15170,1106
29169,MO,Pulaski,,2015,6,13921,14803,882
29169,MO,Pulaski,,2016,5.4,13678,14461,783
29169,MO,Pulaski,,2017,4.3,14070,14695,625
29169,MO,Pulaski,,2018,3.6,14067,14585,518
29169,MO,Pulaski,,2019,3.9,14039,14604,565
29169,MO,Pulaski,,2020,5.6,13708,14524,816
29169,MO,Pulaski,,2021,4.4,13938,14585,647
29171,MO,Putnam,,2007,5.5,2370,2509,139
29171,MO,Putnam,,2008,5.4,2398,2536,138
29171,MO,Putnam,,2009,7.1,2328,2506,178
29171,MO,Putnam,,2010,8,2188,2378,190
29171,MO,Putnam,,2011,7,2196,2361,165
29171,MO,Putnam,,2012,6.2,2192,2336,144
29171,MO,Putnam,,2013,6,2297,2443,146
29171,MO,Putnam,,2014,5.1,2357,2483,126
29171,MO,Putnam,,2015,4.1,2384,2485,101
29171,MO,Putnam,,2016,4.6,2340,2452,112
29171,MO,Putnam,,2017,3.8,2352,2444,92
29171,MO,Putnam,,2018,3.4,2335,2417,82
29171,MO,Putnam,,2019,3.4,2184,2261,77
29171,MO,Putnam,,2020,4.4,2167,2266,99
29171,MO,Putnam,,2021,3.1,2163,2233,70
29173,MO,Ralls,,2007,4.9,5367,5643,276
29173,MO,Ralls,,2008,5.4,5451,5762,311
29173,MO,Ralls,,2009,8.5,5145,5626,481
29173,MO,Ralls,,2010,8.7,5122,5611,489
29173,MO,Ralls,,2011,7.6,5190,5619,429
29173,MO,Ralls,,2012,6.6,5222,5591,369
29173,MO,Ralls,,2013,5.9,5261,5588,327
29173,MO,Ralls,,2014,5.3,5322,5620,298
29173,MO,Ralls,,2015,4.3,5393,5636,243
29173,MO,Ralls,,2016,4,5395,5621,226
29173,MO,Ralls,,2017,3.1,5467,5642,175
29173,MO,Ralls,,2018,2.8,5451,5606,155
29173,MO,Ralls,,2019,3,5493,5660,167
29173,MO,Ralls,,2020,4.4,5363,5612,249
29173,MO,Ralls,,2021,3.4,5412,5602,190
29175,MO,Randolph,,2007,5.3,12516,13223,707
29175,MO,Randolph,,2008,6.1,12563,13385,822
29175,MO,Randolph,,2009,10.4,11884,13258,1374
29175,MO,Randolph,,2010,11.5,9513,10745,1232
29175,MO,Randolph,,2011,10.7,9618,10774,1156
29175,MO,Randolph,,2012,9,9653,10609,956
29175,MO,Randolph,,2013,8.3,9637,10505,868
29175,MO,Randolph,,2014,7.1,9783,10530,747
29175,MO,Randolph,,2015,6.1,9805,10444,639
29175,MO,Randolph,,2016,5.2,9933,10481,548
29175,MO,Randolph,,2017,4.5,9802,10264,462
29175,MO,Randolph,,2018,3.8,9835,10219,384
29175,MO,Randolph,,2019,3.7,9892,10269,377
29175,MO,Randolph,,2020,5.9,9523,10119,596
29175,MO,Randolph,,2021,4.2,9840,10273,433
29177,MO,Ray,,2007,5.3,10952,11565,613
29177,MO,Ray,,2008,6.4,10737,11472,735
29177,MO,Ray,,2009,9.8,10024,11112,1088
29177,MO,Ray,,2010,10.2,10347,11519,1172
29177,MO,Ray,,2011,9.4,10307,11382,1075
29177,MO,Ray,,2012,8.5,10286,11237,951
29177,MO,Ray,,2013,7.8,10234,11098,864
29177,MO,Ray,,2014,6.8,10335,11093,758
29177,MO,Ray,,2015,5.6,10478,11096,618
29177,MO,Ray,,2016,4.9,10588,11135,547
29177,MO,Ray,,2017,4.8,10553,11085,532
29177,MO,Ray,,2018,3.6,10501,10894,393
29177,MO,Ray,,2019,3.4,10582,10958,376
29177,MO,Ray,,2020,6.8,10026,10757,731
29177,MO,Ray,,2021,6.5,10272,10983,711
29179,MO,Reynolds,,2007,6.9,2474,2656,182
29179,MO,Reynolds,,2008,7.4,2520,2722,202
29179,MO,Reynolds,,2009,12.8,2464,2825,361
29179,MO,Reynolds,,2010,15,2016,2372,356
29179,MO,Reynolds,,2011,13.4,2000,2310,310
29179,MO,Reynolds,,2012,11.3,2001,2256,255
29179,MO,Reynolds,,2013,9.5,2276,2515,239
29179,MO,Reynolds,,2014,8.4,2458,2683,225
29179,MO,Reynolds,,2015,7.1,2505,2697,192
29179,MO,Reynolds,,2016,6.5,2507,2680,173
29179,MO,Reynolds,,2017,3.9,3005,3126,121
29179,MO,Reynolds,,2018,3.1,2935,3028,93
29179,MO,Reynolds,,2019,3.5,2902,3007,105
29179,MO,Reynolds,,2020,5.6,2759,2922,163
29179,MO,Reynolds,,2021,4.1,2815,2936,121
29181,MO,Ripley,,2007,6.6,6251,6696,445
29181,MO,Ripley,,2008,6.8,6348,6811,463
29181,MO,Ripley,,2009,9.2,6175,6798,623
29181,MO,Ripley,,2010,12.8,4683,5370,687
29181,MO,Ripley,,2011,12.2,4799,5467,668
29181,MO,Ripley,,2012,10.8,4889,5479,590
29181,MO,Ripley,,2013,9.3,5021,5538,517
29181,MO,Ripley,,2014,8.3,5091,5549,458
29181,MO,Ripley,,2015,8.1,4866,5295,429
29181,MO,Ripley,,2016,7,4954,5329,375
29181,MO,Ripley,,2017,5.5,4955,5244,289
29181,MO,Ripley,,2018,5.1,4826,5088,262
29181,MO,Ripley,,2019,5.2,4716,4977,261
29181,MO,Ripley,,2020,7.8,4617,5007,390
29181,MO,Ripley,,2021,5.5,4793,5072,279
29183,MO,St. Charles,,2007,4.1,186139,194048,7909
29183,MO,St. Charles,,2008,5.5,185519,196319,10800
29183,MO,St. Charles,,2009,8.3,180536,196874,16338
29183,MO,St. Charles,,2010,8.1,187742,204342,16600
29183,MO,St. Charles,,2011,7,190796,205217,14421
29183,MO,St. Charles,,2012,5.8,192394,204183,11789
29183,MO,St. Charles,,2013,5.4,195328,206401,11073
29183,MO,St. Charles,,2014,4.8,201163,211394,10231
29183,MO,St. Charles,,2015,3.9,207742,216222,8480
29183,MO,St. Charles,,2016,3.5,213165,220910,7745
29183,MO,St. Charles,,2017,2.8,215396,221708,6312
29183,MO,St. Charles,,2018,2.5,218501,224066,5565
29183,MO,St. Charles,,2019,2.4,223448,228903,5455
29183,MO,St. Charles,,2020,5.1,213631,225229,11598
29183,MO,St. Charles,,2021,3.5,219453,227337,7884
29185,MO,St. Clair,,2007,6.5,3979,4256,277
29185,MO,St. Clair,,2008,7.1,3997,4304,307
29185,MO,St. Clair,,2009,9.5,3857,4264,407
29185,MO,St. Clair,,2010,11.2,3659,4119,460
29185,MO,St. Clair,,2011,10.3,3593,4006,413
29185,MO,St. Clair,,2012,8.2,3574,3892,318
29185,MO,St. Clair,,2013,7.9,3600,3907,307
29185,MO,St. Clair,,2014,7.7,3668,3974,306
29185,MO,St. Clair,,2015,7.1,3675,3955,280
29185,MO,St. Clair,,2016,6.3,3667,3912,245
29185,MO,St. Clair,,2017,5.1,3681,3877,196
29185,MO,St. Clair,,2018,4.3,3622,3784,162
29185,MO,St. Clair,,2019,4.3,3563,3724,161
29185,MO,St. Clair,,2020,6.2,3541,3774,233
29185,MO,St. Clair,,2021,4.5,3673,3845,172
29186,MO,Ste. Genevieve,,2007,4.7,9544,10010,466
29186,MO,Ste. Genevieve,,2008,5.9,9595,10201,606
29186,MO,Ste. Genevieve,,2009,9.2,9217,10147,930
29186,MO,Ste. Genevieve,,2010,10.2,8407,9363,956
29186,MO,Ste. Genevieve,,2011,9.4,8398,9273,875
29186,MO,Ste. Genevieve,,2012,7.5,8297,8973,676
29186,MO,Ste. Genevieve,,2013,7.3,8340,8996,656
29186,MO,Ste. Genevieve,,2014,6.7,8443,9047,604
29186,MO,Ste. Genevieve,,2015,5.5,8517,9009,492
29186,MO,Ste. Genevieve,,2016,4.6,8563,8980,417
29186,MO,Ste. Genevieve,,2017,3.6,8760,9083,323
29186,MO,Ste. Genevieve,,2018,2.7,8932,9184,252
29186,MO,Ste. Genevieve,,2019,2.5,8909,9140,231
29186,MO,Ste. Genevieve,,2020,4.9,8738,9187,449
29186,MO,Ste. Genevieve,,2021,3.4,8916,9232,316
29187,MO,St. Francois,,2007,5.8,27848,29569,1721
29187,MO,St. Francois,,2008,7.1,28335,30512,2177
29187,MO,St. Francois,,2009,10.7,27334,30624,3290
29187,MO,St. Francois,,2010,12.1,23847,27142,3295
29187,MO,St. Francois,,2011,11,23740,26674,2934
29187,MO,St. Francois,,2012,9.2,23474,25844,2370
29187,MO,St. Francois,,2013,8.6,23957,26222,2265
29187,MO,St. Francois,,2014,7.7,24214,26224,2010
29187,MO,St. Francois,,2015,6.2,24624,26252,1628
29187,MO,St. Francois,,2016,5.5,24770,26210,1440
29187,MO,St. Francois,,2017,4.4,25545,26707,1162
29187,MO,St. Francois,,2018,3.6,25519,26471,952
29187,MO,St. Francois,,2019,3.5,25531,26456,925
29187,MO,St. Francois,,2020,7,24419,26249,1830
29187,MO,St. Francois,,2021,4.8,24772,26027,1255
29189,MO,St. Louis,,2007,4.9,503879,530105,26226
29189,MO,St. Louis,,2008,6.1,492727,524683,31956
29189,MO,St. Louis,,2009,8.7,471724,516937,45213
29189,MO,St. Louis,,2010,8.8,485674,532792,47118
29189,MO,St. Louis,,2011,8,489054,531565,42511
29189,MO,St. Louis,,2012,6.7,488787,523796,35009
29189,MO,St. Louis,,2013,6.3,489821,522762,32941
29189,MO,St. Louis,,2014,5.8,496520,527334,30814
29189,MO,St. Louis,,2015,4.7,505340,530371,25031
29189,MO,St. Louis,,2016,4.2,508770,531064,22294
29189,MO,St. Louis,,2017,3.4,506987,524894,17907
29189,MO,St. Louis,,2018,2.9,509836,525291,15455
29189,MO,St. Louis,,2019,2.9,516571,531873,15302
29189,MO,St. Louis,,2020,6.3,488660,521403,32743
29189,MO,St. Louis,,2021,4.5,502408,526087,23679
29195,MO,Saline,,2007,5,11198,11792,594
29195,MO,Saline,,2008,5.8,10943,11612,669
29195,MO,Saline,,2009,7.6,11007,11910,903
29195,MO,Saline,,2010,8.8,9969,10935,966
29195,MO,Saline,,2011,8.2,10163,11066,903
29195,MO,Saline,,2012,6.8,10206,10952,746
29195,MO,Saline,,2013,6,10389,11056,667
29195,MO,Saline,,2014,5.6,10571,11202,631
29195,MO,Saline,,2015,4.9,10445,10985,540
29195,MO,Saline,,2016,4.7,10227,10726,499
29195,MO,Saline,,2017,3.5,10289,10666,377
29195,MO,Saline,,2018,3,10384,10709,325
29195,MO,Saline,,2019,3,10278,10597,319
29195,MO,Saline,,2020,4.5,10082,10560,478
29195,MO,Saline,,2021,3.5,10119,10487,368
29197,MO,Schuyler,,2007,5.7,2057,2182,125
29197,MO,Schuyler,,2008,6.5,2049,2191,142
29197,MO,Schuyler,,2009,7.8,2011,2180,169
29197,MO,Schuyler,,2010,10.3,1751,1952,201
29197,MO,Schuyler,,2011,9.3,1722,1899,177
29197,MO,Schuyler,,2012,7.6,1736,1879,143
29197,MO,Schuyler,,2013,7.9,1747,1897,150
29197,MO,Schuyler,,2014,7.4,1743,1883,140
29197,MO,Schuyler,,2015,5.9,1784,1896,112
29197,MO,Schuyler,,2016,6.4,1783,1904,121
29197,MO,Schuyler,,2017,4.8,1861,1955,94
29197,MO,Schuyler,,2018,4,1927,2008,81
29197,MO,Schuyler,,2019,4.1,1876,1957,81
29197,MO,Schuyler,,2020,5.8,1788,1898,110
29197,MO,Schuyler,,2021,4.3,1765,1845,80
29199,MO,Scotland,,2007,4.7,2411,2531,120
29199,MO,Scotland,,2008,6.7,2411,2584,173
29199,MO,Scotland,,2009,7.7,2311,2505,194
29199,MO,Scotland,,2010,8,2112,2296,184
29199,MO,Scotland,,2011,6.7,2164,2320,156
29199,MO,Scotland,,2012,5.2,2208,2329,121
29199,MO,Scotland,,2013,5.4,2240,2368,128
29199,MO,Scotland,,2014,4.8,2269,2384,115
29199,MO,Scotland,,2015,4.6,2324,2437,113
29199,MO,Scotland,,2016,4.1,2351,2452,101
29199,MO,Scotland,,2017,3.1,2375,2451,76
29199,MO,Scotland,,2018,2.8,2321,2388,67
29199,MO,Scotland,,2019,2.9,2284,2352,68
29199,MO,Scotland,,2020,3.2,2299,2376,77
29199,MO,Scotland,,2021,2.6,2250,2311,61
29201,MO,Scott,,2007,5.8,18916,20087,1171
29201,MO,Scott,,2008,6.6,18768,20098,1330
29201,MO,Scott,,2009,8.6,18725,20497,1772
29201,MO,Scott,,2010,9.6,17101,18925,1824
29201,MO,Scott,,2011,9,17831,19587,1756
29201,MO,Scott,,2012,7.2,18301,19721,1420
29201,MO,Scott,,2013,7.2,18345,19767,1422
29201,MO,Scott,,2014,6.6,18492,19801,1309
29201,MO,Scott,,2015,5.3,18866,19930,1064
29201,MO,Scott,,2016,5.7,18810,19950,1140
29201,MO,Scott,,2017,4.4,19214,20104,890
29201,MO,Scott,,2018,3.4,19338,20012,674
29201,MO,Scott,,2019,3.3,19143,19805,662
29201,MO,Scott,,2020,5.3,18800,19849,1049
29201,MO,Scott,,2021,3.9,19410,20195,785
29203,MO,Shannon,,2007,6.8,3489,3745,256
29203,MO,Shannon,,2008,8,3473,3773,300
29203,MO,Shannon,,2009,11.9,3319,3766,447
29203,MO,Shannon,,2010,14.7,2752,3227,475
29203,MO,Shannon,,2011,13.4,2704,3122,418
29203,MO,Shannon,,2012,11.4,2700,3046,346
29203,MO,Shannon,,2013,9.6,3036,3359,323
29203,MO,Shannon,,2014,9.5,3093,3416,323
29203,MO,Shannon,,2015,8.3,3044,3320,276
29203,MO,Shannon,,2016,7.3,3079,3322,243
29203,MO,Shannon,,2017,6,3082,3279,197
29203,MO,Shannon,,2018,4.9,3074,3232,158
29203,MO,Shannon,,2019,5.2,3055,3223,168
29203,MO,Shannon,,2020,7.2,3103,3344,241
29203,MO,Shannon,,2021,5.6,3177,3366,189
29205,MO,Shelby,,2007,5,3179,3346,167
29205,MO,Shelby,,2008,5.4,3183,3363,180
29205,MO,Shelby,,2009,8.6,3030,3315,285
29205,MO,Shelby,,2010,8.6,2952,3228,276
29205,MO,Shelby,,2011,7.3,2955,3188,233
29205,MO,Shelby,,2012,6.2,2910,3103,193
29205,MO,Shelby,,2013,5.6,2881,3053,172
29205,MO,Shelby,,2014,6,2863,3047,184
29205,MO,Shelby,,2015,4.8,2911,3058,147
29205,MO,Shelby,,2016,4.2,2940,3069,129
29205,MO,Shelby,,2017,3.4,2987,3092,105
29205,MO,Shelby,,2018,3,2926,3017,91
29205,MO,Shelby,,2019,2.8,2939,3023,84
29205,MO,Shelby,,2020,4.4,2895,3029,134
29205,MO,Shelby,,2021,3.3,2886,2985,99
29207,MO,Stoddard,,2007,6.4,14640,15639,999
29207,MO,Stoddard,,2008,7.6,14410,15596,1186
29207,MO,Stoddard,,2009,9.3,13825,15243,1418
29207,MO,Stoddard,,2010,10.3,12144,13546,1402
29207,MO,Stoddard,,2011,10.2,12244,13639,1395
29207,MO,Stoddard,,2012,9,12203,13403,1200
29207,MO,Stoddard,,2013,8.9,12015,13192,1177
29207,MO,Stoddard,,2014,7.8,12078,13105,1027
29207,MO,Stoddard,,2015,6.7,12270,13158,888
29207,MO,Stoddard,,2016,6.4,12436,13286,850
29207,MO,Stoddard,,2017,5,12557,13221,664
29207,MO,Stoddard,,2018,4.4,12493,13062,569
29207,MO,Stoddard,,2019,4.4,12415,12993,578
29207,MO,Stoddard,,2020,5.8,12417,13185,768
29207,MO,Stoddard,,2021,4.5,12730,13325,595
29209,MO,Stone,,2007,6.4,15435,16493,1058
29209,MO,Stone,,2008,7.9,15418,16738,1320
29209,MO,Stone,,2009,11.8,14230,16127,1897
29209,MO,Stone,,2010,13.7,12448,14428,1980
29209,MO,Stone,,2011,12.8,12318,14125,1807
29209,MO,Stone,,2012,11.5,12052,13618,1566
29209,MO,Stone,,2013,10.6,12125,13563,1438
29209,MO,Stone,,2014,9.7,11981,13266,1285
29209,MO,Stone,,2015,8,12228,13296,1068
29209,MO,Stone,,2016,7,12478,13417,939
29209,MO,Stone,,2017,5.5,13055,13816,761
29209,MO,Stone,,2018,4.6,13067,13699,632
29209,MO,Stone,,2019,4.7,13165,13813,648
29209,MO,Stone,,2020,9.5,11898,13148,1250
29209,MO,Stone,,2021,6.6,12719,13611,892
29211,MO,Sullivan,,2007,6.1,3116,3320,204
29211,MO,Sullivan,,2008,5.8,3347,3553,206
29211,MO,Sullivan,,2009,6.6,3402,3642,240
29211,MO,Sullivan,,2010,8.8,2669,2925,256
29211,MO,Sullivan,,2011,8.5,2583,2823,240
29211,MO,Sullivan,,2012,7.1,2566,2761,195
29211,MO,Sullivan,,2013,6.5,2530,2707,177
29211,MO,Sullivan,,2014,6.6,2550,2731,181
29211,MO,Sullivan,,2015,6.1,2595,2763,168
29211,MO,Sullivan,,2016,5.7,2609,2768,159
29211,MO,Sullivan,,2017,4,2641,2752,111
29211,MO,Sullivan,,2018,3.1,2706,2793,87
29211,MO,Sullivan,,2019,3.3,2565,2653,88
29211,MO,Sullivan,,2020,4.3,2634,2752,118
29211,MO,Sullivan,,2021,4.9,2521,2650,129
29213,MO,Taney,,2007,6.8,25710,27579,1869
29213,MO,Taney,,2008,7.8,26413,28646,2233
29213,MO,Taney,,2009,11.7,24998,28314,3316
29213,MO,Taney,,2010,13.8,22368,25956,3588
29213,MO,Taney,,2011,13.4,22549,26039,3490
29213,MO,Taney,,2012,11.6,22392,25341,2949
29213,MO,Taney,,2013,10.7,23004,25773,2769
29213,MO,Taney,,2014,9.8,23134,25643,2509
29213,MO,Taney,,2015,8.2,23886,26022,2136
29213,MO,Taney,,2016,7.4,24362,26311,1949
29213,MO,Taney,,2017,6,25309,26929,1620
29213,MO,Taney,,2018,5.1,25512,26890,1378
29213,MO,Taney,,2019,4.9,25588,26902,1314
29213,MO,Taney,,2020,12.6,22689,25960,3271
29213,MO,Taney,,2021,7.5,24306,26276,1970
29215,MO,Texas,,2007,5.7,10469,11098,629
29215,MO,Texas,,2008,7,10525,11318,793
29215,MO,Texas,,2009,9,10200,11205,1005
29215,MO,Texas,,2010,10.9,8727,9798,1071
29215,MO,Texas,,2011,9.9,8758,9723,965
29215,MO,Texas,,2012,8.4,8776,9586,810
29215,MO,Texas,,2013,8.3,8879,9680,801
29215,MO,Texas,,2014,7.9,8656,9403,747
29215,MO,Texas,,2015,6.8,8718,9352,634
29215,MO,Texas,,2016,6.3,8731,9314,583
29215,MO,Texas,,2017,4.9,8902,9363,461
29215,MO,Texas,,2018,4,8652,9012,360
29215,MO,Texas,,2019,4.2,8504,8881,377
29215,MO,Texas,,2020,5.7,8425,8938,513
29215,MO,Texas,,2021,4.6,8590,9000,410
29217,MO,Vernon,,2007,4.9,9659,10154,495
29217,MO,Vernon,,2008,5.7,9547,10120,573
29217,MO,Vernon,,2009,7.6,8682,9398,716
29217,MO,Vernon,,2010,8.2,8750,9532,782
29217,MO,Vernon,,2011,7.4,8844,9548,704
29217,MO,Vernon,,2012,6,8974,9551,577
29217,MO,Vernon,,2013,6,9168,9750,582
29217,MO,Vernon,,2014,5.7,9245,9799,554
29217,MO,Vernon,,2015,5.2,9255,9761,506
29217,MO,Vernon,,2016,4.8,9133,9598,465
29217,MO,Vernon,,2017,3.8,9278,9643,365
29217,MO,Vernon,,2018,3.1,9255,9551,296
29217,MO,Vernon,,2019,3.3,9085,9398,313
29217,MO,Vernon,,2020,4.4,8980,9390,410
29217,MO,Vernon,,2021,3.4,9101,9422,321
29219,MO,Warren,,2007,5.4,15399,16276,877
29219,MO,Warren,,2008,7.5,15478,16742,1264
29219,MO,Warren,,2009,11,14938,16793,1855
29219,MO,Warren,,2010,10.9,15311,17179,1868
29219,MO,Warren,,2011,9.2,15456,17031,1575
29219,MO,Warren,,2012,7.7,15532,16831,1299
29219,MO,Warren,,2013,6.9,15656,16817,1161
29219,MO,Warren,,2014,6.2,15997,17052,1055
29219,MO,Warren,,2015,4.9,16398,17238,840
29219,MO,Warren,,2016,4.2,16750,17480,730
29219,MO,Warren,,2017,3.2,17002,17561,559
29219,MO,Warren,,2018,2.8,17248,17736,488
29219,MO,Warren,,2019,2.7,17958,18459,501
29219,MO,Warren,,2020,5.6,17492,18539,1047
29219,MO,Warren,,2021,4.1,17946,18722,776
29221,MO,Washington,,2007,8.2,9252,10083,831
29221,MO,Washington,,2008,10.3,9164,10219,1055
29221,MO,Washington,,2009,13.9,8717,10122,1405
29221,MO,Washington,,2010,14.2,8756,10208,1452
29221,MO,Washington,,2011,12.4,8842,10098,1256
29221,MO,Washington,,2012,10.9,8841,9924,1083
29221,MO,Washington,,2013,9.8,9420,10445,1025
29221,MO,Washington,,2014,8.6,9534,10430,896
29221,MO,Washington,,2015,6.8,9747,10463,716
29221,MO,Washington,,2016,6.3,9677,10331,654
29221,MO,Washington,,2017,5.4,9743,10296,553
29221,MO,Washington,,2018,4.4,9744,10189,445
29221,MO,Washington,,2019,4.2,9737,10169,432
29221,MO,Washington,,2020,7.1,9359,10077,718
29221,MO,Washington,,2021,5.1,9578,10094,516
29223,MO,Wayne,,2007,6.9,5339,5735,396
29223,MO,Wayne,,2008,6.8,5515,5918,403
29223,MO,Wayne,,2009,8.8,5523,6059,536
29223,MO,Wayne,,2010,10.7,4948,5541,593
29223,MO,Wayne,,2011,10.3,4909,5475,566
29223,MO,Wayne,,2012,9.3,4803,5296,493
29223,MO,Wayne,,2013,8.3,5155,5624,469
29223,MO,Wayne,,2014,7.5,5213,5635,422
29223,MO,Wayne,,2015,6,5344,5685,341
29223,MO,Wayne,,2016,5.3,5351,5653,302
29223,MO,Wayne,,2017,5,5255,5534,279
29223,MO,Wayne,,2018,4.7,5076,5328,252
29223,MO,Wayne,,2019,4.6,4983,5222,239
29223,MO,Wayne,,2020,6.1,4711,5017,306
29223,MO,Wayne,,2021,5,4595,4838,243
29225,MO,Webster,,2007,4.8,16347,17167,820
29225,MO,Webster,,2008,5.7,16006,16979,973
29225,MO,Webster,,2009,9.4,15275,16864,1589
29225,MO,Webster,,2010,10.5,14608,16314,1706
29225,MO,Webster,,2011,9.1,14638,16104,1466
29225,MO,Webster,,2012,7.3,14674,15836,1162
29225,MO,Webster,,2013,6.8,14784,15866,1082
29225,MO,Webster,,2014,6.1,15257,16243,986
29225,MO,Webster,,2015,5.2,15694,16553,859
29225,MO,Webster,,2016,4.9,16054,16883,829
29225,MO,Webster,,2017,3.9,16163,16812,649
29225,MO,Webster,,2018,3.1,16430,16948,518
29225,MO,Webster,,2019,3.4,16734,17319,585
29225,MO,Webster,,2020,5.3,16286,17198,912
29225,MO,Webster,,2021,3.4,16811,17409,598
29227,MO,Worth,,2007,4.6,1102,1155,53
29227,MO,Worth,,2008,5.5,1095,1159,64
29227,MO,Worth,,2009,7.4,1068,1153,85
29227,MO,Worth,,2010,6.8,1160,1244,84
29227,MO,Worth,,2011,5.8,1162,1234,72
29227,MO,Worth,,2012,4.3,1183,1236,53
29227,MO,Worth,,2013,4.1,1260,1314,54
29227,MO,Worth,,2014,4,1237,1289,52
29227,MO,Worth,,2015,3.3,1170,1210,40
29227,MO,Worth,,2016,3,1174,1210,36
29227,MO,Worth,,2017,2.5,1160,1190,30
29227,MO,Worth,,2018,2.8,1157,1190,33
29227,MO,Worth,,2019,2.6,1124,1154,30
29227,MO,Worth,,2020,4.1,1122,1170,48
29227,MO,Worth,,2021,2.5,1151,1181,30
29229,MO,Wright,,2007,6,7663,8149,486
29229,MO,Wright,,2008,7.3,7705,8310,605
29229,MO,Wright,,2009,9.9,7458,8278,820
29229,MO,Wright,,2010,11.8,6683,7580,897
29229,MO,Wright,,2011,10,6813,7573,760
29229,MO,Wright,,2012,8.7,6885,7540,655
29229,MO,Wright,,2013,8.5,6936,7579,643
29229,MO,Wright,,2014,7.3,7058,7615,557
29229,MO,Wright,,2015,6.4,7114,7599,485
29229,MO,Wright,,2016,5.9,7146,7595,449
29229,MO,Wright,,2017,4.9,7234,7608,374
29229,MO,Wright,,2018,4.1,7107,7411,304
29229,MO,Wright,,2019,5,7024,7392,368
29229,MO,Wright,,2020,6.9,6866,7374,508
29229,MO,Wright,,2021,4,7290,7596,306
29510,MO,St. Louis,,2007,7.1,147597,158814,11217
29510,MO,St. Louis,,2008,7.9,146296,158816,12520
29510,MO,St. Louis,,2009,11.4,140858,158964,18106
29510,MO,St. Louis,,2010,11.4,145451,164163,18712
29510,MO,St. Louis,,2011,10.5,146378,163556,17178
29510,MO,St. Louis,,2012,8.8,146076,160128,14052
29510,MO,St. Louis,,2013,8.4,145939,159342,13403
29510,MO,St. Louis,,2014,7.6,147413,159559,12146
29510,MO,St. Louis,,2015,6.2,148980,158810,9830
29510,MO,St. Louis,,2016,5.4,148669,157198,8529
29510,MO,St. Louis,,2017,4.4,147124,153929,6805
29510,MO,St. Louis,,2018,3.8,145145,150874,5729
29510,MO,St. Louis,,2019,3.7,146380,151947,5567
29510,MO,St. Louis,,2020,8.6,137094,150074,12980
29510,MO,St. Louis,,2021,6.4,140948,150531,9583
30000,MT,Montana,,2007,3.4,488129,505095,16966
30000,MT,Montana,,2008,4.7,488259,512278,24019
30000,MT,Montana,,2009,7.1,466778,502593,35815
30000,MT,Montana,,2010,7.2,464808,500895,36087
30000,MT,Montana,,2011,6.6,467786,501065,33279
30000,MT,Montana,,2012,5.8,477056,506441,29385
30000,MT,Montana,,2013,5.4,483798,511199,27401
30000,MT,Montana,,2014,4.7,488738,512613,23875
30000,MT,Montana,,2015,4.3,495725,517901,22176
30000,MT,Montana,,2016,4.3,499266,521736,22470
30000,MT,Montana,,2017,4.1,506871,528441,21570
30000,MT,Montana,,2018,3.7,513858,533821,19963
30000,MT,Montana,,2019,3.6,522898,542279,19381
30000,MT,Montana,,2020,5.8,511616,542917,31301
30000,MT,Montana,,2021,3.4,531202,549743,18541
30001,MT,Beaverhead,,2007,2.6,4932,5065,133
30001,MT,Beaverhead,,2008,3.8,4968,5163,195
30001,MT,Beaverhead,,2009,5.2,4904,5173,269
30001,MT,Beaverhead,,2010,5.8,4721,5014,293
30001,MT,Beaverhead,,2011,5.8,4646,4933,287
30001,MT,Beaverhead,,2012,5.2,4651,4908,257
30001,MT,Beaverhead,,2013,4.7,4619,4845,226
30001,MT,Beaverhead,,2014,3.7,4689,4869,180
30001,MT,Beaverhead,,2015,3.5,4806,4982,176
30001,MT,Beaverhead,,2016,3.4,4894,5068,174
30001,MT,Beaverhead,,2017,3.2,4919,5079,160
30001,MT,Beaverhead,,2018,3.1,4921,5080,159
30001,MT,Beaverhead,,2019,3,5025,5180,155
30001,MT,Beaverhead,,2020,3.9,4888,5088,200
30001,MT,Beaverhead,,2021,2.8,4999,5141,142
30003,MT,Big Horn,,2007,6.3,4778,5099,321
30003,MT,Big Horn,,2008,7.7,4827,5227,400
30003,MT,Big Horn,,2009,9.9,4728,5246,518
30003,MT,Big Horn,,2010,10.8,4928,5525,597
30003,MT,Big Horn,,2011,11.5,4976,5624,648
30003,MT,Big Horn,,2012,11.7,4871,5518,647
30003,MT,Big Horn,,2013,13.9,4908,5700,792
30003,MT,Big Horn,,2014,10,5036,5593,557
30003,MT,Big Horn,,2015,6.8,5175,5555,380
30003,MT,Big Horn,,2016,7.5,5123,5539,416
30003,MT,Big Horn,,2017,13.6,4811,5566,755
30003,MT,Big Horn,,2018,9.6,4649,5145,496
30003,MT,Big Horn,,2019,7.5,4578,4950,372
30003,MT,Big Horn,,2020,7.2,4519,4868,349
30003,MT,Big Horn,,2021,7.8,4306,4669,363
30005,MT,Blaine,,2007,3.6,2771,2874,103
30005,MT,Blaine,,2008,4.2,2887,3014,127
30005,MT,Blaine,,2009,5.4,2733,2888,155
30005,MT,Blaine,,2010,6.5,2358,2523,165
30005,MT,Blaine,,2011,6.7,2316,2483,167
30005,MT,Blaine,,2012,6.2,2331,2484,153
30005,MT,Blaine,,2013,6.1,2323,2473,150
30005,MT,Blaine,,2014,5.8,2293,2434,141
30005,MT,Blaine,,2015,5.1,2275,2398,123
30005,MT,Blaine,,2016,4.7,2257,2369,112
30005,MT,Blaine,,2017,4.2,2269,2368,99
30005,MT,Blaine,,2018,4.4,2216,2317,101
30005,MT,Blaine,,2019,4,2223,2315,92
30005,MT,Blaine,,2020,4.7,2164,2271,107
30005,MT,Blaine,,2021,3.8,2151,2237,86
30007,MT,Broadwater,,2007,3.1,2313,2386,73
30007,MT,Broadwater,,2008,5.2,2347,2475,128
30007,MT,Broadwater,,2009,8,2223,2417,194
30007,MT,Broadwater,,2010,7.3,2325,2508,183
30007,MT,Broadwater,,2011,7,2316,2491,175
30007,MT,Broadwater,,2012,7.3,2299,2479,180
30007,MT,Broadwater,,2013,6.3,2351,2509,158
30007,MT,Broadwater,,2014,5.4,2368,2502,134
30007,MT,Broadwater,,2015,5.2,2357,2487,130
30007,MT,Broadwater,,2016,5.1,2421,2551,130
30007,MT,Broadwater,,2017,4.8,2477,2602,125
30007,MT,Broadwater,,2018,4,2541,2647,106
30007,MT,Broadwater,,2019,4.1,2534,2642,108
30007,MT,Broadwater,,2020,6.2,2486,2650,164
30007,MT,Broadwater,,2021,4,2560,2667,107
30009,MT,Carbon,,2007,2.7,5239,5384,145
30009,MT,Carbon,,2008,4,5136,5349,213
30009,MT,Carbon,,2009,5.9,4950,5263,313
30009,MT,Carbon,,2010,6.3,4997,5333,336
30009,MT,Carbon,,2011,5.5,5003,5293,290
30009,MT,Carbon,,2012,4.5,5090,5332,242
30009,MT,Carbon,,2013,4.4,5162,5401,239
30009,MT,Carbon,,2014,3.9,5181,5391,210
30009,MT,Carbon,,2015,3.8,5222,5427,205
30009,MT,Carbon,,2016,4.1,5196,5418,222
30009,MT,Carbon,,2017,3.7,5331,5535,204
30009,MT,Carbon,,2018,3.5,5326,5522,196
30009,MT,Carbon,,2019,3.6,5342,5539,197
30009,MT,Carbon,,2020,5.8,5310,5638,328
30009,MT,Carbon,,2021,3.4,5468,5662,194
30011,MT,Carter,,2007,2.9,669,689,20
30011,MT,Carter,,2008,3,736,759,23
30011,MT,Carter,,2009,3.9,690,718,28
30011,MT,Carter,,2010,3.7,698,725,27
30011,MT,Carter,,2011,3.8,659,685,26
30011,MT,Carter,,2012,3.2,665,687,22
30011,MT,Carter,,2013,3.1,652,673,21
30011,MT,Carter,,2014,3.2,665,687,22
30011,MT,Carter,,2015,3.4,663,686,23
30011,MT,Carter,,2016,2.9,676,696,20
30011,MT,Carter,,2017,2.6,682,700,18
30011,MT,Carter,,2018,2.5,655,672,17
30011,MT,Carter,,2019,2.9,644,663,19
30011,MT,Carter,,2020,2.8,629,647,18
30011,MT,Carter,,2021,2.6,633,650,17
30013,MT,Cascade,,2007,3.3,38511,39817,1306
30013,MT,Cascade,,2008,4.3,38911,40661,1750
30013,MT,Cascade,,2009,5.6,38415,40713,2298
30013,MT,Cascade,,2010,6.3,36059,38471,2412
30013,MT,Cascade,,2011,6.1,35990,38329,2339
30013,MT,Cascade,,2012,5.4,36314,38380,2066
30013,MT,Cascade,,2013,5.1,36478,38421,1943
30013,MT,Cascade,,2014,4.3,36654,38301,1647
30013,MT,Cascade,,2015,4.1,36730,38320,1590
30013,MT,Cascade,,2016,4.1,36224,37781,1557
30013,MT,Cascade,,2017,3.8,36554,38001,1447
30013,MT,Cascade,,2018,3.6,36761,38144,1383
30013,MT,Cascade,,2019,3.5,37120,38455,1335
30013,MT,Cascade,,2020,5.8,35719,37907,2188
30013,MT,Cascade,,2021,3.3,36561,37812,1251
30015,MT,Chouteau,,2007,3,2458,2533,75
30015,MT,Chouteau,,2008,3.3,2586,2675,89
30015,MT,Chouteau,,2009,4.2,2487,2596,109
30015,MT,Chouteau,,2010,4.3,2622,2740,118
30015,MT,Chouteau,,2011,4.3,2539,2654,115
30015,MT,Chouteau,,2012,3.8,2568,2669,101
30015,MT,Chouteau,,2013,3.6,2494,2588,94
30015,MT,Chouteau,,2014,3.2,2508,2592,84
30015,MT,Chouteau,,2015,3.4,2440,2525,85
30015,MT,Chouteau,,2016,3.9,2415,2513,98
30015,MT,Chouteau,,2017,3.4,2423,2507,84
30015,MT,Chouteau,,2018,3,2419,2494,75
30015,MT,Chouteau,,2019,2.8,2415,2484,69
30015,MT,Chouteau,,2020,3.8,2379,2473,94
30015,MT,Chouteau,,2021,2.7,2392,2459,67
30017,MT,Custer,,2007,3.2,5612,5795,183
30017,MT,Custer,,2008,3.9,5701,5933,232
30017,MT,Custer,,2009,5.1,5560,5859,299
30017,MT,Custer,,2010,4.5,6121,6407,286
30017,MT,Custer,,2011,3.9,6126,6374,248
30017,MT,Custer,,2012,3.5,6316,6543,227
30017,MT,Custer,,2013,3.3,6419,6639,220
30017,MT,Custer,,2014,3.2,6381,6593,212
30017,MT,Custer,,2015,3.4,6174,6390,216
30017,MT,Custer,,2016,3.7,6007,6235,228
30017,MT,Custer,,2017,3.2,6000,6198,198
30017,MT,Custer,,2018,3.1,5934,6123,189
30017,MT,Custer,,2019,2.9,5953,6132,179
30017,MT,Custer,,2020,4.7,5931,6225,294
30017,MT,Custer,,2021,3.1,6025,6217,192
30019,MT,Daniels,,2007,2.6,753,773,20
30019,MT,Daniels,,2008,3.5,780,808,28
30019,MT,Daniels,,2009,4.3,748,782,34
30019,MT,Daniels,,2010,3.5,915,948,33
30019,MT,Daniels,,2011,3.4,913,945,32
30019,MT,Daniels,,2012,3.1,912,941,29
30019,MT,Daniels,,2013,3.2,904,934,30
30019,MT,Daniels,,2014,3,923,952,29
30019,MT,Daniels,,2015,2.6,919,944,25
30019,MT,Daniels,,2016,2.7,909,934,25
30019,MT,Daniels,,2017,2.3,891,912,21
30019,MT,Daniels,,2018,2.1,872,891,19
30019,MT,Daniels,,2019,2,876,894,18
30019,MT,Daniels,,2020,2.8,866,891,25
30019,MT,Daniels,,2021,1.9,858,875,17
30021,MT,Dawson,,2007,2.6,4169,4282,113
30021,MT,Dawson,,2008,3.4,4276,4427,151
30021,MT,Dawson,,2009,4.9,4160,4376,216
30021,MT,Dawson,,2010,4.1,4331,4518,187
30021,MT,Dawson,,2011,3.5,4394,4552,158
30021,MT,Dawson,,2012,3.2,4503,4652,149
30021,MT,Dawson,,2013,3.1,4662,4812,150
30021,MT,Dawson,,2014,2.6,4738,4866,128
30021,MT,Dawson,,2015,3.2,4666,4822,156
30021,MT,Dawson,,2016,4,4418,4601,183
30021,MT,Dawson,,2017,3.1,4560,4707,147
30021,MT,Dawson,,2018,2.7,4543,4668,125
30021,MT,Dawson,,2019,2.5,4544,4659,115
30021,MT,Dawson,,2020,5.4,4418,4670,252
30021,MT,Dawson,,2021,3.1,4371,4511,140
30023,MT,Deer Lodge,,2007,4.5,3745,3922,177
30023,MT,Deer Lodge,,2008,6.2,3628,3867,239
30023,MT,Deer Lodge,,2009,7.9,3638,3950,312
30023,MT,Deer Lodge,,2010,6,4873,5185,312
30023,MT,Deer Lodge,,2011,5.9,4851,5155,304
30023,MT,Deer Lodge,,2012,5.4,4910,5189,279
30023,MT,Deer Lodge,,2013,4.9,4959,5213,254
30023,MT,Deer Lodge,,2014,4.4,5012,5240,228
30023,MT,Deer Lodge,,2015,4.1,5024,5238,214
30023,MT,Deer Lodge,,2016,3.9,5087,5296,209
30023,MT,Deer Lodge,,2017,3.6,4981,5168,187
30023,MT,Deer Lodge,,2018,3.6,4987,5172,185
30023,MT,Deer Lodge,,2019,3.3,4964,5132,168
30023,MT,Deer Lodge,,2020,5,4820,5073,253
30023,MT,Deer Lodge,,2021,3.3,4928,5094,166
30025,MT,Fallon,,2007,1.9,1720,1753,33
30025,MT,Fallon,,2008,2.4,1792,1837,45
30025,MT,Fallon,,2009,3.3,1834,1897,63
30025,MT,Fallon,,2010,3,1843,1900,57
30025,MT,Fallon,,2011,2.5,1907,1956,49
30025,MT,Fallon,,2012,2,1995,2035,40
30025,MT,Fallon,,2013,2,2001,2041,40
30025,MT,Fallon,,2014,1.9,2034,2074,40
30025,MT,Fallon,,2015,2.4,1923,1970,47
30025,MT,Fallon,,2016,3.8,1742,1810,68
30025,MT,Fallon,,2017,2.7,1700,1747,47
30025,MT,Fallon,,2018,1.8,1678,1709,31
30025,MT,Fallon,,2019,1.8,1689,1720,31
30025,MT,Fallon,,2020,3.9,1587,1651,64
30025,MT,Fallon,,2021,2.6,1578,1620,42
30027,MT,Fergus,,2007,3.7,5676,5897,221
30027,MT,Fergus,,2008,4.4,5724,5988,264
30027,MT,Fergus,,2009,5.7,5714,6059,345
30027,MT,Fergus,,2010,6.3,5640,6020,380
30027,MT,Fergus,,2011,5.8,5563,5907,344
30027,MT,Fergus,,2012,5.2,5552,5856,304
30027,MT,Fergus,,2013,4.9,5591,5876,285
30027,MT,Fergus,,2014,4.3,5499,5746,247
30027,MT,Fergus,,2015,4.2,5462,5704,242
30027,MT,Fergus,,2016,4.1,5528,5763,235
30027,MT,Fergus,,2017,4.1,5562,5799,237
30027,MT,Fergus,,2018,3.7,5643,5859,216
30027,MT,Fergus,,2019,3.2,5902,6098,196
30027,MT,Fergus,,2020,4.5,5586,5849,263
30027,MT,Fergus,,2021,3.3,5631,5822,191
30029,MT,Flathead,,2007,3.7,44283,46000,1717
30029,MT,Flathead,,2008,6.2,43652,46559,2907
30029,MT,Flathead,,2009,12.3,39371,44878,5507
30029,MT,Flathead,,2010,12,38579,43844,5265
30029,MT,Flathead,,2011,10.5,38933,43506,4573
30029,MT,Flathead,,2012,8.8,39490,43283,3793
30029,MT,Flathead,,2013,7.6,40529,43860,3331
30029,MT,Flathead,,2014,6.4,40954,43773,2819
30029,MT,Flathead,,2015,5.9,42228,44861,2633
30029,MT,Flathead,,2016,5.8,43298,45960,2662
30029,MT,Flathead,,2017,5.3,44581,47092,2511
30029,MT,Flathead,,2018,4.8,45895,48229,2334
30029,MT,Flathead,,2019,4.8,46513,48862,2349
30029,MT,Flathead,,2020,7.7,45934,49750,3816
30029,MT,Flathead,,2021,4,49112,51167,2055
30031,MT,Gallatin,,2007,2.5,49480,50734,1254
30031,MT,Gallatin,,2008,3.9,49227,51233,2006
30031,MT,Gallatin,,2009,7.2,45447,48991,3544
30031,MT,Gallatin,,2010,6.7,47397,50799,3402
30031,MT,Gallatin,,2011,5.7,48602,51555,2953
30031,MT,Gallatin,,2012,5,49895,52494,2599
30031,MT,Gallatin,,2013,4.1,52604,54837,2233
30031,MT,Gallatin,,2014,3.5,54904,56887,1983
30031,MT,Gallatin,,2015,3.1,57622,59459,1837
30031,MT,Gallatin,,2016,2.9,60245,62060,1815
30031,MT,Gallatin,,2017,2.8,63106,64922,1816
30031,MT,Gallatin,,2018,2.5,65697,67412,1715
30031,MT,Gallatin,,2019,2.3,68422,70059,1637
30031,MT,Gallatin,,2020,4.9,67418,70900,3482
30031,MT,Gallatin,,2021,2.4,72116,73887,1771
30033,MT,Garfield,,2007,2.8,629,647,18
30033,MT,Garfield,,2008,3.3,640,662,22
30033,MT,Garfield,,2009,3.8,628,653,25
30033,MT,Garfield,,2010,3.5,738,765,27
30033,MT,Garfield,,2011,3.7,749,778,29
30033,MT,Garfield,,2012,3,746,769,23
30033,MT,Garfield,,2013,3.1,738,762,24
30033,MT,Garfield,,2014,2.7,728,748,20
30033,MT,Garfield,,2015,2.9,740,762,22
30033,MT,Garfield,,2016,3,740,763,23
30033,MT,Garfield,,2017,2.9,743,765,22
30033,MT,Garfield,,2018,2.7,722,742,20
30033,MT,Garfield,,2019,2.4,731,749,18
30033,MT,Garfield,,2020,2.7,726,746,20
30033,MT,Garfield,,2021,2.6,723,742,19
30035,MT,Glacier,,2007,7.6,5388,5831,443
30035,MT,Glacier,,2008,8.5,5371,5868,497
30035,MT,Glacier,,2009,9.7,5231,5791,560
30035,MT,Glacier,,2010,9.7,5658,6264,606
30035,MT,Glacier,,2011,10.9,5388,6050,662
30035,MT,Glacier,,2012,9.6,5730,6340,610
30035,MT,Glacier,,2013,10,5709,6342,633
30035,MT,Glacier,,2014,10.5,5329,5957,628
30035,MT,Glacier,,2015,9.2,5323,5863,540
30035,MT,Glacier,,2016,8.9,5310,5826,516
30035,MT,Glacier,,2017,8,5301,5765,464
30035,MT,Glacier,,2018,7.8,5308,5759,451
30035,MT,Glacier,,2019,7.7,5352,5796,444
30035,MT,Glacier,,2020,9.5,4983,5508,525
30035,MT,Glacier,,2021,7,5139,5528,389
30037,MT,Golden Valley,,2007,3.7,544,565,21
30037,MT,Golden Valley,,2008,4.6,556,583,27
30037,MT,Golden Valley,,2009,5.4,525,555,30
30037,MT,Golden Valley,,2010,6.7,391,419,28
30037,MT,Golden Valley,,2011,4.9,372,391,19
30037,MT,Golden Valley,,2012,4.6,373,391,18
30037,MT,Golden Valley,,2013,5,377,397,20
30037,MT,Golden Valley,,2014,4.6,374,392,18
30037,MT,Golden Valley,,2015,4.2,364,380,16
30037,MT,Golden Valley,,2016,4.5,361,378,17
30037,MT,Golden Valley,,2017,5.1,357,376,19
30037,MT,Golden Valley,,2018,4.6,355,372,17
30037,MT,Golden Valley,,2019,4.1,353,368,15
30037,MT,Golden Valley,,2020,4.7,348,365,17
30037,MT,Golden Valley,,2021,3.5,356,369,13
30039,MT,Granite,,2007,4.5,1231,1289,58
30039,MT,Granite,,2008,6.2,1217,1298,81
30039,MT,Granite,,2009,10.8,1122,1258,136
30039,MT,Granite,,2010,9.1,1326,1459,133
30039,MT,Granite,,2011,8.7,1329,1456,127
30039,MT,Granite,,2012,7.9,1356,1473,117
30039,MT,Granite,,2013,7.5,1389,1502,113
30039,MT,Granite,,2014,6.8,1423,1527,104
30039,MT,Granite,,2015,6.4,1462,1562,100
30039,MT,Granite,,2016,6.1,1532,1632,100
30039,MT,Granite,,2017,6,1532,1629,97
30039,MT,Granite,,2018,5.3,1617,1708,91
30039,MT,Granite,,2019,5.7,1626,1724,98
30039,MT,Granite,,2020,8,1473,1601,128
30039,MT,Granite,,2021,4.4,1548,1620,72
30041,MT,Hill,,2007,3.9,7808,8124,316
30041,MT,Hill,,2008,4.7,7896,8283,387
30041,MT,Hill,,2009,5.7,7760,8229,469
30041,MT,Hill,,2010,5.7,7531,7987,456
30041,MT,Hill,,2011,6,7509,7986,477
30041,MT,Hill,,2012,5.6,7581,8034,453
30041,MT,Hill,,2013,6.5,7427,7944,517
30041,MT,Hill,,2014,5.8,7381,7833,452
30041,MT,Hill,,2015,4.3,7464,7799,335
30041,MT,Hill,,2016,4.5,7448,7797,349
30041,MT,Hill,,2017,3.9,7541,7843,302
30041,MT,Hill,,2018,3.6,7466,7742,276
30041,MT,Hill,,2019,3.8,7483,7775,292
30041,MT,Hill,,2020,4.9,7241,7611,370
30041,MT,Hill,,2021,3.1,7308,7543,235
30043,MT,Jefferson,,2007,3,5714,5888,174
30043,MT,Jefferson,,2008,4.3,5777,6035,258
30043,MT,Jefferson,,2009,6.6,5653,6054,401
30043,MT,Jefferson,,2010,6.2,5283,5631,348
30043,MT,Jefferson,,2011,6,5283,5619,336
30043,MT,Jefferson,,2012,5.4,5301,5601,300
30043,MT,Jefferson,,2013,4.8,5341,5613,272
30043,MT,Jefferson,,2014,4.6,5373,5632,259
30043,MT,Jefferson,,2015,4.2,5351,5585,234
30043,MT,Jefferson,,2016,4.8,5399,5669,270
30043,MT,Jefferson,,2017,4.4,5416,5664,248
30043,MT,Jefferson,,2018,3.8,5472,5691,219
30043,MT,Jefferson,,2019,3.4,5606,5804,198
30043,MT,Jefferson,,2020,5,5538,5830,292
30043,MT,Jefferson,,2021,3.2,5715,5906,191
30045,MT,Judith Basin,,2007,3.5,1015,1052,37
30045,MT,Judith Basin,,2008,4,1070,1115,45
30045,MT,Judith Basin,,2009,5.5,1013,1072,59
30045,MT,Judith Basin,,2010,6.3,946,1010,64
30045,MT,Judith Basin,,2011,5.9,911,968,57
30045,MT,Judith Basin,,2012,5,941,991,50
30045,MT,Judith Basin,,2013,4.8,931,978,47
30045,MT,Judith Basin,,2014,4.2,926,967,41
30045,MT,Judith Basin,,2015,3.5,959,994,35
30045,MT,Judith Basin,,2016,3.5,899,932,33
30045,MT,Judith Basin,,2017,3.8,894,929,35
30045,MT,Judith Basin,,2018,3.4,889,920,31
30045,MT,Judith Basin,,2019,3.1,962,993,31
30045,MT,Judith Basin,,2020,4.7,938,984,46
30045,MT,Judith Basin,,2021,2.7,925,951,26
30047,MT,Lake,,2007,5.2,11096,11699,603
30047,MT,Lake,,2008,7,10907,11727,820
30047,MT,Lake,,2009,9.6,10359,11459,1100
30047,MT,Lake,,2010,8.9,11532,12658,1126
30047,MT,Lake,,2011,8.7,11443,12539,1096
30047,MT,Lake,,2012,7.5,11501,12430,929
30047,MT,Lake,,2013,6.4,11583,12378,795
30047,MT,Lake,,2014,5.5,11797,12487,690
30047,MT,Lake,,2015,5.1,12054,12705,651
30047,MT,Lake,,2016,4.9,12435,13078,643
30047,MT,Lake,,2017,4.6,12623,13225,602
30047,MT,Lake,,2018,4.3,12668,13236,568
30047,MT,Lake,,2019,4.3,12875,13458,583
30047,MT,Lake,,2020,6.1,12908,13742,834
30047,MT,Lake,,2021,3.8,13472,14006,534
30049,MT,Lewis and Clark,,2007,2.9,32543,33502,959
30049,MT,Lewis and Clark,,2008,3.8,33014,34333,1319
30049,MT,Lewis and Clark,,2009,5.3,32228,34016,1788
30049,MT,Lewis and Clark,,2010,5.4,32483,34339,1856
30049,MT,Lewis and Clark,,2011,5.1,32764,34515,1751
30049,MT,Lewis and Clark,,2012,4.7,33287,34929,1642
30049,MT,Lewis and Clark,,2013,4.3,33587,35098,1511
30049,MT,Lewis and Clark,,2014,3.7,33913,35221,1308
30049,MT,Lewis and Clark,,2015,3.5,33805,35016,1211
30049,MT,Lewis and Clark,,2016,3.4,33961,35167,1206
30049,MT,Lewis and Clark,,2017,3.5,34234,35477,1243
30049,MT,Lewis and Clark,,2018,3.3,34511,35706,1195
30049,MT,Lewis and Clark,,2019,3.1,35380,36498,1118
30049,MT,Lewis and Clark,,2020,4.9,34955,36742,1787
30049,MT,Lewis and Clark,,2021,3,36149,37256,1107
30051,MT,Liberty,,2007,2.7,782,804,22
30051,MT,Liberty,,2008,3.8,751,781,30
30051,MT,Liberty,,2009,4.5,719,753,34
30051,MT,Liberty,,2010,4.3,990,1034,44
30051,MT,Liberty,,2011,3.8,979,1018,39
30051,MT,Liberty,,2012,4,994,1035,41
30051,MT,Liberty,,2013,3.4,959,993,34
30051,MT,Liberty,,2014,3.2,943,974,31
30051,MT,Liberty,,2015,2.7,959,986,27
30051,MT,Liberty,,2016,3.2,956,988,32
30051,MT,Liberty,,2017,3,955,985,30
30051,MT,Liberty,,2018,2.5,944,968,24
30051,MT,Liberty,,2019,2.6,932,957,25
30051,MT,Liberty,,2020,2.7,946,972,26
30051,MT,Liberty,,2021,2.4,959,983,24
30053,MT,Lincoln,,2007,7.1,7286,7841,555
30053,MT,Lincoln,,2008,10,7073,7863,790
30053,MT,Lincoln,,2009,15.3,6727,7942,1215
30053,MT,Lincoln,,2010,14.8,7180,8424,1244
30053,MT,Lincoln,,2011,14.2,7017,8177,1160
30053,MT,Lincoln,,2012,12.2,7194,8191,997
30053,MT,Lincoln,,2013,12.8,7079,8120,1041
30053,MT,Lincoln,,2014,11.2,7036,7920,884
30053,MT,Lincoln,,2015,10.3,7015,7824,809
30053,MT,Lincoln,,2016,9.3,7200,7940,740
30053,MT,Lincoln,,2017,8.6,7271,7951,680
30053,MT,Lincoln,,2018,7.4,7540,8145,605
30053,MT,Lincoln,,2019,7.4,7610,8222,612
30053,MT,Lincoln,,2020,10,7308,8119,811
30053,MT,Lincoln,,2021,6,7617,8100,483
30055,MT,McCone,,2007,2.1,986,1007,21
30055,MT,McCone,,2008,2.6,1012,1039,27
30055,MT,McCone,,2009,3.3,984,1018,34
30055,MT,McCone,,2010,2.8,1100,1132,32
30055,MT,McCone,,2011,2.9,1068,1100,32
30055,MT,McCone,,2012,2.8,1059,1090,31
30055,MT,McCone,,2013,2.4,1071,1097,26
30055,MT,McCone,,2014,2.3,1064,1089,25
30055,MT,McCone,,2015,2.3,1038,1062,24
30055,MT,McCone,,2016,2,1021,1042,21
30055,MT,McCone,,2017,2.1,1006,1028,22
30055,MT,McCone,,2018,1.8,957,975,18
30055,MT,McCone,,2019,2,943,962,19
30055,MT,McCone,,2020,2.8,932,959,27
30055,MT,McCone,,2021,1.8,951,968,17
30057,MT,Madison,,2007,2.7,4354,4475,121
30057,MT,Madison,,2008,3.9,4401,4580,179
30057,MT,Madison,,2009,6.6,3941,4219,278
30057,MT,Madison,,2010,7.5,3847,4158,311
30057,MT,Madison,,2011,7,3884,4177,293
30057,MT,Madison,,2012,6.1,3863,4113,250
30057,MT,Madison,,2013,5.5,3937,4164,227
30057,MT,Madison,,2014,4.6,4037,4231,194
30057,MT,Madison,,2015,3.7,4129,4288,159
30057,MT,Madison,,2016,3.9,4239,4412,173
30057,MT,Madison,,2017,4,4246,4421,175
30057,MT,Madison,,2018,3.6,4448,4614,166
30057,MT,Madison,,2019,3.3,4676,4835,159
30057,MT,Madison,,2020,5,4454,4686,232
30057,MT,Madison,,2021,3.2,4592,4743,151
30059,MT,Meagher,,2007,5.3,857,905,48
30059,MT,Meagher,,2008,6.5,837,895,58
30059,MT,Meagher,,2009,8.8,784,860,76
30059,MT,Meagher,,2010,8,862,937,75
30059,MT,Meagher,,2011,7.1,845,910,65
30059,MT,Meagher,,2012,5.3,881,930,49
30059,MT,Meagher,,2013,5.3,884,933,49
30059,MT,Meagher,,2014,4.3,869,908,39
30059,MT,Meagher,,2015,3.7,901,936,35
30059,MT,Meagher,,2016,4.2,877,915,38
30059,MT,Meagher,,2017,4.4,894,935,41
30059,MT,Meagher,,2018,3.8,927,964,37
30059,MT,Meagher,,2019,3.5,936,970,34
30059,MT,Meagher,,2020,4.6,915,959,44
30059,MT,Meagher,,2021,2.5,963,988,25
30061,MT,Mineral,,2007,4.5,1891,1980,89
30061,MT,Mineral,,2008,6.7,1777,1904,127
30061,MT,Mineral,,2009,10.9,1718,1928,210
30061,MT,Mineral,,2010,12.4,1569,1792,223
30061,MT,Mineral,,2011,11.6,1578,1786,208
30061,MT,Mineral,,2012,10.6,1578,1766,188
30061,MT,Mineral,,2013,10.3,1597,1781,184
30061,MT,Mineral,,2014,9.1,1588,1747,159
30061,MT,Mineral,,2015,8.6,1582,1731,149
30061,MT,Mineral,,2016,7.8,1556,1688,132
30061,MT,Mineral,,2017,7.6,1569,1698,129
30061,MT,Mineral,,2018,7.2,1609,1734,125
30061,MT,Mineral,,2019,5.8,1688,1792,104
30061,MT,Mineral,,2020,10,1609,1788,179
30061,MT,Mineral,,2021,5.3,1772,1871,99
30063,MT,Missoula,,2007,3.2,57595,59518,1923
30063,MT,Missoula,,2008,4.6,56708,59465,2757
30063,MT,Missoula,,2009,6.6,55021,58899,3878
30063,MT,Missoula,,2010,7.2,54339,58566,4227
30063,MT,Missoula,,2011,6.5,54980,58776,3796
30063,MT,Missoula,,2012,5.7,55772,59138,3366
30063,MT,Missoula,,2013,5.1,56397,59447,3050
30063,MT,Missoula,,2014,4.4,57311,59970,2659
30063,MT,Missoula,,2015,4,58102,60542,2440
30063,MT,Missoula,,2016,3.9,58972,61361,2389
30063,MT,Missoula,,2017,3.7,60431,62734,2303
30063,MT,Missoula,,2018,3.3,61603,63737,2134
30063,MT,Missoula,,2019,3.3,62715,64851,2136
30063,MT,Missoula,,2020,6.1,60562,64525,3963
30063,MT,Missoula,,2021,3.4,62920,65104,2184
30065,MT,Musselshell,,2007,5,1944,2047,103
30065,MT,Musselshell,,2008,5.4,2050,2168,118
30065,MT,Musselshell,,2009,6.9,2276,2445,169
30065,MT,Musselshell,,2010,6.8,2221,2383,162
30065,MT,Musselshell,,2011,6.3,2182,2329,147
30065,MT,Musselshell,,2012,5.2,2291,2416,125
30065,MT,Musselshell,,2013,5,2259,2377,118
30065,MT,Musselshell,,2014,4.1,2266,2362,96
30065,MT,Musselshell,,2015,4.4,2304,2410,106
30065,MT,Musselshell,,2016,5.3,2172,2294,122
30065,MT,Musselshell,,2017,4.6,2200,2305,105
30065,MT,Musselshell,,2018,4.3,2203,2302,99
30065,MT,Musselshell,,2019,3.9,2213,2304,91
30065,MT,Musselshell,,2020,6,2200,2340,140
30065,MT,Musselshell,,2021,4.2,2255,2354,99
30067,MT,Park,,2007,3.3,8826,9130,304
30067,MT,Park,,2008,4.9,8642,9087,445
30067,MT,Park,,2009,8.3,7907,8624,717
30067,MT,Park,,2010,8.7,7212,7895,683
30067,MT,Park,,2011,8,7250,7877,627
30067,MT,Park,,2012,6.8,7479,8021,542
30067,MT,Park,,2013,6.3,7513,8016,503
30067,MT,Park,,2014,5.6,7617,8068,451
30067,MT,Park,,2015,4.9,7895,8304,409
30067,MT,Park,,2016,4.4,8032,8406,374
30067,MT,Park,,2017,4,8334,8679,345
30067,MT,Park,,2018,3.9,8576,8920,344
30067,MT,Park,,2019,3.5,8755,9071,316
30067,MT,Park,,2020,7.3,8354,9008,654
30067,MT,Park,,2021,3.5,8926,9253,327
30069,MT,Petroleum,,2007,5.1,225,237,12
30069,MT,Petroleum,,2008,5.2,238,251,13
30069,MT,Petroleum,,2009,5.5,223,236,13
30069,MT,Petroleum,,2010,5,284,299,15
30069,MT,Petroleum,,2011,5.4,265,280,15
30069,MT,Petroleum,,2012,4.3,287,300,13
30069,MT,Petroleum,,2013,4.4,280,293,13
30069,MT,Petroleum,,2014,4.2,272,284,12
30069,MT,Petroleum,,2015,5.3,269,284,15
30069,MT,Petroleum,,2016,4.7,264,277,13
30069,MT,Petroleum,,2017,4.4,281,294,13
30069,MT,Petroleum,,2018,4.2,272,284,12
30069,MT,Petroleum,,2019,3.7,260,270,10
30069,MT,Petroleum,,2020,3.3,262,271,9
30069,MT,Petroleum,,2021,2.6,264,271,7
30071,MT,Phillips,,2007,4,1984,2066,82
30071,MT,Phillips,,2008,4.7,2095,2199,104
30071,MT,Phillips,,2009,5.9,2111,2243,132
30071,MT,Phillips,,2010,6.7,2062,2210,148
30071,MT,Phillips,,2011,6.6,1985,2125,140
30071,MT,Phillips,,2012,5.8,1940,2059,119
30071,MT,Phillips,,2013,5.8,1939,2059,120
30071,MT,Phillips,,2014,5.3,1888,1994,106
30071,MT,Phillips,,2015,5.2,1876,1979,103
30071,MT,Phillips,,2016,5.5,1829,1935,106
30071,MT,Phillips,,2017,4.6,1816,1904,88
30071,MT,Phillips,,2018,4.5,1833,1920,87
30071,MT,Phillips,,2019,3.8,1829,1901,72
30071,MT,Phillips,,2020,4.8,1805,1896,91
30071,MT,Phillips,,2021,3.8,1782,1852,70
30073,MT,Pondera,,2007,3.7,2635,2737,102
30073,MT,Pondera,,2008,5.1,2507,2642,135
30073,MT,Pondera,,2009,6.5,2413,2581,168
30073,MT,Pondera,,2010,5.8,2785,2955,170
30073,MT,Pondera,,2011,5.7,2761,2929,168
30073,MT,Pondera,,2012,4.8,2801,2941,140
30073,MT,Pondera,,2013,4.9,2762,2904,142
30073,MT,Pondera,,2014,4.9,2704,2844,140
30073,MT,Pondera,,2015,4.6,2736,2867,131
30073,MT,Pondera,,2016,4.4,2739,2864,125
30073,MT,Pondera,,2017,3.9,2651,2758,107
30073,MT,Pondera,,2018,4.1,2629,2740,111
30073,MT,Pondera,,2019,3.8,2607,2710,103
30073,MT,Pondera,,2020,4.8,2543,2671,128
30073,MT,Pondera,,2021,3.2,2549,2633,84
30075,MT,Powder River,,2007,3,876,903,27
30075,MT,Powder River,,2008,3.2,925,956,31
30075,MT,Powder River,,2009,4.2,864,902,38
30075,MT,Powder River,,2010,3.7,1007,1046,39
30075,MT,Powder River,,2011,4.5,1011,1059,48
30075,MT,Powder River,,2012,3.6,1039,1078,39
30075,MT,Powder River,,2013,3.3,1089,1126,37
30075,MT,Powder River,,2014,3.1,1043,1076,33
30075,MT,Powder River,,2015,2.7,1028,1056,28
30075,MT,Powder River,,2016,2.4,1040,1066,26
30075,MT,Powder River,,2017,2.6,986,1012,26
30075,MT,Powder River,,2018,2.9,948,976,28
30075,MT,Powder River,,2019,2.4,945,968,23
30075,MT,Powder River,,2020,3.1,936,966,30
30075,MT,Powder River,,2021,2.7,951,977,26
30077,MT,Powell,,2007,5,2523,2657,134
30077,MT,Powell,,2008,7.1,2570,2767,197
30077,MT,Powell,,2009,9.5,2470,2728,258
30077,MT,Powell,,2010,7.6,2740,2964,224
30077,MT,Powell,,2011,7.3,2769,2988,219
30077,MT,Powell,,2012,6.3,2825,3014,189
30077,MT,Powell,,2013,5.5,2786,2948,162
30077,MT,Powell,,2014,5,2790,2937,147
30077,MT,Powell,,2015,4.6,2827,2962,135
30077,MT,Powell,,2016,5.2,2718,2868,150
30077,MT,Powell,,2017,4.4,2779,2907,128
30077,MT,Powell,,2018,4.2,2819,2942,123
30077,MT,Powell,,2019,3.7,2886,2998,112
30077,MT,Powell,,2020,4.6,2793,2928,135
30077,MT,Powell,,2021,2.6,2903,2979,76
30079,MT,Prairie,,2007,3.3,530,548,18
30079,MT,Prairie,,2008,3.8,575,598,23
30079,MT,Prairie,,2009,4.2,565,590,25
30079,MT,Prairie,,2010,4.9,539,567,28
30079,MT,Prairie,,2011,5.1,504,531,27
30079,MT,Prairie,,2012,4.2,507,529,22
30079,MT,Prairie,,2013,4.4,498,521,23
30079,MT,Prairie,,2014,4.3,492,514,22
30079,MT,Prairie,,2015,4.2,507,529,22
30079,MT,Prairie,,2016,3.4,508,526,18
30079,MT,Prairie,,2017,3.7,471,489,18
30079,MT,Prairie,,2018,3.7,473,491,18
30079,MT,Prairie,,2019,3.8,462,480,18
30079,MT,Prairie,,2020,6.6,440,471,31
30079,MT,Prairie,,2021,3.6,476,494,18
30081,MT,Ravalli,,2007,4.2,17958,18752,794
30081,MT,Ravalli,,2008,6.1,17737,18887,1150
30081,MT,Ravalli,,2009,9.6,16586,18340,1754
30081,MT,Ravalli,,2010,9.3,17125,18888,1763
30081,MT,Ravalli,,2011,8.6,17036,18640,1604
30081,MT,Ravalli,,2012,7.4,17322,18705,1383
30081,MT,Ravalli,,2013,6.7,17510,18759,1249
30081,MT,Ravalli,,2014,6,17658,18792,1134
30081,MT,Ravalli,,2015,5.3,18206,19235,1029
30081,MT,Ravalli,,2016,5,18594,19569,975
30081,MT,Ravalli,,2017,4.8,18956,19903,947
30081,MT,Ravalli,,2018,4.2,19271,20120,849
30081,MT,Ravalli,,2019,4.2,19736,20594,858
30081,MT,Ravalli,,2020,5.7,19667,20848,1181
30081,MT,Ravalli,,2021,3.6,20564,21330,766
30083,MT,Richland,,2007,2.3,5348,5472,124
30083,MT,Richland,,2008,2.9,5443,5608,165
30083,MT,Richland,,2009,4.9,5223,5495,272
30083,MT,Richland,,2010,3.7,5555,5769,214
30083,MT,Richland,,2011,2.9,5978,6159,181
30083,MT,Richland,,2012,2.7,6538,6720,182
30083,MT,Richland,,2013,2.6,6895,7078,183
30083,MT,Richland,,2014,2.4,7153,7328,175
30083,MT,Richland,,2015,3.3,6653,6881,228
30083,MT,Richland,,2016,5.2,5893,6213,320
30083,MT,Richland,,2017,3.9,5781,6014,233
30083,MT,Richland,,2018,3.1,5746,5929,183
30083,MT,Richland,,2019,2.7,5790,5951,161
30083,MT,Richland,,2020,6.3,5591,5964,373
30083,MT,Richland,,2021,4,5651,5887,236
30085,MT,Roosevelt,,2007,5.9,3644,3872,228
30085,MT,Roosevelt,,2008,6.8,3722,3995,273
30085,MT,Roosevelt,,2009,8.1,3718,4045,327
30085,MT,Roosevelt,,2010,6.8,4276,4587,311
30085,MT,Roosevelt,,2011,6.8,4314,4627,313
30085,MT,Roosevelt,,2012,6.4,4512,4820,308
30085,MT,Roosevelt,,2013,5.4,4657,4925,268
30085,MT,Roosevelt,,2014,5.2,4573,4822,249
30085,MT,Roosevelt,,2015,5.4,4443,4696,253
30085,MT,Roosevelt,,2016,5.5,4428,4687,259
30085,MT,Roosevelt,,2017,4.7,4382,4599,217
30085,MT,Roosevelt,,2018,4.6,4303,4509,206
30085,MT,Roosevelt,,2019,4.4,4368,4569,201
30085,MT,Roosevelt,,2020,5.9,4188,4449,261
30085,MT,Roosevelt,,2021,4.2,4146,4330,184
30087,MT,Rosebud,,2007,4.9,3748,3941,193
30087,MT,Rosebud,,2008,5.9,3828,4066,238
30087,MT,Rosebud,,2009,7,3768,4053,285
30087,MT,Rosebud,,2010,6.9,4061,4361,300
30087,MT,Rosebud,,2011,7,4133,4442,309
30087,MT,Rosebud,,2012,6.6,4160,4453,293
30087,MT,Rosebud,,2013,6.3,3937,4203,266
30087,MT,Rosebud,,2014,5.7,3940,4176,236
30087,MT,Rosebud,,2015,5.5,3950,4180,230
30087,MT,Rosebud,,2016,5.7,3874,4107,233
30087,MT,Rosebud,,2017,5.2,3837,4049,212
30087,MT,Rosebud,,2018,5.3,3693,3900,207
30087,MT,Rosebud,,2019,5.1,3678,3877,199
30087,MT,Rosebud,,2020,5.5,3535,3742,207
30087,MT,Rosebud,,2021,4,3432,3575,143
30089,MT,Sanders,,2007,6.3,4410,4704,294
30089,MT,Sanders,,2008,9.7,4240,4696,456
30089,MT,Sanders,,2009,16.1,3830,4566,736
30089,MT,Sanders,,2010,12.9,4352,4997,645
30089,MT,Sanders,,2011,12.8,4224,4843,619
30089,MT,Sanders,,2012,11.2,4252,4786,534
30089,MT,Sanders,,2013,10.4,4249,4740,491
30089,MT,Sanders,,2014,9.3,4207,4637,430
30089,MT,Sanders,,2015,8.5,4309,4710,401
30089,MT,Sanders,,2016,8,4377,4758,381
30089,MT,Sanders,,2017,7.1,4473,4813,340
30089,MT,Sanders,,2018,6.4,4513,4822,309
30089,MT,Sanders,,2019,6,4659,4958,299
30089,MT,Sanders,,2020,7.7,4700,5090,390
30089,MT,Sanders,,2021,4.8,4955,5206,251
30091,MT,Sheridan,,2007,2.6,1697,1742,45
30091,MT,Sheridan,,2008,2.9,1801,1855,54
30091,MT,Sheridan,,2009,4.5,1710,1791,81
30091,MT,Sheridan,,2010,3.6,1756,1822,66
30091,MT,Sheridan,,2011,3.4,1823,1887,64
30091,MT,Sheridan,,2012,2.9,2002,2061,59
30091,MT,Sheridan,,2013,2.8,2114,2174,60
30091,MT,Sheridan,,2014,2.6,2074,2130,56
30091,MT,Sheridan,,2015,2.6,2022,2075,53
30091,MT,Sheridan,,2016,3.4,1892,1958,66
30091,MT,Sheridan,,2017,2.7,1823,1874,51
30091,MT,Sheridan,,2018,2.3,1731,1772,41
30091,MT,Sheridan,,2019,2.3,1719,1759,40
30091,MT,Sheridan,,2020,4.7,1681,1764,83
30091,MT,Sheridan,,2021,3.3,1725,1784,59
30093,MT,Silver Bow,,2007,3.4,16902,17502,600
30093,MT,Silver Bow,,2008,4.5,17141,17946,805
30093,MT,Silver Bow,,2009,6.6,16159,17292,1133
30093,MT,Silver Bow,,2010,6.4,15874,16962,1088
30093,MT,Silver Bow,,2011,6.3,15885,16952,1067
30093,MT,Silver Bow,,2012,5.9,16200,17213,1013
30093,MT,Silver Bow,,2013,5.4,16262,17190,928
30093,MT,Silver Bow,,2014,4.9,16184,17023,839
30093,MT,Silver Bow,,2015,4.4,16385,17140,755
30093,MT,Silver Bow,,2016,4.4,16421,17184,763
30093,MT,Silver Bow,,2017,4.3,16517,17252,735
30093,MT,Silver Bow,,2018,4,16687,17391,704
30093,MT,Silver Bow,,2019,3.9,16784,17460,676
30093,MT,Silver Bow,,2020,6.5,16244,17366,1122
30093,MT,Silver Bow,,2021,3.6,16854,17489,635
30095,MT,Stillwater,,2007,3,4402,4536,134
30095,MT,Stillwater,,2008,4.1,4454,4645,191
30095,MT,Stillwater,,2009,6.4,4198,4486,288
30095,MT,Stillwater,,2010,5.7,4492,4766,274
30095,MT,Stillwater,,2011,5,4586,4825,239
30095,MT,Stillwater,,2012,4.3,4741,4956,215
30095,MT,Stillwater,,2013,4,4867,5069,202
30095,MT,Stillwater,,2014,3.7,4811,4998,187
30095,MT,Stillwater,,2015,3.9,4743,4933,190
30095,MT,Stillwater,,2016,4.1,4609,4808,199
30095,MT,Stillwater,,2017,3.9,4683,4873,190
30095,MT,Stillwater,,2018,3.4,4813,4984,171
30095,MT,Stillwater,,2019,3.2,5124,5293,169
30095,MT,Stillwater,,2020,4.9,5108,5374,266
30095,MT,Stillwater,,2021,2.9,5340,5499,159
30097,MT,Sweet Grass,,2007,1.8,2889,2941,52
30097,MT,Sweet Grass,,2008,2.5,2827,2900,73
30097,MT,Sweet Grass,,2009,4.8,2311,2428,117
30097,MT,Sweet Grass,,2010,5.4,1646,1740,94
30097,MT,Sweet Grass,,2011,4.5,1628,1704,76
30097,MT,Sweet Grass,,2012,3.8,1682,1748,66
30097,MT,Sweet Grass,,2013,3.7,1705,1770,65
30097,MT,Sweet Grass,,2014,3.5,1719,1782,63
30097,MT,Sweet Grass,,2015,2.9,1738,1790,52
30097,MT,Sweet Grass,,2016,3.2,1738,1796,58
30097,MT,Sweet Grass,,2017,3.2,1750,1807,57
30097,MT,Sweet Grass,,2018,3.1,1735,1790,55
30097,MT,Sweet Grass,,2019,2.8,1781,1833,52
30097,MT,Sweet Grass,,2020,3.5,1793,1858,65
30097,MT,Sweet Grass,,2021,2.4,1859,1904,45
30099,MT,Teton,,2007,2.9,2992,3082,90
30099,MT,Teton,,2008,3.9,3011,3134,123
30099,MT,Teton,,2009,5.2,2874,3031,157
30099,MT,Teton,,2010,5.9,2854,3033,179
30099,MT,Teton,,2011,5.4,2782,2941,159
30099,MT,Teton,,2012,4.7,2803,2942,139
30099,MT,Teton,,2013,4.3,2830,2956,126
30099,MT,Teton,,2014,3.7,2774,2882,108
30099,MT,Teton,,2015,3.9,2777,2891,114
30099,MT,Teton,,2016,3.7,2722,2828,106
30099,MT,Teton,,2017,4,2686,2797,111
30099,MT,Teton,,2018,3.4,2629,2721,92
30099,MT,Teton,,2019,3.3,2693,2786,93
30099,MT,Teton,,2020,4.3,2672,2791,119
30099,MT,Teton,,2021,3.1,2732,2820,88
30101,MT,Toole,,2007,2.4,2412,2471,59
30101,MT,Toole,,2008,3.1,2541,2621,80
30101,MT,Toole,,2009,4.5,2414,2528,114
30101,MT,Toole,,2010,4.5,2340,2450,110
30101,MT,Toole,,2011,4.4,2283,2388,105
30101,MT,Toole,,2012,4.1,2399,2501,102
30101,MT,Toole,,2013,3.8,2298,2389,91
30101,MT,Toole,,2014,3,2277,2348,71
30101,MT,Toole,,2015,3.5,2219,2299,80
30101,MT,Toole,,2016,3.6,2144,2224,80
30101,MT,Toole,,2017,3.1,2096,2162,66
30101,MT,Toole,,2018,2.6,2093,2148,55
30101,MT,Toole,,2019,2.4,2092,2144,52
30101,MT,Toole,,2020,4.8,2046,2149,103
30101,MT,Toole,,2021,2.6,2003,2056,53
30103,MT,Treasure,,2007,3.2,396,409,13
30103,MT,Treasure,,2008,3.9,393,409,16
30103,MT,Treasure,,2009,5.5,380,402,22
30103,MT,Treasure,,2010,5.3,378,399,21
30103,MT,Treasure,,2011,5.3,358,378,20
30103,MT,Treasure,,2012,4.7,361,379,18
30103,MT,Treasure,,2013,4.5,339,355,16
30103,MT,Treasure,,2014,4,333,347,14
30103,MT,Treasure,,2015,5,339,357,18
30103,MT,Treasure,,2016,4.5,337,353,16
30103,MT,Treasure,,2017,3.8,329,342,13
30103,MT,Treasure,,2018,3,326,336,10
30103,MT,Treasure,,2019,2.9,335,345,10
30103,MT,Treasure,,2020,3.5,329,341,12
30103,MT,Treasure,,2021,3.2,335,346,11
30105,MT,Valley,,2007,3.3,3539,3659,120
30105,MT,Valley,,2008,4,3534,3680,146
30105,MT,Valley,,2009,5.4,3401,3597,196
30105,MT,Valley,,2010,4.8,3726,3914,188
30105,MT,Valley,,2011,4.5,3763,3940,177
30105,MT,Valley,,2012,4,3864,4025,161
30105,MT,Valley,,2013,3.7,4089,4248,159
30105,MT,Valley,,2014,3,4232,4364,132
30105,MT,Valley,,2015,3.2,4250,4392,142
30105,MT,Valley,,2016,3.5,4246,4400,154
30105,MT,Valley,,2017,3.3,4046,4185,139
30105,MT,Valley,,2018,3.1,4029,4156,127
30105,MT,Valley,,2019,3.2,4021,4155,134
30105,MT,Valley,,2020,4.2,3911,4084,173
30105,MT,Valley,,2021,3.1,3918,4044,126
30107,MT,Wheatland,,2007,3.3,1012,1046,34
30107,MT,Wheatland,,2008,3.8,1063,1105,42
30107,MT,Wheatland,,2009,5.9,984,1046,62
30107,MT,Wheatland,,2010,7.8,794,861,67
30107,MT,Wheatland,,2011,7.7,772,836,64
30107,MT,Wheatland,,2012,6.1,787,838,51
30107,MT,Wheatland,,2013,6.2,775,826,51
30107,MT,Wheatland,,2014,5,744,783,39
30107,MT,Wheatland,,2015,5.6,744,788,44
30107,MT,Wheatland,,2016,5.3,755,797,42
30107,MT,Wheatland,,2017,4.4,754,789,35
30107,MT,Wheatland,,2018,5,767,807,40
30107,MT,Wheatland,,2019,3.8,744,773,29
30107,MT,Wheatland,,2020,7,709,762,53
30107,MT,Wheatland,,2021,5.3,720,760,40
30109,MT,Wibaux,,2007,2.7,505,519,14
30109,MT,Wibaux,,2008,3.2,519,536,17
30109,MT,Wibaux,,2009,5,547,576,29
30109,MT,Wibaux,,2010,4.2,508,530,22
30109,MT,Wibaux,,2011,4,505,526,21
30109,MT,Wibaux,,2012,3,544,561,17
30109,MT,Wibaux,,2013,3.4,540,559,19
30109,MT,Wibaux,,2014,2.9,534,550,16
30109,MT,Wibaux,,2015,3.3,528,546,18
30109,MT,Wibaux,,2016,4.1,492,513,21
30109,MT,Wibaux,,2017,3.3,470,486,16
30109,MT,Wibaux,,2018,3.6,453,470,17
30109,MT,Wibaux,,2019,3,446,460,14
30109,MT,Wibaux,,2020,4.9,428,450,22
30109,MT,Wibaux,,2021,3.8,407,423,16
30111,MT,Yellowstone,,2007,2.5,79907,81995,2088
30111,MT,Yellowstone,,2008,3.5,80215,83121,2906
30111,MT,Yellowstone,,2009,5.2,77833,82065,4232
30111,MT,Yellowstone,,2010,5.8,72045,76468,4423
30111,MT,Yellowstone,,2011,5.2,73155,77170,4015
30111,MT,Yellowstone,,2012,4.5,75206,78709,3503
30111,MT,Yellowstone,,2013,4.3,75946,79347,3401
30111,MT,Yellowstone,,2014,3.7,76525,79477,2952
30111,MT,Yellowstone,,2015,3.4,78046,80797,2751
30111,MT,Yellowstone,,2016,3.7,78099,81129,3030
30111,MT,Yellowstone,,2017,3.6,78912,81822,2910
30111,MT,Yellowstone,,2018,3.3,79543,82294,2751
30111,MT,Yellowstone,,2019,3.3,80365,83093,2728
30111,MT,Yellowstone,,2020,5.3,79187,83644,4457
30111,MT,Yellowstone,,2021,3.2,81654,84311,2657
31000,NE,Nebraska,,2007,2.9,950318,979043,28725
31000,NE,Nebraska,,2008,3.2,955470,987537,32067
31000,NE,Nebraska,,2009,4.7,941903,987855,45952
31000,NE,Nebraska,,2010,4.7,945195,992009,46814
31000,NE,Nebraska,,2011,4.4,959325,1003635,44310
31000,NE,Nebraska,,2012,3.9,973448,1012807,39359
31000,NE,Nebraska,,2013,3.7,977464,1014830,37366
31000,NE,Nebraska,,2014,3.3,979728,1012727,32999
31000,NE,Nebraska,,2015,3,981326,1011666,30340
31000,NE,Nebraska,,2016,3.1,984966,1016062,31096
31000,NE,Nebraska,,2017,3,992740,1023163,30423
31000,NE,Nebraska,,2018,2.9,1004261,1034214,29953
31000,NE,Nebraska,,2019,3,1016904,1048820,31916
31000,NE,Nebraska,,2020,4.1,1001426,1044541,43115
31000,NE,Nebraska,,2021,2.5,1022662,1049033,26371
31001,NE,Adams,,2007,2.7,16917,17379,462
31001,NE,Adams,,2008,3,17140,17669,529
31001,NE,Adams,,2009,5.1,16639,17529,890
31001,NE,Adams,,2010,4.8,15677,16472,795
31001,NE,Adams,,2011,4.3,15781,16493,712
31001,NE,Adams,,2012,3.7,16225,16851,626
31001,NE,Adams,,2013,3.6,16305,16906,601
31001,NE,Adams,,2014,3.4,16167,16728,561
31001,NE,Adams,,2015,3.1,16157,16677,520
31001,NE,Adams,,2016,3.1,16226,16749,523
31001,NE,Adams,,2017,3.1,16249,16775,526
31001,NE,Adams,,2018,3,16242,16738,496
31001,NE,Adams,,2019,3.2,16434,16973,539
31001,NE,Adams,,2020,3.9,16364,17032,668
31001,NE,Adams,,2021,2.4,16539,16942,403
31003,NE,Antelope,,2007,2.8,3530,3631,101
31003,NE,Antelope,,2008,2.9,3535,3641,106
31003,NE,Antelope,,2009,3.7,3585,3724,139
31003,NE,Antelope,,2010,3.7,3393,3522,129
31003,NE,Antelope,,2011,3.6,3468,3599,131
31003,NE,Antelope,,2012,3.2,3460,3573,113
31003,NE,Antelope,,2013,3.1,3494,3607,113
31003,NE,Antelope,,2014,2.7,3497,3594,97
31003,NE,Antelope,,2015,2.6,3517,3610,93
31003,NE,Antelope,,2016,2.6,3519,3613,94
31003,NE,Antelope,,2017,2.5,3505,3595,90
31003,NE,Antelope,,2018,2.5,3516,3605,89
31003,NE,Antelope,,2019,2.5,3540,3631,91
31003,NE,Antelope,,2020,2.2,3847,3932,85
31003,NE,Antelope,,2021,1.7,3632,3693,61
31005,NE,Arthur,,2007,3.8,229,238,9
31005,NE,Arthur,,2008,3.7,233,242,9
31005,NE,Arthur,,2009,5.8,227,241,14
31005,NE,Arthur,,2010,8,207,225,18
31005,NE,Arthur,,2011,6.1,217,231,14
31005,NE,Arthur,,2012,6.5,215,230,15
31005,NE,Arthur,,2013,7.3,203,219,16
31005,NE,Arthur,,2014,5.4,212,224,12
31005,NE,Arthur,,2015,4.4,215,225,10
31005,NE,Arthur,,2016,5.7,215,228,13
31005,NE,Arthur,,2017,5.8,210,223,13
31005,NE,Arthur,,2018,4.9,212,223,11
31005,NE,Arthur,,2019,5.6,218,231,13
31005,NE,Arthur,,2020,5.1,222,234,12
31005,NE,Arthur,,2021,2.6,228,234,6
31007,NE,Banner,,2007,2,396,404,8
31007,NE,Banner,,2008,2.5,391,401,10
31007,NE,Banner,,2009,3.4,338,350,12
31007,NE,Banner,,2010,4.4,395,413,18
31007,NE,Banner,,2011,4.6,413,433,20
31007,NE,Banner,,2012,4.4,417,436,19
31007,NE,Banner,,2013,4.4,416,435,19
31007,NE,Banner,,2014,3.7,421,437,16
31007,NE,Banner,,2015,3.4,427,442,15
31007,NE,Banner,,2016,3.6,405,420,15
31007,NE,Banner,,2017,3.6,379,393,14
31007,NE,Banner,,2018,3.6,370,384,14
31007,NE,Banner,,2019,3.6,370,384,14
31007,NE,Banner,,2020,2.8,381,392,11
31007,NE,Banner,,2021,2.1,381,389,8
31009,NE,Blaine,,2007,3.8,230,239,9
31009,NE,Blaine,,2008,4.9,231,243,12
31009,NE,Blaine,,2009,5.4,246,260,14
31009,NE,Blaine,,2010,5.1,244,257,13
31009,NE,Blaine,,2011,5.4,265,280,15
31009,NE,Blaine,,2012,5.3,268,283,15
31009,NE,Blaine,,2013,5.1,258,272,14
31009,NE,Blaine,,2014,4.4,263,275,12
31009,NE,Blaine,,2015,4.5,257,269,12
31009,NE,Blaine,,2016,4.5,255,267,12
31009,NE,Blaine,,2017,4.5,252,264,12
31009,NE,Blaine,,2018,4.6,251,263,12
31009,NE,Blaine,,2019,5,246,259,13
31009,NE,Blaine,,2020,3.5,246,255,9
31009,NE,Blaine,,2021,2.4,242,248,6
31011,NE,Boone,,2007,2.4,3095,3171,76
31011,NE,Boone,,2008,2.6,3166,3249,83
31011,NE,Boone,,2009,3.4,3216,3330,114
31011,NE,Boone,,2010,3.6,2849,2955,106
31011,NE,Boone,,2011,3.7,2930,3041,111
31011,NE,Boone,,2012,3,2945,3036,91
31011,NE,Boone,,2013,3.2,2952,3049,97
31011,NE,Boone,,2014,2.6,2947,3025,78
31011,NE,Boone,,2015,2.4,2950,3024,74
31011,NE,Boone,,2016,2.6,2942,3021,79
31011,NE,Boone,,2017,2.5,2883,2956,73
31011,NE,Boone,,2018,2.3,2875,2942,67
31011,NE,Boone,,2019,2.7,2913,2994,81
31011,NE,Boone,,2020,2.4,2882,2954,72
31011,NE,Boone,,2021,1.6,2916,2964,48
31013,NE,Box Butte,,2007,3.1,5438,5614,176
31013,NE,Box Butte,,2008,3.6,5413,5617,204
31013,NE,Box Butte,,2009,6.6,5248,5620,372
31013,NE,Box Butte,,2010,5.1,5548,5844,296
31013,NE,Box Butte,,2011,4.2,5730,5983,253
31013,NE,Box Butte,,2012,3.9,5731,5964,233
31013,NE,Box Butte,,2013,3.8,5742,5967,225
31013,NE,Box Butte,,2014,3.1,5569,5747,178
31013,NE,Box Butte,,2015,3,5513,5683,170
31013,NE,Box Butte,,2016,3.6,5472,5675,203
31013,NE,Box Butte,,2017,3.3,5295,5478,183
31013,NE,Box Butte,,2018,2.9,5301,5458,157
31013,NE,Box Butte,,2019,3.2,5300,5474,174
31013,NE,Box Butte,,2020,4.6,5155,5404,249
31013,NE,Box Butte,,2021,2.4,5349,5483,134
31015,NE,Boyd,,2007,3,1044,1076,32
31015,NE,Boyd,,2008,3.2,1072,1107,35
31015,NE,Boyd,,2009,3.9,1084,1128,44
31015,NE,Boyd,,2010,4,1061,1105,44
31015,NE,Boyd,,2011,3.8,1105,1149,44
31015,NE,Boyd,,2012,3.8,1101,1145,44
31015,NE,Boyd,,2013,3.4,1087,1125,38
31015,NE,Boyd,,2014,3.3,1064,1100,36
31015,NE,Boyd,,2015,2.7,1064,1093,29
31015,NE,Boyd,,2016,3,1072,1105,33
31015,NE,Boyd,,2017,3.4,1052,1089,37
31015,NE,Boyd,,2018,3,1054,1087,33
31015,NE,Boyd,,2019,3.3,1054,1090,36
31015,NE,Boyd,,2020,2.7,1028,1057,29
31015,NE,Boyd,,2021,2,1019,1040,21
31017,NE,Brown,,2007,2.6,1767,1814,47
31017,NE,Brown,,2008,2.6,1796,1844,48
31017,NE,Brown,,2009,3.1,1776,1833,57
31017,NE,Brown,,2010,4.8,1390,1460,70
31017,NE,Brown,,2011,4.6,1398,1465,67
31017,NE,Brown,,2012,3.9,1392,1449,57
31017,NE,Brown,,2013,3.8,1377,1432,55
31017,NE,Brown,,2014,3.4,1372,1421,49
31017,NE,Brown,,2015,3.7,1348,1400,52
31017,NE,Brown,,2016,3.7,1337,1388,51
31017,NE,Brown,,2017,3.3,1368,1415,47
31017,NE,Brown,,2018,3.4,1355,1403,48
31017,NE,Brown,,2019,3.6,1363,1414,51
31017,NE,Brown,,2020,2.7,1384,1422,38
31017,NE,Brown,,2021,2.3,1403,1436,33
31019,NE,Buffalo,,2007,2.2,27438,28054,616
31019,NE,Buffalo,,2008,2.4,27142,27820,678
31019,NE,Buffalo,,2009,3.6,26597,27599,1002
31019,NE,Buffalo,,2010,3.7,25371,26344,973
31019,NE,Buffalo,,2011,3.5,25930,26875,945
31019,NE,Buffalo,,2012,3.2,26378,27253,875
31019,NE,Buffalo,,2013,3.2,26486,27351,865
31019,NE,Buffalo,,2014,2.7,26745,27498,753
31019,NE,Buffalo,,2015,2.4,26582,27245,663
31019,NE,Buffalo,,2016,2.5,26687,27371,684
31019,NE,Buffalo,,2017,2.5,26850,27526,676
31019,NE,Buffalo,,2018,2.4,27333,28009,676
31019,NE,Buffalo,,2019,2.6,27429,28163,734
31019,NE,Buffalo,,2020,3.9,26768,27865,1097
31019,NE,Buffalo,,2021,2,27617,28178,561
31021,NE,Burt,,2007,3.9,3757,3910,153
31021,NE,Burt,,2008,4.1,3791,3952,161
31021,NE,Burt,,2009,5.6,3761,3984,223
31021,NE,Burt,,2010,6,3417,3637,220
31021,NE,Burt,,2011,5.7,3430,3639,209
31021,NE,Burt,,2012,4.6,3501,3670,169
31021,NE,Burt,,2013,4.4,3483,3645,162
31021,NE,Burt,,2014,3.9,3445,3584,139
31021,NE,Burt,,2015,3.6,3493,3624,131
31021,NE,Burt,,2016,3.7,3435,3566,131
31021,NE,Burt,,2017,3.7,3406,3537,131
31021,NE,Burt,,2018,3.5,3379,3500,121
31021,NE,Burt,,2019,3.4,3418,3537,119
31021,NE,Burt,,2020,3.8,3458,3594,136
31021,NE,Burt,,2021,2.4,3590,3680,90
31023,NE,Butler,,2007,2.5,4713,4832,119
31023,NE,Butler,,2008,2.8,4763,4901,138
31023,NE,Butler,,2009,4.2,4533,4732,199
31023,NE,Butler,,2010,4,4458,4643,185
31023,NE,Butler,,2011,3.8,4567,4747,180
31023,NE,Butler,,2012,3.2,4581,4734,153
31023,NE,Butler,,2013,3.3,4617,4775,158
31023,NE,Butler,,2014,2.9,4688,4830,142
31023,NE,Butler,,2015,2.8,4625,4757,132
31023,NE,Butler,,2016,3.2,4503,4652,149
31023,NE,Butler,,2017,2.8,4476,4606,130
31023,NE,Butler,,2018,2.4,4484,4594,110
31023,NE,Butler,,2019,2.6,4552,4673,121
31023,NE,Butler,,2020,3.3,4470,4624,154
31023,NE,Butler,,2021,2.2,4605,4707,102
31025,NE,Cass,,2007,3.2,13429,13879,450
31025,NE,Cass,,2008,3.6,13452,13956,504
31025,NE,Cass,,2009,5.2,12973,13689,716
31025,NE,Cass,,2010,5.7,12620,13387,767
31025,NE,Cass,,2011,5.3,12682,13385,703
31025,NE,Cass,,2012,4.5,12681,13282,601
31025,NE,Cass,,2013,4.2,12711,13274,563
31025,NE,Cass,,2014,3.7,12755,13244,489
31025,NE,Cass,,2015,3.3,12688,13123,435
31025,NE,Cass,,2016,3.4,12774,13217,443
31025,NE,Cass,,2017,3.2,12864,13289,425
31025,NE,Cass,,2018,3.1,13051,13465,414
31025,NE,Cass,,2019,3.4,13230,13691,461
31025,NE,Cass,,2020,4.3,12899,13474,575
31025,NE,Cass,,2021,2.7,13192,13554,362
31027,NE,Cedar,,2007,2.4,4664,4778,114
31027,NE,Cedar,,2008,2.4,4700,4818,118
31027,NE,Cedar,,2009,3.6,4649,4825,176
31027,NE,Cedar,,2010,3.6,4452,4619,167
31027,NE,Cedar,,2011,3.3,4555,4710,155
31027,NE,Cedar,,2012,2.8,4598,4732,134
31027,NE,Cedar,,2013,2.9,4582,4718,136
31027,NE,Cedar,,2014,2.3,4563,4670,107
31027,NE,Cedar,,2015,2.4,4550,4660,110
31027,NE,Cedar,,2016,2.5,4478,4595,117
31027,NE,Cedar,,2017,2.3,4409,4511,102
31027,NE,Cedar,,2018,2.4,4409,4516,107
31027,NE,Cedar,,2019,2.5,4461,4575,114
31027,NE,Cedar,,2020,2.7,4442,4563,121
31027,NE,Cedar,,2021,1.8,4582,4665,83
31029,NE,Chase,,2007,2.4,1949,1997,48
31029,NE,Chase,,2008,2.6,1936,1987,51
31029,NE,Chase,,2009,2.9,2014,2074,60
31029,NE,Chase,,2010,2.8,2224,2289,65
31029,NE,Chase,,2011,2.5,2290,2348,58
31029,NE,Chase,,2012,2.3,2314,2369,55
31029,NE,Chase,,2013,2.3,2343,2399,56
31029,NE,Chase,,2014,2,2301,2349,48
31029,NE,Chase,,2015,1.9,2303,2348,45
31029,NE,Chase,,2016,2,2257,2304,47
31029,NE,Chase,,2017,1.9,2281,2325,44
31029,NE,Chase,,2018,2.2,2248,2299,51
31029,NE,Chase,,2019,2.2,2249,2300,51
31029,NE,Chase,,2020,1.7,2250,2289,39
31029,NE,Chase,,2021,1.6,2227,2263,36
31031,NE,Cherry,,2007,2.2,3316,3390,74
31031,NE,Cherry,,2008,2.3,3318,3396,78
31031,NE,Cherry,,2009,2.6,3385,3476,91
31031,NE,Cherry,,2010,3,3277,3378,101
31031,NE,Cherry,,2011,3,3349,3454,105
31031,NE,Cherry,,2012,2.8,3379,3476,97
31031,NE,Cherry,,2013,2.7,3386,3480,94
31031,NE,Cherry,,2014,2.4,3334,3417,83
31031,NE,Cherry,,2015,2.3,3384,3463,79
31031,NE,Cherry,,2016,2.3,3412,3491,79
31031,NE,Cherry,,2017,2.3,3343,3423,80
31031,NE,Cherry,,2018,2.2,3294,3369,75
31031,NE,Cherry,,2019,2.4,3325,3406,81
31031,NE,Cherry,,2020,2.4,3318,3400,82
31031,NE,Cherry,,2021,1.6,3418,3473,55
31033,NE,Cheyenne,,2007,2.4,5121,5245,124
31033,NE,Cheyenne,,2008,2.8,5083,5227,144
31033,NE,Cheyenne,,2009,4.5,4925,5155,230
31033,NE,Cheyenne,,2010,3.7,5344,5549,205
31033,NE,Cheyenne,,2011,3,5512,5685,173
31033,NE,Cheyenne,,2012,2.7,5622,5778,156
31033,NE,Cheyenne,,2013,2.8,5641,5801,160
31033,NE,Cheyenne,,2014,2.2,5627,5751,124
31033,NE,Cheyenne,,2015,2.2,5645,5770,125
31033,NE,Cheyenne,,2016,2.8,5329,5483,154
31033,NE,Cheyenne,,2017,2.9,4997,5147,150
31033,NE,Cheyenne,,2018,2.9,4611,4747,136
31033,NE,Cheyenne,,2019,3.6,4276,4436,160
31033,NE,Cheyenne,,2020,4.3,4102,4287,185
31033,NE,Cheyenne,,2021,2.8,4142,4261,119
31035,NE,Clay,,2007,2.7,3027,3111,84
31035,NE,Clay,,2008,3.1,3015,3112,97
31035,NE,Clay,,2009,4.4,2889,3021,132
31035,NE,Clay,,2010,4.3,3279,3428,149
31035,NE,Clay,,2011,4.2,3340,3485,145
31035,NE,Clay,,2012,3.6,3353,3479,126
31035,NE,Clay,,2013,3.4,3375,3492,117
31035,NE,Clay,,2014,3.2,3351,3463,112
31035,NE,Clay,,2015,2.9,3289,3387,98
31035,NE,Clay,,2016,3.1,3237,3340,103
31035,NE,Clay,,2017,3.1,3204,3308,104
31035,NE,Clay,,2018,3.2,3177,3282,105
31035,NE,Clay,,2019,3.2,3227,3333,106
31035,NE,Clay,,2020,3.2,3197,3303,106
31035,NE,Clay,,2021,2.3,3185,3259,74
31037,NE,Colfax,,2007,2.2,5526,5648,122
31037,NE,Colfax,,2008,2.6,5472,5616,144
31037,NE,Colfax,,2009,3.7,5546,5761,215
31037,NE,Colfax,,2010,4,5423,5650,227
31037,NE,Colfax,,2011,3.9,5465,5686,221
31037,NE,Colfax,,2012,3.4,5458,5653,195
31037,NE,Colfax,,2013,3.4,5414,5607,193
31037,NE,Colfax,,2014,3,5458,5625,167
31037,NE,Colfax,,2015,2.6,5427,5572,145
31037,NE,Colfax,,2016,2.8,5424,5582,158
31037,NE,Colfax,,2017,2.4,5513,5651,138
31037,NE,Colfax,,2018,2.5,5508,5647,139
31037,NE,Colfax,,2019,2.7,5498,5650,152
31037,NE,Colfax,,2020,2.8,5516,5676,160
31037,NE,Colfax,,2021,1.9,5619,5728,109
31039,NE,Cuming,,2007,2.7,4864,4997,133
31039,NE,Cuming,,2008,2.8,4787,4927,140
31039,NE,Cuming,,2009,3.8,4782,4972,190
31039,NE,Cuming,,2010,3.7,4675,4856,181
31039,NE,Cuming,,2011,3.4,4757,4925,168
31039,NE,Cuming,,2012,3,4758,4905,147
31039,NE,Cuming,,2013,3,4798,4945,147
31039,NE,Cuming,,2014,2.6,4823,4952,129
31039,NE,Cuming,,2015,2.6,4730,4858,128
31039,NE,Cuming,,2016,2.9,4606,4742,136
31039,NE,Cuming,,2017,2.7,4643,4774,131
31039,NE,Cuming,,2018,2.6,4617,4738,121
31039,NE,Cuming,,2019,2.6,4677,4801,124
31039,NE,Cuming,,2020,2.5,4769,4890,121
31039,NE,Cuming,,2021,1.7,4857,4939,82
31041,NE,Custer,,2007,2.1,5881,6007,126
31041,NE,Custer,,2008,2.3,5906,6048,142
31041,NE,Custer,,2009,3.3,5967,6172,205
31041,NE,Custer,,2010,3.7,5753,5977,224
31041,NE,Custer,,2011,3.4,5843,6050,207
31041,NE,Custer,,2012,2.8,5928,6098,170
31041,NE,Custer,,2013,2.7,5976,6143,167
31041,NE,Custer,,2014,2.4,5991,6138,147
31041,NE,Custer,,2015,2.2,6169,6309,140
31041,NE,Custer,,2016,2.3,6238,6387,149
31041,NE,Custer,,2017,2.2,6303,6444,141
31041,NE,Custer,,2018,2.2,6345,6486,141
31041,NE,Custer,,2019,2.4,6332,6486,154
31041,NE,Custer,,2020,2.7,6257,6428,171
31041,NE,Custer,,2021,1.6,6319,6421,102
31043,NE,Dakota,,2007,3.9,10499,10928,429
31043,NE,Dakota,,2008,4.1,10530,10975,445
31043,NE,Dakota,,2009,6.1,10437,11111,674
31043,NE,Dakota,,2010,7.5,10447,11290,843
31043,NE,Dakota,,2011,5.9,10369,11018,649
31043,NE,Dakota,,2012,5.6,10539,11167,628
31043,NE,Dakota,,2013,4.6,10661,11174,513
31043,NE,Dakota,,2014,3.7,10645,11054,409
31043,NE,Dakota,,2015,3.5,10649,11038,389
31043,NE,Dakota,,2016,4.1,10515,10969,454
31043,NE,Dakota,,2017,4.1,10292,10733,441
31043,NE,Dakota,,2018,3.6,10395,10787,392
31043,NE,Dakota,,2019,3.9,10441,10862,421
31043,NE,Dakota,,2020,4.7,10212,10716,504
31043,NE,Dakota,,2021,3,10494,10823,329
31045,NE,Dawes,,2007,2.7,4674,4803,129
31045,NE,Dawes,,2008,2.9,4679,4817,138
31045,NE,Dawes,,2009,4.4,4541,4751,210
31045,NE,Dawes,,2010,4,5269,5490,221
31045,NE,Dawes,,2011,3.9,5263,5476,213
31045,NE,Dawes,,2012,3.6,5213,5405,192
31045,NE,Dawes,,2013,3.5,5221,5411,190
31045,NE,Dawes,,2014,2.9,5134,5288,154
31045,NE,Dawes,,2015,2.6,5135,5271,136
31045,NE,Dawes,,2016,2.9,5089,5243,154
31045,NE,Dawes,,2017,2.8,5066,5210,144
31045,NE,Dawes,,2018,2.7,4934,5071,137
31045,NE,Dawes,,2019,2.8,4901,5044,143
31045,NE,Dawes,,2020,2.7,4850,4985,135
31045,NE,Dawes,,2021,1.9,4925,5020,95
31047,NE,Dawson,,2007,3,11984,12353,369
31047,NE,Dawson,,2008,3.9,11944,12432,488
31047,NE,Dawson,,2009,4.6,11998,12582,584
31047,NE,Dawson,,2010,5,12530,13192,662
31047,NE,Dawson,,2011,5,12534,13194,660
31047,NE,Dawson,,2012,4.2,12685,13248,563
31047,NE,Dawson,,2013,3.7,12737,13230,493
31047,NE,Dawson,,2014,3.4,12881,13340,459
31047,NE,Dawson,,2015,3.2,12700,13115,415
31047,NE,Dawson,,2016,2.9,12653,13037,384
31047,NE,Dawson,,2017,2.9,12681,13060,379
31047,NE,Dawson,,2018,2.9,12697,13070,373
31047,NE,Dawson,,2019,3,12834,13229,395
31047,NE,Dawson,,2020,3.3,13000,13449,449
31047,NE,Dawson,,2021,2.1,13317,13607,290
31049,NE,Deuel,,2007,2.8,1021,1050,29
31049,NE,Deuel,,2008,2.9,1022,1052,30
31049,NE,Deuel,,2009,3.9,1024,1066,42
31049,NE,Deuel,,2010,4,989,1030,41
31049,NE,Deuel,,2011,3.5,1032,1069,37
31049,NE,Deuel,,2012,3.2,1152,1190,38
31049,NE,Deuel,,2013,3.3,1093,1130,37
31049,NE,Deuel,,2014,2.7,1062,1092,30
31049,NE,Deuel,,2015,2.5,1052,1079,27
31049,NE,Deuel,,2016,2.6,1039,1067,28
31049,NE,Deuel,,2017,2.6,1018,1045,27
31049,NE,Deuel,,2018,3,941,970,29
31049,NE,Deuel,,2019,3,937,966,29
31049,NE,Deuel,,2020,3.1,937,967,30
31049,NE,Deuel,,2021,2.1,956,977,21
31051,NE,Dixon,,2007,3.1,3212,3314,102
31051,NE,Dixon,,2008,3.1,3269,3374,105
31051,NE,Dixon,,2009,4.7,3163,3319,156
31051,NE,Dixon,,2010,4.9,2959,3111,152
31051,NE,Dixon,,2011,4.6,3018,3162,144
31051,NE,Dixon,,2012,4,3008,3134,126
31051,NE,Dixon,,2013,3.7,2998,3112,114
31051,NE,Dixon,,2014,3,2966,3059,93
31051,NE,Dixon,,2015,3.3,2992,3094,102
31051,NE,Dixon,,2016,3.3,2984,3086,102
31051,NE,Dixon,,2017,3.2,2947,3043,96
31051,NE,Dixon,,2018,3.1,2948,3043,95
31051,NE,Dixon,,2019,3,2934,3026,92
31051,NE,Dixon,,2020,3.2,2862,2957,95
31051,NE,Dixon,,2021,2.1,2922,2986,64
31053,NE,Dodge,,2007,3.1,19211,19831,620
31053,NE,Dodge,,2008,3.4,19280,19960,680
31053,NE,Dodge,,2009,5.1,18807,19809,1002
31053,NE,Dodge,,2010,5.4,17814,18827,1013
31053,NE,Dodge,,2011,4.9,18195,19138,943
31053,NE,Dodge,,2012,4.4,18382,19229,847
31053,NE,Dodge,,2013,4.1,18403,19192,789
31053,NE,Dodge,,2014,3.6,18537,19232,695
31053,NE,Dodge,,2015,3.2,18548,19171,623
31053,NE,Dodge,,2016,3.1,18649,19237,588
31053,NE,Dodge,,2017,2.8,18981,19536,555
31053,NE,Dodge,,2018,2.8,19048,19606,558
31053,NE,Dodge,,2019,2.9,19293,19871,578
31053,NE,Dodge,,2020,3.4,19609,20304,695
31053,NE,Dodge,,2021,2.4,19940,20420,480
31055,NE,Douglas,,2007,3.3,261053,270030,8977
31055,NE,Douglas,,2008,3.6,263715,273568,9853
31055,NE,Douglas,,2009,5.2,259591,273769,14178
31055,NE,Douglas,,2010,5.2,264380,278916,14536
31055,NE,Douglas,,2011,4.9,268311,282153,13842
31055,NE,Douglas,,2012,4.3,272639,285026,12387
31055,NE,Douglas,,2013,4.1,273993,285565,11572
31055,NE,Douglas,,2014,3.6,276341,286657,10316
31055,NE,Douglas,,2015,3.3,278389,287891,9502
31055,NE,Douglas,,2016,3.3,280038,289613,9575
31055,NE,Douglas,,2017,3.2,284301,293773,9472
31055,NE,Douglas,,2018,3.2,288281,297765,9484
31055,NE,Douglas,,2019,3.3,293488,303415,9927
31055,NE,Douglas,,2020,5,287388,302384,14996
31055,NE,Douglas,,2021,3,294193,303368,9175
31057,NE,Dundy,,2007,2.6,990,1016,26
31057,NE,Dundy,,2008,2.8,1004,1033,29
31057,NE,Dundy,,2009,4,1020,1062,42
31057,NE,Dundy,,2010,3.2,1176,1215,39
31057,NE,Dundy,,2011,2.9,1238,1275,37
31057,NE,Dundy,,2012,2.8,1243,1279,36
31057,NE,Dundy,,2013,2.7,1265,1300,35
31057,NE,Dundy,,2014,2.3,1249,1278,29
31057,NE,Dundy,,2015,2.1,1176,1201,25
31057,NE,Dundy,,2016,2.2,1176,1202,26
31057,NE,Dundy,,2017,2.4,1163,1192,29
31057,NE,Dundy,,2018,2.2,1136,1162,26
31057,NE,Dundy,,2019,2.5,1137,1166,29
31057,NE,Dundy,,2020,2.1,1143,1168,25
31057,NE,Dundy,,2021,1.6,1152,1171,19
31059,NE,Fillmore,,2007,2.5,3095,3173,78
31059,NE,Fillmore,,2008,2.9,3082,3174,92
31059,NE,Fillmore,,2009,4.1,3056,3187,131
31059,NE,Fillmore,,2010,3.8,3112,3235,123
31059,NE,Fillmore,,2011,3.5,3210,3325,115
31059,NE,Fillmore,,2012,3.2,3209,3314,105
31059,NE,Fillmore,,2013,2.9,3199,3296,97
31059,NE,Fillmore,,2014,2.4,3170,3248,78
31059,NE,Fillmore,,2015,2.9,3126,3221,95
31059,NE,Fillmore,,2016,2.7,3113,3201,88
31059,NE,Fillmore,,2017,2.5,3055,3134,79
31059,NE,Fillmore,,2018,2.5,3096,3177,81
31059,NE,Fillmore,,2019,2.6,3121,3203,82
31059,NE,Fillmore,,2020,2.7,3116,3203,87
31059,NE,Fillmore,,2021,1.9,3227,3291,64
31061,NE,Franklin,,2007,2.7,1749,1798,49
31061,NE,Franklin,,2008,2.9,1721,1773,52
31061,NE,Franklin,,2009,3.9,1711,1780,69
31061,NE,Franklin,,2010,4.5,1560,1633,73
31061,NE,Franklin,,2011,4.2,1601,1671,70
31061,NE,Franklin,,2012,3.5,1583,1641,58
31061,NE,Franklin,,2013,3.4,1540,1595,55
31061,NE,Franklin,,2014,3.2,1527,1577,50
31061,NE,Franklin,,2015,2.4,1481,1517,36
31061,NE,Franklin,,2016,3,1464,1509,45
31061,NE,Franklin,,2017,3,1445,1490,45
31061,NE,Franklin,,2018,3.1,1442,1488,46
31061,NE,Franklin,,2019,3.3,1450,1499,49
31061,NE,Franklin,,2020,3.3,1431,1480,49
31061,NE,Franklin,,2021,2.2,1472,1505,33
31063,NE,Frontier,,2007,2.2,1624,1661,37
31063,NE,Frontier,,2008,2.7,1581,1625,44
31063,NE,Frontier,,2009,3.2,1597,1649,52
31063,NE,Frontier,,2010,3.8,1533,1594,61
31063,NE,Frontier,,2011,3.6,1546,1603,57
31063,NE,Frontier,,2012,3.1,1559,1609,50
31063,NE,Frontier,,2013,3.3,1540,1593,53
31063,NE,Frontier,,2014,2.8,1509,1552,43
31063,NE,Frontier,,2015,2.4,1501,1538,37
31063,NE,Frontier,,2016,2.8,1534,1578,44
31063,NE,Frontier,,2017,2.5,1535,1575,40
31063,NE,Frontier,,2018,2.6,1490,1530,40
31063,NE,Frontier,,2019,3.2,1579,1631,52
31063,NE,Frontier,,2020,2.8,1512,1556,44
31063,NE,Frontier,,2021,1.7,1549,1576,27
31065,NE,Furnas,,2007,3,2397,2470,73
31065,NE,Furnas,,2008,2.9,2440,2512,72
31065,NE,Furnas,,2009,3.7,2458,2552,94
31065,NE,Furnas,,2010,3.4,2565,2656,91
31065,NE,Furnas,,2011,3.6,2614,2713,99
31065,NE,Furnas,,2012,3.4,2591,2683,92
31065,NE,Furnas,,2013,3.4,2629,2722,93
31065,NE,Furnas,,2014,2.8,2634,2711,77
31065,NE,Furnas,,2015,2.6,2667,2739,72
31065,NE,Furnas,,2016,2.8,2655,2731,76
31065,NE,Furnas,,2017,2.4,2636,2702,66
31065,NE,Furnas,,2018,2.6,2581,2651,70
31065,NE,Furnas,,2019,2.8,2540,2612,72
31065,NE,Furnas,,2020,2.7,2546,2616,70
31065,NE,Furnas,,2021,1.9,2534,2583,49
31067,NE,Gage,,2007,3.5,12072,12512,440
31067,NE,Gage,,2008,4.6,11645,12202,557
31067,NE,Gage,,2009,6.3,11220,11970,750
31067,NE,Gage,,2010,5.9,10727,11394,667
31067,NE,Gage,,2011,5.8,10547,11196,649
31067,NE,Gage,,2012,4.8,10613,11152,539
31067,NE,Gage,,2013,4.5,10590,11088,498
31067,NE,Gage,,2014,4.1,10638,11094,456
31067,NE,Gage,,2015,3.6,10689,11090,401
31067,NE,Gage,,2016,3.3,10749,11112,363
31067,NE,Gage,,2017,3.5,10672,11062,390
31067,NE,Gage,,2018,3.2,10690,11048,358
31067,NE,Gage,,2019,3.5,10750,11144,394
31067,NE,Gage,,2020,3.9,10542,10973,431
31067,NE,Gage,,2021,2.4,10679,10945,266
31069,NE,Garden,,2007,2.6,911,935,24
31069,NE,Garden,,2008,3,919,947,28
31069,NE,Garden,,2009,4.3,917,958,41
31069,NE,Garden,,2010,4.2,1212,1265,53
31069,NE,Garden,,2011,3.6,1215,1260,45
31069,NE,Garden,,2012,3.1,1219,1258,39
31069,NE,Garden,,2013,2.8,1199,1233,34
31069,NE,Garden,,2014,2.8,1160,1194,34
31069,NE,Garden,,2015,2.4,1172,1201,29
31069,NE,Garden,,2016,3.3,1155,1194,39
31069,NE,Garden,,2017,2.8,1167,1201,34
31069,NE,Garden,,2018,2.5,1165,1195,30
31069,NE,Garden,,2019,2.9,1075,1107,32
31069,NE,Garden,,2020,3.5,1044,1082,38
31069,NE,Garden,,2021,2.1,1096,1119,23
31071,NE,Garfield,,2007,2.5,1012,1038,26
31071,NE,Garfield,,2008,2.5,1025,1051,26
31071,NE,Garfield,,2009,3,1050,1082,32
31071,NE,Garfield,,2010,3.2,1162,1200,38
31071,NE,Garfield,,2011,3.4,1165,1206,41
31071,NE,Garfield,,2012,3,1182,1218,36
31071,NE,Garfield,,2013,3,1191,1228,37
31071,NE,Garfield,,2014,2.6,1172,1203,31
31071,NE,Garfield,,2015,2.4,1169,1198,29
31071,NE,Garfield,,2016,2.5,1133,1162,29
31071,NE,Garfield,,2017,2.7,1137,1168,31
31071,NE,Garfield,,2018,2.5,1147,1176,29
31071,NE,Garfield,,2019,2.7,1132,1163,31
31071,NE,Garfield,,2020,2,1139,1162,23
31071,NE,Garfield,,2021,2,1128,1151,23
31073,NE,Gosper,,2007,3.1,1011,1043,32
31073,NE,Gosper,,2008,3.1,988,1020,32
31073,NE,Gosper,,2009,3.9,934,972,38
31073,NE,Gosper,,2010,3.7,1103,1145,42
31073,NE,Gosper,,2011,3.5,1091,1131,40
31073,NE,Gosper,,2012,2.9,1110,1143,33
31073,NE,Gosper,,2013,3.4,1123,1162,39
31073,NE,Gosper,,2014,3,1103,1137,34
31073,NE,Gosper,,2015,2.4,1052,1078,26
31073,NE,Gosper,,2016,2.5,1035,1062,27
31073,NE,Gosper,,2017,2.7,1026,1055,29
31073,NE,Gosper,,2018,2.6,1041,1069,28
31073,NE,Gosper,,2019,2.6,1083,1112,29
31073,NE,Gosper,,2020,2.5,1085,1113,28
31073,NE,Gosper,,2021,1.7,1191,1211,20
31075,NE,Grant,,2007,2.6,376,386,10
31075,NE,Grant,,2008,2.9,362,373,11
31075,NE,Grant,,2009,3.5,354,367,13
31075,NE,Grant,,2010,3.8,404,420,16
31075,NE,Grant,,2011,3.3,439,454,15
31075,NE,Grant,,2012,3.4,424,439,15
31075,NE,Grant,,2013,3.3,405,419,14
31075,NE,Grant,,2014,2.3,419,429,10
31075,NE,Grant,,2015,2.3,427,437,10
31075,NE,Grant,,2016,2.2,445,455,10
31075,NE,Grant,,2017,2.3,433,443,10
31075,NE,Grant,,2018,2.6,412,423,11
31075,NE,Grant,,2019,2.7,403,414,11
31075,NE,Grant,,2020,1.9,412,420,8
31075,NE,Grant,,2021,1.4,422,428,6
31077,NE,Greeley,,2007,2.6,1245,1278,33
31077,NE,Greeley,,2008,2.8,1264,1301,37
31077,NE,Greeley,,2009,3.5,1279,1326,47
31077,NE,Greeley,,2010,3.7,1308,1358,50
31077,NE,Greeley,,2011,3.9,1309,1362,53
31077,NE,Greeley,,2012,3.5,1250,1296,46
31077,NE,Greeley,,2013,3.4,1252,1296,44
31077,NE,Greeley,,2014,3.2,1231,1272,41
31077,NE,Greeley,,2015,3.1,1214,1253,39
31077,NE,Greeley,,2016,3.1,1203,1241,38
31077,NE,Greeley,,2017,3.1,1194,1232,38
31077,NE,Greeley,,2018,2.7,1191,1224,33
31077,NE,Greeley,,2019,3,1201,1238,37
31077,NE,Greeley,,2020,2.9,1204,1240,36
31077,NE,Greeley,,2021,1.9,1217,1240,23
31079,NE,Hall,,2007,2.7,30127,30970,843
31079,NE,Hall,,2008,3,30710,31672,962
31079,NE,Hall,,2009,4.3,30691,32055,1364
31079,NE,Hall,,2010,4.7,29986,31476,1490
31079,NE,Hall,,2011,4.5,30589,32025,1436
31079,NE,Hall,,2012,3.9,31326,32587,1261
31079,NE,Hall,,2013,3.6,31297,32476,1179
31079,NE,Hall,,2014,3.9,31160,32417,1257
31079,NE,Hall,,2015,3.9,30471,31717,1246
31079,NE,Hall,,2016,3.6,30429,31581,1152
31079,NE,Hall,,2017,3.5,30781,31887,1106
31079,NE,Hall,,2018,3.2,31159,32203,1044
31079,NE,Hall,,2019,3.5,31164,32296,1132
31079,NE,Hall,,2020,5.6,30403,32215,1812
31079,NE,Hall,,2021,2.9,31559,32501,942
31081,NE,Hamilton,,2007,2.2,5520,5643,123
31081,NE,Hamilton,,2008,2.4,5732,5871,139
31081,NE,Hamilton,,2009,3.3,5331,5511,180
31081,NE,Hamilton,,2010,3.8,4615,4799,184
31081,NE,Hamilton,,2011,3.8,4651,4834,183
31081,NE,Hamilton,,2012,3.2,4677,4834,157
31081,NE,Hamilton,,2013,3.1,4687,4838,151
31081,NE,Hamilton,,2014,3,4624,4766,142
31081,NE,Hamilton,,2015,2.9,4556,4690,134
31081,NE,Hamilton,,2016,2.8,4549,4679,130
31081,NE,Hamilton,,2017,2.5,4605,4725,120
31081,NE,Hamilton,,2018,2.5,4672,4793,121
31081,NE,Hamilton,,2019,3,4719,4865,146
31081,NE,Hamilton,,2020,3.6,4604,4778,174
31081,NE,Hamilton,,2021,2.1,4754,4856,102
31083,NE,Harlan,,2007,2.6,1767,1814,47
31083,NE,Harlan,,2008,3,1783,1838,55
31083,NE,Harlan,,2009,3.7,1797,1866,69
31083,NE,Harlan,,2010,3.3,1828,1890,62
31083,NE,Harlan,,2011,3.3,1833,1895,62
31083,NE,Harlan,,2012,3.1,1815,1874,59
31083,NE,Harlan,,2013,3,1801,1857,56
31083,NE,Harlan,,2014,2.6,1756,1803,47
31083,NE,Harlan,,2015,2.1,1755,1793,38
31083,NE,Harlan,,2016,2.5,1723,1767,44
31083,NE,Harlan,,2017,2.6,1743,1789,46
31083,NE,Harlan,,2018,2.4,1746,1789,43
31083,NE,Harlan,,2019,2.8,1750,1800,50
31083,NE,Harlan,,2020,2.8,1704,1753,49
31083,NE,Harlan,,2021,1.9,1763,1797,34
31085,NE,Hayes,,2007,3.5,444,460,16
31085,NE,Hayes,,2008,3.6,459,476,17
31085,NE,Hayes,,2009,4.1,471,491,20
31085,NE,Hayes,,2010,3.6,617,640,23
31085,NE,Hayes,,2011,3.1,658,679,21
31085,NE,Hayes,,2012,2.9,644,663,19
31085,NE,Hayes,,2013,3.3,624,645,21
31085,NE,Hayes,,2014,2.9,611,629,18
31085,NE,Hayes,,2015,2.3,604,618,14
31085,NE,Hayes,,2016,2.4,579,593,14
31085,NE,Hayes,,2017,2.4,563,577,14
31085,NE,Hayes,,2018,2.1,592,605,13
31085,NE,Hayes,,2019,2.6,608,624,16
31085,NE,Hayes,,2020,2.2,620,634,14
31085,NE,Hayes,,2021,1.3,609,617,8
31087,NE,Hitchcock,,2007,2.7,1404,1443,39
31087,NE,Hitchcock,,2008,3.3,1420,1469,49
31087,NE,Hitchcock,,2009,5.5,1404,1486,82
31087,NE,Hitchcock,,2010,5.2,1325,1398,73
31087,NE,Hitchcock,,2011,4.9,1310,1377,67
31087,NE,Hitchcock,,2012,4,1302,1356,54
31087,NE,Hitchcock,,2013,4,1305,1359,54
31087,NE,Hitchcock,,2014,3.4,1296,1342,46
31087,NE,Hitchcock,,2015,3.2,1283,1326,43
31087,NE,Hitchcock,,2016,3.6,1266,1313,47
31087,NE,Hitchcock,,2017,3.5,1230,1274,44
31087,NE,Hitchcock,,2018,3.5,1224,1268,44
31087,NE,Hitchcock,,2019,3.3,1231,1273,42
31087,NE,Hitchcock,,2020,3.4,1277,1322,45
31087,NE,Hitchcock,,2021,2.3,1295,1325,30
31089,NE,Holt,,2007,2.5,5888,6040,152
31089,NE,Holt,,2008,2.6,5964,6125,161
31089,NE,Holt,,2009,3.1,6022,6216,194
31089,NE,Holt,,2010,3.7,5608,5822,214
31089,NE,Holt,,2011,3.4,5738,5942,204
31089,NE,Holt,,2012,3.1,5775,5960,185
31089,NE,Holt,,2013,3.1,5811,5995,184
31089,NE,Holt,,2014,2.6,5769,5925,156
31089,NE,Holt,,2015,2.4,5750,5890,140
31089,NE,Holt,,2016,2.5,5747,5892,145
31089,NE,Holt,,2017,2.5,5662,5805,143
31089,NE,Holt,,2018,2.6,5651,5802,151
31089,NE,Holt,,2019,2.6,5651,5800,149
31089,NE,Holt,,2020,2.4,5632,5771,139
31089,NE,Holt,,2021,1.7,5636,5736,100
31091,NE,Hooker,,2007,2.8,452,465,13
31091,NE,Hooker,,2008,4.3,396,414,18
31091,NE,Hooker,,2009,5.1,389,410,21
31091,NE,Hooker,,2010,5.1,388,409,21
31091,NE,Hooker,,2011,4.5,426,446,20
31091,NE,Hooker,,2012,4.6,418,438,20
31091,NE,Hooker,,2013,4.6,413,433,20
31091,NE,Hooker,,2014,4.2,406,424,18
31091,NE,Hooker,,2015,4.2,389,406,17
31091,NE,Hooker,,2016,3.6,380,394,14
31091,NE,Hooker,,2017,3.8,384,399,15
31091,NE,Hooker,,2018,3.7,390,405,15
31091,NE,Hooker,,2019,2.8,411,423,12
31091,NE,Hooker,,2020,2.7,399,410,11
31091,NE,Hooker,,2021,1.6,423,430,7
31093,NE,Howard,,2007,2.7,3610,3710,100
31093,NE,Howard,,2008,3,3619,3730,111
31093,NE,Howard,,2009,3.7,3468,3601,133
31093,NE,Howard,,2010,4.5,3191,3342,151
31093,NE,Howard,,2011,4.1,3258,3396,138
31093,NE,Howard,,2012,3.5,3296,3416,120
31093,NE,Howard,,2013,3.6,3291,3413,122
31093,NE,Howard,,2014,3.7,3244,3369,125
31093,NE,Howard,,2015,3.6,3201,3322,121
31093,NE,Howard,,2016,3.3,3209,3318,109
31093,NE,Howard,,2017,3.1,3246,3349,103
31093,NE,Howard,,2018,3.1,3282,3387,105
31093,NE,Howard,,2019,3.5,3288,3408,120
31093,NE,Howard,,2020,4.3,3258,3403,145
31093,NE,Howard,,2021,2.2,3364,3439,75
31095,NE,Jefferson,,2007,2.7,4455,4577,122
31095,NE,Jefferson,,2008,3.8,4149,4311,162
31095,NE,Jefferson,,2009,4.8,4077,4284,207
31095,NE,Jefferson,,2010,4.8,4041,4245,204
31095,NE,Jefferson,,2011,4.3,4187,4377,190
31095,NE,Jefferson,,2012,3.7,4154,4313,159
31095,NE,Jefferson,,2013,3.6,4175,4332,157
31095,NE,Jefferson,,2014,3,4172,4302,130
31095,NE,Jefferson,,2015,2.7,4175,4291,116
31095,NE,Jefferson,,2016,2.4,4143,4245,102
31095,NE,Jefferson,,2017,2.5,4131,4235,104
31095,NE,Jefferson,,2018,2.5,4090,4197,107
31095,NE,Jefferson,,2019,2.7,4080,4194,114
31095,NE,Jefferson,,2020,2.7,4123,4236,113
31095,NE,Jefferson,,2021,1.8,4155,4230,75
31097,NE,Johnson,,2007,2.9,2793,2875,82
31097,NE,Johnson,,2008,3.1,2841,2932,91
31097,NE,Johnson,,2009,4.2,2894,3021,127
31097,NE,Johnson,,2010,4.7,2229,2340,111
31097,NE,Johnson,,2011,4.8,2109,2216,107
31097,NE,Johnson,,2012,4.2,2096,2188,92
31097,NE,Johnson,,2013,4.2,2086,2178,92
31097,NE,Johnson,,2014,3.8,2087,2169,82
31097,NE,Johnson,,2015,3.3,2062,2132,70
31097,NE,Johnson,,2016,3.1,2037,2103,66
31097,NE,Johnson,,2017,3.4,2023,2095,72
31097,NE,Johnson,,2018,3.6,2019,2095,76
31097,NE,Johnson,,2019,3.4,2014,2085,71
31097,NE,Johnson,,2020,3.8,1998,2078,80
31097,NE,Johnson,,2021,2.9,1956,2014,58
31099,NE,Kearney,,2007,2.2,3728,3811,83
31099,NE,Kearney,,2008,2.7,3587,3685,98
31099,NE,Kearney,,2009,3.9,3471,3612,141
31099,NE,Kearney,,2010,3.6,3655,3790,135
31099,NE,Kearney,,2011,3.3,3779,3906,127
31099,NE,Kearney,,2012,2.8,3817,3927,110
31099,NE,Kearney,,2013,2.7,3786,3893,107
31099,NE,Kearney,,2014,2.4,3757,3851,94
31099,NE,Kearney,,2015,2.2,3723,3807,84
31099,NE,Kearney,,2016,2.3,3673,3761,88
31099,NE,Kearney,,2017,2.2,3706,3791,85
31099,NE,Kearney,,2018,2.1,3715,3795,80
31099,NE,Kearney,,2019,2.2,3746,3832,86
31099,NE,Kearney,,2020,3.1,3721,3842,121
31099,NE,Kearney,,2021,1.8,3775,3843,68
31101,NE,Keith,,2007,2.5,4547,4663,116
31101,NE,Keith,,2008,2.8,4415,4541,126
31101,NE,Keith,,2009,4.5,4252,4453,201
31101,NE,Keith,,2010,4.3,4380,4578,198
31101,NE,Keith,,2011,4.1,4466,4656,190
31101,NE,Keith,,2012,3.6,4487,4655,168
31101,NE,Keith,,2013,3.5,4532,4697,165
31101,NE,Keith,,2014,2.8,4535,4668,133
31101,NE,Keith,,2015,2.7,4577,4702,125
31101,NE,Keith,,2016,2.9,4509,4643,134
31101,NE,Keith,,2017,3.1,4491,4633,142
31101,NE,Keith,,2018,3.1,4453,4594,141
31101,NE,Keith,,2019,3.2,4513,4664,151
31101,NE,Keith,,2020,3.1,4521,4667,146
31101,NE,Keith,,2021,2,4590,4685,95
31103,NE,Keya Paha,,2007,3.7,366,380,14
31103,NE,Keya Paha,,2008,4.8,357,375,18
31103,NE,Keya Paha,,2009,4.6,377,395,18
31103,NE,Keya Paha,,2010,3.7,547,568,21
31103,NE,Keya Paha,,2011,3,584,602,18
31103,NE,Keya Paha,,2012,3,587,605,18
31103,NE,Keya Paha,,2013,3.3,589,609,20
31103,NE,Keya Paha,,2014,2.7,603,620,17
31103,NE,Keya Paha,,2015,2.1,649,663,14
31103,NE,Keya Paha,,2016,2.1,610,623,13
31103,NE,Keya Paha,,2017,2.5,597,612,15
31103,NE,Keya Paha,,2018,2.2,587,600,13
31103,NE,Keya Paha,,2019,2.5,578,593,15
31103,NE,Keya Paha,,2020,2.2,572,585,13
31103,NE,Keya Paha,,2021,1.7,580,590,10
31105,NE,Kimball,,2007,2.7,1921,1975,54
31105,NE,Kimball,,2008,3.3,1873,1937,64
31105,NE,Kimball,,2009,4.8,1824,1916,92
31105,NE,Kimball,,2010,4.8,2019,2120,101
31105,NE,Kimball,,2011,3.6,2102,2181,79
31105,NE,Kimball,,2012,3.2,2147,2218,71
31105,NE,Kimball,,2013,3.2,2121,2192,71
31105,NE,Kimball,,2014,2.5,2173,2229,56
31105,NE,Kimball,,2015,3.5,1986,2059,73
31105,NE,Kimball,,2016,4,1902,1982,80
31105,NE,Kimball,,2017,2.9,1934,1991,57
31105,NE,Kimball,,2018,2.7,1984,2040,56
31105,NE,Kimball,,2019,3,1990,2051,61
31105,NE,Kimball,,2020,3.5,1917,1986,69
31105,NE,Kimball,,2021,2.2,1916,1960,44
31107,NE,Knox,,2007,2.9,4577,4713,136
31107,NE,Knox,,2008,3.1,4512,4656,144
31107,NE,Knox,,2009,3.6,4668,4841,173
31107,NE,Knox,,2010,4.2,4544,4744,200
31107,NE,Knox,,2011,3.9,4579,4765,186
31107,NE,Knox,,2012,3.3,4625,4781,156
31107,NE,Knox,,2013,3.4,4627,4792,165
31107,NE,Knox,,2014,3.1,4589,4735,146
31107,NE,Knox,,2015,3.2,4585,4736,151
31107,NE,Knox,,2016,3,4601,4745,144
31107,NE,Knox,,2017,3.5,4569,4734,165
31107,NE,Knox,,2018,3.1,4533,4680,147
31107,NE,Knox,,2019,3,4522,4661,139
31107,NE,Knox,,2020,2.9,4551,4689,138
31107,NE,Knox,,2021,2,4638,4735,97
31109,NE,Lancaster,,2007,2.7,153104,157419,4315
31109,NE,Lancaster,,2008,3,154744,159498,4754
31109,NE,Lancaster,,2009,4.3,153175,160106,6931
31109,NE,Lancaster,,2010,4.3,155360,162326,6966
31109,NE,Lancaster,,2011,4,157636,164218,6582
31109,NE,Lancaster,,2012,3.5,161395,167268,5873
31109,NE,Lancaster,,2013,3.4,162683,168376,5693
31109,NE,Lancaster,,2014,3,163106,168083,4977
31109,NE,Lancaster,,2015,2.6,163746,168174,4428
31109,NE,Lancaster,,2016,2.8,165281,169981,4700
31109,NE,Lancaster,,2017,2.7,167501,172124,4623
31109,NE,Lancaster,,2018,2.6,171912,176561,4649
31109,NE,Lancaster,,2019,2.8,174514,179477,4963
31109,NE,Lancaster,,2020,4.1,171029,178390,7361
31109,NE,Lancaster,,2021,2.4,174272,178631,4359
31111,NE,Lincoln,,2007,2.6,21200,21763,563
31111,NE,Lincoln,,2008,2.9,21303,21934,631
31111,NE,Lincoln,,2009,4,20866,21738,872
31111,NE,Lincoln,,2010,4.6,18482,19374,892
31111,NE,Lincoln,,2011,4.4,18576,19429,853
31111,NE,Lincoln,,2012,3.8,18499,19236,737
31111,NE,Lincoln,,2013,3.7,18471,19181,710
31111,NE,Lincoln,,2014,3.2,18137,18742,605
31111,NE,Lincoln,,2015,2.9,18073,18611,538
31111,NE,Lincoln,,2016,3.1,18238,18815,577
31111,NE,Lincoln,,2017,3.1,18051,18625,574
31111,NE,Lincoln,,2018,3.1,17919,18486,567
31111,NE,Lincoln,,2019,3.4,17900,18536,636
31111,NE,Lincoln,,2020,3.9,17821,18536,715
31111,NE,Lincoln,,2021,2.2,18187,18596,409
31113,NE,Logan,,2007,2.8,458,471,13
31113,NE,Logan,,2008,1.9,454,463,9
31113,NE,Logan,,2009,3.1,442,456,14
31113,NE,Logan,,2010,4.7,469,492,23
31113,NE,Logan,,2011,3.5,491,509,18
31113,NE,Logan,,2012,3,489,504,15
31113,NE,Logan,,2013,3.2,486,502,16
31113,NE,Logan,,2014,3,480,495,15
31113,NE,Logan,,2015,3,480,495,15
31113,NE,Logan,,2016,2.9,472,486,14
31113,NE,Logan,,2017,2.7,462,475,13
31113,NE,Logan,,2018,3,456,470,14
31113,NE,Logan,,2019,2.9,464,478,14
31113,NE,Logan,,2020,2.5,464,476,12
31113,NE,Logan,,2021,1.7,463,471,8
31115,NE,Loup,,2007,3.9,320,333,13
31115,NE,Loup,,2008,3.8,326,339,13
31115,NE,Loup,,2009,5.1,318,335,17
31115,NE,Loup,,2010,5.7,347,368,21
31115,NE,Loup,,2011,4.7,361,379,18
31115,NE,Loup,,2012,3.6,377,391,14
31115,NE,Loup,,2013,4.5,360,377,17
31115,NE,Loup,,2014,3.9,367,382,15
31115,NE,Loup,,2015,3.4,366,379,13
31115,NE,Loup,,2016,3.5,384,398,14
31115,NE,Loup,,2017,3,390,402,12
31115,NE,Loup,,2018,3.2,389,402,13
31115,NE,Loup,,2019,4,403,420,17
31115,NE,Loup,,2020,3.2,396,409,13
31115,NE,Loup,,2021,2,392,400,8
31117,NE,McPherson,,2007,2,295,301,6
31117,NE,McPherson,,2008,2.3,303,310,7
31117,NE,McPherson,,2009,3.8,280,291,11
31117,NE,McPherson,,2010,2.8,342,352,10
31117,NE,McPherson,,2011,2.5,357,366,9
31117,NE,McPherson,,2012,3.3,347,359,12
31117,NE,McPherson,,2013,3.8,357,371,14
31117,NE,McPherson,,2014,2.3,429,439,10
31117,NE,McPherson,,2015,1.9,453,462,9
31117,NE,McPherson,,2016,2.4,455,466,11
31117,NE,McPherson,,2017,2.2,446,456,10
31117,NE,McPherson,,2018,2.7,435,447,12
31117,NE,McPherson,,2019,2.4,439,450,11
31117,NE,McPherson,,2020,2.5,432,443,11
31117,NE,McPherson,,2021,1.6,426,433,7
31119,NE,Madison,,2007,3.1,18241,18824,583
31119,NE,Madison,,2008,3.2,18204,18812,608
31119,NE,Madison,,2009,4.4,18041,18863,822
31119,NE,Madison,,2010,4.3,18110,18923,813
31119,NE,Madison,,2011,4.1,18319,19098,779
31119,NE,Madison,,2012,3.6,18482,19170,688
31119,NE,Madison,,2013,3.4,18634,19293,659
31119,NE,Madison,,2014,2.9,18926,19497,571
31119,NE,Madison,,2015,2.7,18757,19284,527
31119,NE,Madison,,2016,2.7,18738,19266,528
31119,NE,Madison,,2017,2.7,18918,19434,516
31119,NE,Madison,,2018,2.6,19160,19668,508
31119,NE,Madison,,2019,2.8,19503,20060,557
31119,NE,Madison,,2020,3.7,19073,19813,740
31119,NE,Madison,,2021,2.4,19598,20079,481
31121,NE,Merrick,,2007,2.8,4057,4175,118
31121,NE,Merrick,,2008,3,4086,4214,128
31121,NE,Merrick,,2009,4.2,3988,4162,174
31121,NE,Merrick,,2010,4.6,4001,4193,192
31121,NE,Merrick,,2011,4.3,3997,4175,178
31121,NE,Merrick,,2012,3.6,4073,4224,151
31121,NE,Merrick,,2013,3.6,4043,4195,152
31121,NE,Merrick,,2014,3.8,3961,4116,155
31121,NE,Merrick,,2015,3.7,3893,4043,150
31121,NE,Merrick,,2016,3.6,3910,4056,146
31121,NE,Merrick,,2017,2.8,3977,4092,115
31121,NE,Merrick,,2018,2.9,3925,4041,116
31121,NE,Merrick,,2019,3.2,3958,4089,131
31121,NE,Merrick,,2020,3.8,3925,4082,157
31121,NE,Merrick,,2021,2.3,4051,4148,97
31123,NE,Morrill,,2007,2.6,2708,2780,72
31123,NE,Morrill,,2008,3.1,2788,2876,88
31123,NE,Morrill,,2009,4.2,2731,2852,121
31123,NE,Morrill,,2010,4.2,2536,2646,110
31123,NE,Morrill,,2011,3.4,2569,2659,90
31123,NE,Morrill,,2012,3.1,2614,2698,84
31123,NE,Morrill,,2013,3.1,2660,2746,86
31123,NE,Morrill,,2014,3,2603,2683,80
31123,NE,Morrill,,2015,2.9,2585,2661,76
31123,NE,Morrill,,2016,3.2,2579,2663,84
31123,NE,Morrill,,2017,3,2552,2631,79
31123,NE,Morrill,,2018,2.8,2538,2610,72
31123,NE,Morrill,,2019,2.8,2560,2635,75
31123,NE,Morrill,,2020,3.5,2547,2639,92
31123,NE,Morrill,,2021,2.5,2576,2641,65
31125,NE,Nance,,2007,2.4,1972,2021,49
31125,NE,Nance,,2008,2.9,1992,2051,59
31125,NE,Nance,,2009,3.3,2070,2141,71
31125,NE,Nance,,2010,4,1898,1977,79
31125,NE,Nance,,2011,3.7,1988,2064,76
31125,NE,Nance,,2012,3.2,2026,2094,68
31125,NE,Nance,,2013,3.1,2007,2072,65
31125,NE,Nance,,2014,2.7,2016,2072,56
31125,NE,Nance,,2015,2.5,2022,2073,51
31125,NE,Nance,,2016,2.7,1956,2011,55
31125,NE,Nance,,2017,2.5,1986,2037,51
31125,NE,Nance,,2018,2.5,1981,2031,50
31125,NE,Nance,,2019,3,1946,2007,61
31125,NE,Nance,,2020,3.1,1913,1975,62
31125,NE,Nance,,2021,1.9,1934,1972,38
31127,NE,Nemaha,,2007,3.7,3374,3505,131
31127,NE,Nemaha,,2008,4.5,3252,3406,154
31127,NE,Nemaha,,2009,5.3,3240,3420,180
31127,NE,Nemaha,,2010,5.4,3638,3846,208
31127,NE,Nemaha,,2011,5,3765,3963,198
31127,NE,Nemaha,,2012,4.7,3694,3877,183
31127,NE,Nemaha,,2013,4.9,3624,3810,186
31127,NE,Nemaha,,2014,3.8,3586,3728,142
31127,NE,Nemaha,,2015,3.6,3569,3704,135
31127,NE,Nemaha,,2016,3.6,3505,3637,132
31127,NE,Nemaha,,2017,3.9,3494,3637,143
31127,NE,Nemaha,,2018,3.5,3520,3648,128
31127,NE,Nemaha,,2019,3.6,3534,3667,133
31127,NE,Nemaha,,2020,3.5,3498,3625,127
31127,NE,Nemaha,,2021,2.2,3581,3662,81
31129,NE,Nuckolls,,2007,2.5,2183,2240,57
31129,NE,Nuckolls,,2008,2.8,2185,2249,64
31129,NE,Nuckolls,,2009,4.6,2199,2304,105
31129,NE,Nuckolls,,2010,4.2,2336,2438,102
31129,NE,Nuckolls,,2011,3.6,2407,2497,90
31129,NE,Nuckolls,,2012,3.4,2388,2471,83
31129,NE,Nuckolls,,2013,3.1,2373,2450,77
31129,NE,Nuckolls,,2014,2.8,2338,2405,67
31129,NE,Nuckolls,,2015,2.6,2330,2391,61
31129,NE,Nuckolls,,2016,2.9,2311,2380,69
31129,NE,Nuckolls,,2017,2.7,2319,2383,64
31129,NE,Nuckolls,,2018,2.7,2337,2403,66
31129,NE,Nuckolls,,2019,2.7,2358,2424,66
31129,NE,Nuckolls,,2020,2.7,2412,2478,66
31129,NE,Nuckolls,,2021,1.8,2455,2501,46
31131,NE,Otoe,,2007,2.9,8689,8952,263
31131,NE,Otoe,,2008,3.4,8740,9050,310
31131,NE,Otoe,,2009,5,8473,8918,445
31131,NE,Otoe,,2010,5.1,8030,8465,435
31131,NE,Otoe,,2011,5.1,8123,8558,435
31131,NE,Otoe,,2012,4.4,8120,8493,373
31131,NE,Otoe,,2013,4.2,8058,8409,351
31131,NE,Otoe,,2014,3.7,7945,8248,303
31131,NE,Otoe,,2015,3.3,7961,8232,271
31131,NE,Otoe,,2016,3.4,8026,8307,281
31131,NE,Otoe,,2017,3.4,7954,8232,278
31131,NE,Otoe,,2018,2.9,8003,8244,241
31131,NE,Otoe,,2019,3.2,8242,8512,270
31131,NE,Otoe,,2020,3.5,8157,8451,294
31131,NE,Otoe,,2021,2.3,8399,8597,198
31133,NE,Pawnee,,2007,2.9,1541,1587,46
31133,NE,Pawnee,,2008,3.3,1511,1562,51
31133,NE,Pawnee,,2009,3.7,1483,1540,57
31133,NE,Pawnee,,2010,4,1519,1583,64
31133,NE,Pawnee,,2011,3.7,1592,1654,62
31133,NE,Pawnee,,2012,3.2,1585,1638,53
31133,NE,Pawnee,,2013,3,1628,1679,51
31133,NE,Pawnee,,2014,2.8,1608,1654,46
31133,NE,Pawnee,,2015,2.6,1635,1678,43
31133,NE,Pawnee,,2016,2.2,1626,1663,37
31133,NE,Pawnee,,2017,3,1471,1517,46
31133,NE,Pawnee,,2018,2.6,1449,1488,39
31133,NE,Pawnee,,2019,2.8,1451,1493,42
31133,NE,Pawnee,,2020,2.7,1463,1503,40
31133,NE,Pawnee,,2021,1.8,1501,1529,28
31135,NE,Perkins,,2007,2.3,1540,1577,37
31135,NE,Perkins,,2008,2.3,1633,1672,39
31135,NE,Perkins,,2009,3,1648,1699,51
31135,NE,Perkins,,2010,3.4,1706,1766,60
31135,NE,Perkins,,2011,2.9,1751,1803,52
31135,NE,Perkins,,2012,2.6,1779,1826,47
31135,NE,Perkins,,2013,2.5,1772,1817,45
31135,NE,Perkins,,2014,2.1,1814,1853,39
31135,NE,Perkins,,2015,1.8,1808,1842,34
31135,NE,Perkins,,2016,2.2,1790,1830,40
31135,NE,Perkins,,2017,1.9,1788,1823,35
31135,NE,Perkins,,2018,2,1801,1837,36
31135,NE,Perkins,,2019,2.2,1798,1839,41
31135,NE,Perkins,,2020,1.8,1828,1861,33
31135,NE,Perkins,,2021,1.4,1848,1874,26
31137,NE,Phelps,,2007,2.2,4989,5103,114
31137,NE,Phelps,,2008,2.4,5020,5141,121
31137,NE,Phelps,,2009,3.6,5007,5192,185
31137,NE,Phelps,,2010,3.6,4770,4950,180
31137,NE,Phelps,,2011,3.7,4831,5015,184
31137,NE,Phelps,,2012,2.9,4893,5040,147
31137,NE,Phelps,,2013,2.9,4930,5077,147
31137,NE,Phelps,,2014,2.6,4926,5056,130
31137,NE,Phelps,,2015,2.4,4893,5013,120
31137,NE,Phelps,,2016,2.5,4833,4957,124
31137,NE,Phelps,,2017,2.3,4834,4950,116
31137,NE,Phelps,,2018,2.3,4823,4937,114
31137,NE,Phelps,,2019,2.6,4901,5033,132
31137,NE,Phelps,,2020,2.9,4866,5011,145
31137,NE,Phelps,,2021,1.7,4885,4972,87
31139,NE,Pierce,,2007,2.9,3840,3956,116
31139,NE,Pierce,,2008,2.9,3817,3931,114
31139,NE,Pierce,,2009,4,3706,3859,153
31139,NE,Pierce,,2010,3.7,4013,4169,156
31139,NE,Pierce,,2011,3.5,4064,4213,149
31139,NE,Pierce,,2012,3.2,4052,4188,136
31139,NE,Pierce,,2013,3.3,4072,4210,138
31139,NE,Pierce,,2014,2.9,4121,4242,121
31139,NE,Pierce,,2015,2.5,4077,4183,106
31139,NE,Pierce,,2016,2.6,4059,4168,109
31139,NE,Pierce,,2017,2.7,4041,4155,114
31139,NE,Pierce,,2018,2.7,4029,4140,111
31139,NE,Pierce,,2019,2.7,4038,4149,111
31139,NE,Pierce,,2020,3.2,4044,4176,132
31139,NE,Pierce,,2021,2.1,4104,4193,89
31141,NE,Platte,,2007,2.4,17968,18408,440
31141,NE,Platte,,2008,2.9,17830,18359,529
31141,NE,Platte,,2009,4.1,17542,18293,751
31141,NE,Platte,,2010,4.3,16871,17629,758
31141,NE,Platte,,2011,4.2,17088,17832,744
31141,NE,Platte,,2012,3.6,17369,18009,640
31141,NE,Platte,,2013,3.4,17093,17693,600
31141,NE,Platte,,2014,3,16812,17325,513
31141,NE,Platte,,2015,3,16698,17209,511
31141,NE,Platte,,2016,3.5,16476,17068,592
31141,NE,Platte,,2017,2.9,16900,17406,506
31141,NE,Platte,,2018,2.7,17111,17592,481
31141,NE,Platte,,2019,2.9,17376,17898,522
31141,NE,Platte,,2020,3.6,17295,17945,650
31141,NE,Platte,,2021,2.1,17934,18327,393
31143,NE,Polk,,2007,2.7,2886,2967,81
31143,NE,Polk,,2008,2.7,2944,3027,83
31143,NE,Polk,,2009,3.8,2922,3036,114
31143,NE,Polk,,2010,4.1,2833,2954,121
31143,NE,Polk,,2011,3.4,2898,3001,103
31143,NE,Polk,,2012,3,2898,2987,89
31143,NE,Polk,,2013,3.3,2891,2991,100
31143,NE,Polk,,2014,3.2,2870,2964,94
31143,NE,Polk,,2015,2.5,2847,2921,74
31143,NE,Polk,,2016,2.7,2821,2898,77
31143,NE,Polk,,2017,2.4,2849,2919,70
31143,NE,Polk,,2018,2.4,2853,2924,71
31143,NE,Polk,,2019,2.8,2874,2956,82
31143,NE,Polk,,2020,3,2860,2947,87
31143,NE,Polk,,2021,1.9,2896,2951,55
31145,NE,Red Willow,,2007,2.5,5777,5923,146
31145,NE,Red Willow,,2008,2.8,5838,6007,169
31145,NE,Red Willow,,2009,4.5,5802,6076,274
31145,NE,Red Willow,,2010,3.7,5975,6206,231
31145,NE,Red Willow,,2011,3.5,6071,6290,219
31145,NE,Red Willow,,2012,3.2,6144,6345,201
31145,NE,Red Willow,,2013,2.9,6233,6418,185
31145,NE,Red Willow,,2014,2.6,6131,6292,161
31145,NE,Red Willow,,2015,2.6,5965,6126,161
31145,NE,Red Willow,,2016,2.8,5840,6009,169
31145,NE,Red Willow,,2017,2.6,5743,5894,151
31145,NE,Red Willow,,2018,2.4,5749,5892,143
31145,NE,Red Willow,,2019,2.7,5761,5921,160
31145,NE,Red Willow,,2020,3.2,5700,5886,186
31145,NE,Red Willow,,2021,2,5752,5869,117
31147,NE,Richardson,,2007,4,4101,4273,172
31147,NE,Richardson,,2008,4.3,4027,4208,181
31147,NE,Richardson,,2009,6.1,3949,4204,255
31147,NE,Richardson,,2010,6.3,4049,4323,274
31147,NE,Richardson,,2011,6,4140,4406,266
31147,NE,Richardson,,2012,5,4177,4396,219
31147,NE,Richardson,,2013,4.4,4160,4351,191
31147,NE,Richardson,,2014,3.6,4124,4279,155
31147,NE,Richardson,,2015,3.2,4179,4317,138
31147,NE,Richardson,,2016,3.2,4124,4261,137
31147,NE,Richardson,,2017,3.3,4111,4251,140
31147,NE,Richardson,,2018,3.1,4149,4281,132
31147,NE,Richardson,,2019,3.2,4156,4292,136
31147,NE,Richardson,,2020,3.2,4104,4239,135
31147,NE,Richardson,,2021,2.4,4192,4294,102
31149,NE,Rock,,2007,2.5,855,877,22
31149,NE,Rock,,2008,2.7,822,845,23
31149,NE,Rock,,2009,3,848,874,26
31149,NE,Rock,,2010,2.9,864,890,26
31149,NE,Rock,,2011,2.7,876,900,24
31149,NE,Rock,,2012,2.5,857,879,22
31149,NE,Rock,,2013,3.1,857,884,27
31149,NE,Rock,,2014,2.6,861,884,23
31149,NE,Rock,,2015,2.7,839,862,23
31149,NE,Rock,,2016,2.6,873,896,23
31149,NE,Rock,,2017,2.6,889,913,24
31149,NE,Rock,,2018,2.5,874,896,22
31149,NE,Rock,,2019,3.1,854,881,27
31149,NE,Rock,,2020,2,871,889,18
31149,NE,Rock,,2021,1.3,878,890,12
31151,NE,Saline,,2007,2.6,8101,8318,217
31151,NE,Saline,,2008,3.3,8104,8382,278
31151,NE,Saline,,2009,4.6,7930,8311,381
31151,NE,Saline,,2010,4.8,6930,7277,347
31151,NE,Saline,,2011,4.7,7000,7346,346
31151,NE,Saline,,2012,4.2,7037,7348,311
31151,NE,Saline,,2013,4.2,7067,7374,307
31151,NE,Saline,,2014,3.4,6990,7237,247
31151,NE,Saline,,2015,2.9,7094,7308,214
31151,NE,Saline,,2016,3.1,7164,7391,227
31151,NE,Saline,,2017,3.1,7231,7463,232
31151,NE,Saline,,2018,3.1,7273,7504,231
31151,NE,Saline,,2019,3.3,7232,7475,243
31151,NE,Saline,,2020,3.5,7116,7376,260
31151,NE,Saline,,2021,2.3,7134,7302,168
31153,NE,Sarpy,,2007,2.9,74627,76827,2200
31153,NE,Sarpy,,2008,3.1,76584,79074,2490
31153,NE,Sarpy,,2009,4.7,75677,79378,3701
31153,NE,Sarpy,,2010,4.5,80959,84801,3842
31153,NE,Sarpy,,2011,4.2,82715,86383,3668
31153,NE,Sarpy,,2012,3.8,84588,87890,3302
31153,NE,Sarpy,,2013,3.5,85854,88979,3125
31153,NE,Sarpy,,2014,3.1,87108,89873,2765
31153,NE,Sarpy,,2015,2.8,88454,91004,2550
31153,NE,Sarpy,,2016,2.9,89882,92568,2686
31153,NE,Sarpy,,2017,2.8,91389,94047,2658
31153,NE,Sarpy,,2018,2.8,93301,95959,2658
31153,NE,Sarpy,,2019,2.9,95644,98488,2844
31153,NE,Sarpy,,2020,4,93989,97907,3918
31153,NE,Sarpy,,2021,2.4,96195,98538,2343
31155,NE,Saunders,,2007,3,10629,10962,333
31155,NE,Saunders,,2008,3.5,10560,10943,383
31155,NE,Saunders,,2009,5,10240,10784,544
31155,NE,Saunders,,2010,4.9,10618,11164,546
31155,NE,Saunders,,2011,4.6,10691,11206,515
31155,NE,Saunders,,2012,4.1,10706,11167,461
31155,NE,Saunders,,2013,3.9,10700,11139,439
31155,NE,Saunders,,2014,3.5,10644,11025,381
31155,NE,Saunders,,2015,3.1,10634,10970,336
31155,NE,Saunders,,2016,3.1,10600,10935,335
31155,NE,Saunders,,2017,2.8,10627,10937,310
31155,NE,Saunders,,2018,2.8,10806,11122,316
31155,NE,Saunders,,2019,2.8,11060,11376,316
31155,NE,Saunders,,2020,3.6,10977,11383,406
31155,NE,Saunders,,2021,2.2,11229,11484,255
31157,NE,Scotts Bluff,,2007,2.9,18926,19492,566
31157,NE,Scotts Bluff,,2008,3.6,18777,19480,703
31157,NE,Scotts Bluff,,2009,5.2,18603,19616,1013
31157,NE,Scotts Bluff,,2010,5.6,18103,19176,1073
31157,NE,Scotts Bluff,,2011,5,18250,19216,966
31157,NE,Scotts Bluff,,2012,4.6,18316,19192,876
31157,NE,Scotts Bluff,,2013,4.1,18309,19093,784
31157,NE,Scotts Bluff,,2014,3.6,18088,18764,676
31157,NE,Scotts Bluff,,2015,3.4,18102,18734,632
31157,NE,Scotts Bluff,,2016,3.5,18290,18951,661
31157,NE,Scotts Bluff,,2017,3.5,17913,18557,644
31157,NE,Scotts Bluff,,2018,3.3,17969,18586,617
31157,NE,Scotts Bluff,,2019,3.7,17796,18475,679
31157,NE,Scotts Bluff,,2020,4.1,17534,18278,744
31157,NE,Scotts Bluff,,2021,2.8,17654,18154,500
31159,NE,Seward,,2007,2.7,8658,8897,239
31159,NE,Seward,,2008,3.2,8762,9048,286
31159,NE,Seward,,2009,4.1,8444,8806,362
31159,NE,Seward,,2010,4.1,8395,8752,357
31159,NE,Seward,,2011,3.9,8432,8770,338
31159,NE,Seward,,2012,3.4,8633,8939,306
31159,NE,Seward,,2013,3.6,8668,8992,324
31159,NE,Seward,,2014,3.1,8581,8851,270
31159,NE,Seward,,2015,2.9,8478,8731,253
31159,NE,Seward,,2016,2.9,8551,8802,251
31159,NE,Seward,,2017,2.7,8458,8695,237
31159,NE,Seward,,2018,2.7,8653,8890,237
31159,NE,Seward,,2019,2.9,8721,8985,264
31159,NE,Seward,,2020,4,8492,8847,355
31159,NE,Seward,,2021,2.5,8636,8854,218
31161,NE,Sheridan,,2007,2.6,3028,3109,81
31161,NE,Sheridan,,2008,2.7,2973,3055,82
31161,NE,Sheridan,,2009,3.9,2983,3105,122
31161,NE,Sheridan,,2010,3.6,2715,2817,102
31161,NE,Sheridan,,2011,3.6,2731,2833,102
31161,NE,Sheridan,,2012,3.5,2704,2801,97
31161,NE,Sheridan,,2013,3.2,2703,2792,89
31161,NE,Sheridan,,2014,2.6,2710,2782,72
31161,NE,Sheridan,,2015,2.7,2667,2741,74
31161,NE,Sheridan,,2016,2.8,2675,2753,78
31161,NE,Sheridan,,2017,2.7,2666,2739,73
31161,NE,Sheridan,,2018,2.6,2635,2705,70
31161,NE,Sheridan,,2019,2.7,2634,2708,74
31161,NE,Sheridan,,2020,2.3,2671,2735,64
31161,NE,Sheridan,,2021,1.8,2705,2755,50
31163,NE,Sherman,,2007,2.6,1860,1910,50
31163,NE,Sherman,,2008,2.7,1880,1932,52
31163,NE,Sherman,,2009,3.2,1936,2000,64
31163,NE,Sherman,,2010,4.1,1656,1727,71
31163,NE,Sherman,,2011,4.3,1683,1759,76
31163,NE,Sherman,,2012,3.7,1683,1747,64
31163,NE,Sherman,,2013,3.3,1678,1735,57
31163,NE,Sherman,,2014,3.3,1671,1728,57
31163,NE,Sherman,,2015,2.9,1665,1715,50
31163,NE,Sherman,,2016,3.2,1671,1726,55
31163,NE,Sherman,,2017,2.9,1659,1709,50
31163,NE,Sherman,,2018,2.7,1665,1711,46
31163,NE,Sherman,,2019,3.2,1641,1696,55
31163,NE,Sherman,,2020,3.1,1626,1678,52
31163,NE,Sherman,,2021,2.1,1666,1701,35
31165,NE,Sioux,,2007,2.7,688,707,19
31165,NE,Sioux,,2008,3.2,691,714,23
31165,NE,Sioux,,2009,3.4,707,732,25
31165,NE,Sioux,,2010,3.8,802,834,32
31165,NE,Sioux,,2011,3.4,815,844,29
31165,NE,Sioux,,2012,3.5,811,840,29
31165,NE,Sioux,,2013,3.2,777,803,26
31165,NE,Sioux,,2014,2.5,787,807,20
31165,NE,Sioux,,2015,2.5,771,791,20
31165,NE,Sioux,,2016,2.7,767,788,21
31165,NE,Sioux,,2017,3,739,762,23
31165,NE,Sioux,,2018,2.7,729,749,20
31165,NE,Sioux,,2019,2.8,730,751,21
31165,NE,Sioux,,2020,2.2,750,767,17
31165,NE,Sioux,,2021,1.8,756,770,14
31167,NE,Stanton,,2007,2.9,3452,3555,103
31167,NE,Stanton,,2008,2.7,3411,3506,95
31167,NE,Stanton,,2009,4.1,3333,3477,144
31167,NE,Stanton,,2010,4.2,3430,3579,149
31167,NE,Stanton,,2011,3.7,3494,3630,136
31167,NE,Stanton,,2012,3.4,3543,3667,124
31167,NE,Stanton,,2013,3.3,3561,3681,120
31167,NE,Stanton,,2014,2.8,3479,3578,99
31167,NE,Stanton,,2015,2.5,3429,3518,89
31167,NE,Stanton,,2016,2.6,3370,3460,90
31167,NE,Stanton,,2017,2.8,3409,3509,100
31167,NE,Stanton,,2018,2.5,3427,3516,89
31167,NE,Stanton,,2019,2.6,3460,3551,91
31167,NE,Stanton,,2020,3.2,3441,3556,115
31167,NE,Stanton,,2021,2.1,3544,3620,76
31169,NE,Thayer,,2007,2.6,2790,2865,75
31169,NE,Thayer,,2008,3.2,2725,2814,89
31169,NE,Thayer,,2009,4.3,2670,2789,119
31169,NE,Thayer,,2010,3.9,2691,2799,108
31169,NE,Thayer,,2011,3.3,2831,2927,96
31169,NE,Thayer,,2012,3,2913,3003,90
31169,NE,Thayer,,2013,2.7,2965,3048,83
31169,NE,Thayer,,2014,2.5,2957,3034,77
31169,NE,Thayer,,2015,2.4,2908,2978,70
31169,NE,Thayer,,2016,2.4,2848,2919,71
31169,NE,Thayer,,2017,2.3,2823,2889,66
31169,NE,Thayer,,2018,2.3,2816,2882,66
31169,NE,Thayer,,2019,2.6,2742,2815,73
31169,NE,Thayer,,2020,2.7,2715,2790,75
31169,NE,Thayer,,2021,1.7,2644,2690,46
31171,NE,Thomas,,2007,3.4,364,377,13
31171,NE,Thomas,,2008,3.8,358,372,14
31171,NE,Thomas,,2009,4.5,342,358,16
31171,NE,Thomas,,2010,4.8,376,395,19
31171,NE,Thomas,,2011,5.2,404,426,22
31171,NE,Thomas,,2012,3.8,410,426,16
31171,NE,Thomas,,2013,3.8,436,453,17
31171,NE,Thomas,,2014,3.5,413,428,15
31171,NE,Thomas,,2015,3,424,437,13
31171,NE,Thomas,,2016,3.3,436,451,15
31171,NE,Thomas,,2017,3.2,426,440,14
31171,NE,Thomas,,2018,2.9,428,441,13
31171,NE,Thomas,,2019,3.7,416,432,16
31171,NE,Thomas,,2020,4,413,430,17
31171,NE,Thomas,,2021,2.6,419,430,11
31173,NE,Thurston,,2007,6.4,2795,2987,192
31173,NE,Thurston,,2008,6.6,2789,2985,196
31173,NE,Thurston,,2009,10.5,2817,3149,332
31173,NE,Thurston,,2010,9.7,2756,3053,297
31173,NE,Thurston,,2011,10.2,2805,3124,319
31173,NE,Thurston,,2012,8.5,2869,3135,266
31173,NE,Thurston,,2013,7.5,2860,3091,231
31173,NE,Thurston,,2014,6,2839,3021,182
31173,NE,Thurston,,2015,5.3,2824,2982,158
31173,NE,Thurston,,2016,4.8,2852,2995,143
31173,NE,Thurston,,2017,5,2889,3042,153
31173,NE,Thurston,,2018,4.2,2881,3006,125
31173,NE,Thurston,,2019,4.5,2943,3082,139
31173,NE,Thurston,,2020,5.1,2967,3125,158
31173,NE,Thurston,,2021,3.3,3088,3195,107
31175,NE,Valley,,2007,2.3,2513,2573,60
31175,NE,Valley,,2008,2.7,2501,2571,70
31175,NE,Valley,,2009,3.3,2477,2562,85
31175,NE,Valley,,2010,4.5,2043,2139,96
31175,NE,Valley,,2011,4,2063,2149,86
31175,NE,Valley,,2012,3.4,2075,2148,73
31175,NE,Valley,,2013,3.2,2067,2136,69
31175,NE,Valley,,2014,3,2056,2119,63
31175,NE,Valley,,2015,2.8,2013,2071,58
31175,NE,Valley,,2016,2.8,2045,2104,59
31175,NE,Valley,,2017,2.7,2073,2130,57
31175,NE,Valley,,2018,2.9,2040,2102,62
31175,NE,Valley,,2019,3.2,2085,2154,69
31175,NE,Valley,,2020,2.8,2082,2142,60
31175,NE,Valley,,2021,2.1,2075,2119,44
31177,NE,Washington,,2007,2.8,10958,11271,313
31177,NE,Washington,,2008,3.1,10888,11231,343
31177,NE,Washington,,2009,4.6,10495,11003,508
31177,NE,Washington,,2010,4.7,10692,11217,525
31177,NE,Washington,,2011,4.4,10755,11245,490
31177,NE,Washington,,2012,3.7,10795,11206,411
31177,NE,Washington,,2013,3.6,10704,11103,399
31177,NE,Washington,,2014,3.2,10696,11050,354
31177,NE,Washington,,2015,3,10651,10980,329
31177,NE,Washington,,2016,3.2,10813,11169,356
31177,NE,Washington,,2017,3.1,10895,11248,353
31177,NE,Washington,,2018,2.9,10895,11219,324
31177,NE,Washington,,2019,2.9,11040,11370,330
31177,NE,Washington,,2020,3.6,10865,11268,403
31177,NE,Washington,,2021,2.3,11102,11364,262
31179,NE,Wayne,,2007,2.5,5173,5306,133
31179,NE,Wayne,,2008,2.8,5045,5191,146
31179,NE,Wayne,,2009,3.9,4967,5171,204
31179,NE,Wayne,,2010,3.9,5443,5662,219
31179,NE,Wayne,,2011,3.5,5416,5610,194
31179,NE,Wayne,,2012,3.1,5538,5717,179
31179,NE,Wayne,,2013,3.1,5495,5671,176
31179,NE,Wayne,,2014,2.8,5416,5571,155
31179,NE,Wayne,,2015,2.6,5421,5563,142
31179,NE,Wayne,,2016,2.7,5506,5656,150
31179,NE,Wayne,,2017,2.4,5568,5706,138
31179,NE,Wayne,,2018,2.5,5603,5747,144
31179,NE,Wayne,,2019,2.6,5680,5832,152
31179,NE,Wayne,,2020,2.8,5557,5715,158
31179,NE,Wayne,,2021,1.9,5627,5737,110
31181,NE,Webster,,2007,3.2,1746,1804,58
31181,NE,Webster,,2008,3.3,1728,1787,59
31181,NE,Webster,,2009,3.9,1736,1806,70
31181,NE,Webster,,2010,4.9,1620,1704,84
31181,NE,Webster,,2011,4.6,1656,1736,80
31181,NE,Webster,,2012,3.6,1681,1743,62
31181,NE,Webster,,2013,3.8,1675,1741,66
31181,NE,Webster,,2014,3.4,1672,1730,58
31181,NE,Webster,,2015,3.5,1671,1732,61
31181,NE,Webster,,2016,3.1,1668,1722,54
31181,NE,Webster,,2017,3,1628,1678,50
31181,NE,Webster,,2018,2.9,1614,1662,48
31181,NE,Webster,,2019,3.4,1633,1691,58
31181,NE,Webster,,2020,3.7,1602,1663,61
31181,NE,Webster,,2021,2,1626,1660,34
31183,NE,Wheeler,,2007,2.9,406,418,12
31183,NE,Wheeler,,2008,2.3,475,486,11
31183,NE,Wheeler,,2009,3.7,443,460,17
31183,NE,Wheeler,,2010,3.9,494,514,20
31183,NE,Wheeler,,2011,3.2,507,524,17
31183,NE,Wheeler,,2012,3.3,504,521,17
31183,NE,Wheeler,,2013,3.2,507,524,17
31183,NE,Wheeler,,2014,2.9,543,559,16
31183,NE,Wheeler,,2015,2.3,551,564,13
31183,NE,Wheeler,,2016,2.1,557,569,12
31183,NE,Wheeler,,2017,2.2,576,589,13
31183,NE,Wheeler,,2018,2.4,565,579,14
31183,NE,Wheeler,,2019,2.6,558,573,15
31183,NE,Wheeler,,2020,1.8,559,569,10
31183,NE,Wheeler,,2021,1.2,556,563,7
31185,NE,York,,2007,2.7,7447,7651,204
31185,NE,York,,2008,3.6,6780,7034,254
31185,NE,York,,2009,4.9,6706,7051,345
31185,NE,York,,2010,4.7,7051,7401,350
31185,NE,York,,2011,4.3,7191,7518,327
31185,NE,York,,2012,3.6,7312,7585,273
31185,NE,York,,2013,3.5,7218,7481,263
31185,NE,York,,2014,3.1,7167,7400,233
31185,NE,York,,2015,2.9,7155,7368,213
31185,NE,York,,2016,2.7,7166,7365,199
31185,NE,York,,2017,2.6,7204,7395,191
31185,NE,York,,2018,2.6,7188,7378,190
31185,NE,York,,2019,2.6,7189,7384,195
31185,NE,York,,2020,3.3,7086,7327,241
31185,NE,York,,2021,1.9,7195,7338,143
32000,NV,Nevada,,2007,4.6,1282414,1344209,61795
32000,NV,Nevada,,2008,6.9,1278789,1373107,94318
32000,NV,Nevada,,2009,11.7,1207052,1367367,160315
32000,NV,Nevada,,2010,13.8,1171879,1358860,186981
32000,NV,Nevada,,2011,13.3,1179653,1360791,181138
32000,NV,Nevada,,2012,11.6,1207733,1366208,158475
32000,NV,Nevada,,2013,10,1234021,1370727,136706
32000,NV,Nevada,,2014,8.2,1267424,1380084,112660
32000,NV,Nevada,,2015,6.8,1301094,1396761,95667
32000,NV,Nevada,,2016,5.8,1332390,1414233,81843
32000,NV,Nevada,,2017,5,1372022,1444262,72240
32000,NV,Nevada,,2018,4.4,1427371,1492831,65460
32000,NV,Nevada,,2019,4,1479777,1541772,61995
32000,NV,Nevada,,2020,13.5,1299640,1502848,203208
32000,NV,Nevada,,2021,7.2,1395939,1504761,108822
32001,NV,Churchill,,2007,4.4,12702,13287,585
32001,NV,Churchill,,2008,6.1,12753,13584,831
32001,NV,Churchill,,2009,8.9,12447,13670,1223
32001,NV,Churchill,,2010,12.5,9817,11223,1406
32001,NV,Churchill,,2011,12.8,9716,11139,1423
32001,NV,Churchill,,2012,11.4,9768,11030,1262
32001,NV,Churchill,,2013,9.8,9768,10832,1064
32001,NV,Churchill,,2014,8,9664,10505,841
32001,NV,Churchill,,2015,7.1,9545,10276,731
32001,NV,Churchill,,2016,5.6,9724,10304,580
32001,NV,Churchill,,2017,4.5,9978,10445,467
32001,NV,Churchill,,2018,3.8,10528,10945,417
32001,NV,Churchill,,2019,3.6,10663,11065,402
32001,NV,Churchill,,2020,5.7,10411,11045,634
32001,NV,Churchill,,2021,3.5,10839,11230,391
32003,NV,Clark,,2007,4.6,916771,960953,44182
32003,NV,Clark,,2008,6.8,919898,987088,67190
32003,NV,Clark,,2009,11.9,863864,980724,116860
32003,NV,Clark,,2010,14,846856,984712,137856
32003,NV,Clark,,2011,13.5,852943,986302,133359
32003,NV,Clark,,2012,11.7,875964,992000,116036
32003,NV,Clark,,2013,10,898037,998095,100058
32003,NV,Clark,,2014,8.2,926938,1010053,83115
32003,NV,Clark,,2015,6.9,956238,1027290,71052
32003,NV,Clark,,2016,5.9,978799,1040292,61493
32003,NV,Clark,,2017,5.2,1005370,1060593,55223
32003,NV,Clark,,2018,4.6,1043615,1093988,50373
32003,NV,Clark,,2019,4.2,1084237,1131564,47327
32003,NV,Clark,,2020,15.5,932852,1104388,171536
32003,NV,Clark,,2021,8.3,1009020,1100264,91244
32005,NV,Douglas,,2007,5,21703,22834,1131
32005,NV,Douglas,,2008,7.6,21056,22781,1725
32005,NV,Douglas,,2009,12,19918,22626,2708
32005,NV,Douglas,,2010,14,19892,23127,3235
32005,NV,Douglas,,2011,13.5,19919,23026,3107
32005,NV,Douglas,,2012,11.9,19919,22609,2690
32005,NV,Douglas,,2013,10.1,20199,22466,2267
32005,NV,Douglas,,2014,8.3,20300,22128,1828
32005,NV,Douglas,,2015,6.8,20730,22244,1514
32005,NV,Douglas,,2016,5.7,20810,22069,1259
32005,NV,Douglas,,2017,4.8,21131,22201,1070
32005,NV,Douglas,,2018,4.2,21798,22747,949
32005,NV,Douglas,,2019,4,22283,23218,935
32005,NV,Douglas,,2020,8.9,20130,22104,1974
32005,NV,Douglas,,2021,4.5,21046,22047,1001
32007,NV,Elko,,2007,3.3,25793,26685,892
32007,NV,Elko,,2008,4.4,25738,26911,1173
32007,NV,Elko,,2009,6.5,25900,27703,1803
32007,NV,Elko,,2010,7.9,24433,26539,2106
32007,NV,Elko,,2011,7.4,25833,27895,2062
32007,NV,Elko,,2012,6.6,26932,28840,1908
32007,NV,Elko,,2013,6.4,26670,28506,1836
32007,NV,Elko,,2014,5.8,26024,27626,1602
32007,NV,Elko,,2015,5.2,25097,26478,1381
32007,NV,Elko,,2016,4.5,25497,26709,1212
32007,NV,Elko,,2017,3.7,25588,26567,979
32007,NV,Elko,,2018,3.1,26419,27260,841
32007,NV,Elko,,2019,3,26491,27322,831
32007,NV,Elko,,2020,5.9,24551,26086,1535
32007,NV,Elko,,2021,3.3,24939,25803,864
32009,NV,Esmeralda,,2007,3.1,462,477,15
32009,NV,Esmeralda,,2008,5.1,465,490,25
32009,NV,Esmeralda,,2009,7.3,458,494,36
32009,NV,Esmeralda,,2010,9.9,344,382,38
32009,NV,Esmeralda,,2011,8.2,383,417,34
32009,NV,Esmeralda,,2012,7.2,438,472,34
32009,NV,Esmeralda,,2013,5,510,537,27
32009,NV,Esmeralda,,2014,4.5,511,535,24
32009,NV,Esmeralda,,2015,4.4,497,520,23
32009,NV,Esmeralda,,2016,4.7,487,511,24
32009,NV,Esmeralda,,2017,4.2,461,481,20
32009,NV,Esmeralda,,2018,5,400,421,21
32009,NV,Esmeralda,,2019,3.7,443,460,17
32009,NV,Esmeralda,,2020,5.3,395,417,22
32009,NV,Esmeralda,,2021,3.8,410,426,16
32011,NV,Eureka,,2007,4.3,782,817,35
32011,NV,Eureka,,2008,5.2,814,859,45
32011,NV,Eureka,,2009,6.9,843,905,62
32011,NV,Eureka,,2010,8,937,1018,81
32011,NV,Eureka,,2011,7.1,986,1061,75
32011,NV,Eureka,,2012,6.3,1022,1091,69
32011,NV,Eureka,,2013,6.3,1012,1080,68
32011,NV,Eureka,,2014,6.1,954,1016,62
32011,NV,Eureka,,2015,5.9,928,986,58
32011,NV,Eureka,,2016,4.6,935,980,45
32011,NV,Eureka,,2017,3,1005,1036,31
32011,NV,Eureka,,2018,2.5,1059,1086,27
32011,NV,Eureka,,2019,2.5,1072,1099,27
32011,NV,Eureka,,2020,3.5,983,1019,36
32011,NV,Eureka,,2021,2.6,1026,1053,27
32013,NV,Humboldt,,2007,3.6,7746,8039,293
32013,NV,Humboldt,,2008,5.1,7795,8210,415
32013,NV,Humboldt,,2009,7.6,8025,8682,657
32013,NV,Humboldt,,2010,8.8,7658,8394,736
32013,NV,Humboldt,,2011,8,7953,8643,690
32013,NV,Humboldt,,2012,6.8,8426,9045,619
32013,NV,Humboldt,,2013,6.6,8400,8997,597
32013,NV,Humboldt,,2014,6.7,7953,8525,572
32013,NV,Humboldt,,2015,6.1,7694,8191,497
32013,NV,Humboldt,,2016,5.6,7545,7990,445
32013,NV,Humboldt,,2017,4.2,7648,7987,339
32013,NV,Humboldt,,2018,3.3,7739,8005,266
32013,NV,Humboldt,,2019,3,8089,8336,247
32013,NV,Humboldt,,2020,5,7603,8005,402
32013,NV,Humboldt,,2021,3.4,7879,8158,279
32015,NV,Lander,,2007,3.3,3307,3420,113
32015,NV,Lander,,2008,4.5,3505,3669,164
32015,NV,Lander,,2009,6,3807,4052,245
32015,NV,Lander,,2010,9.9,2742,3042,300
32015,NV,Lander,,2011,9.1,2900,3192,292
32015,NV,Lander,,2012,7.8,3142,3409,267
32015,NV,Lander,,2013,7.7,3221,3488,267
32015,NV,Lander,,2014,6.9,3064,3292,228
32015,NV,Lander,,2015,6.8,2975,3193,218
32015,NV,Lander,,2016,6.3,2909,3106,197
32015,NV,Lander,,2017,4.5,2945,3085,140
32015,NV,Lander,,2018,3.5,3012,3121,109
32015,NV,Lander,,2019,3.2,3131,3235,104
32015,NV,Lander,,2020,4.9,2974,3128,154
32015,NV,Lander,,2021,3.6,3066,3180,114
32017,NV,Lincoln,,2007,4.3,1665,1740,75
32017,NV,Lincoln,,2008,5.7,1741,1846,105
32017,NV,Lincoln,,2009,9.2,1542,1699,157
32017,NV,Lincoln,,2010,10.8,1785,2002,217
32017,NV,Lincoln,,2011,11.4,1826,2060,234
32017,NV,Lincoln,,2012,10.8,1863,2089,226
32017,NV,Lincoln,,2013,9.9,1802,2001,199
32017,NV,Lincoln,,2014,7.6,1787,1934,147
32017,NV,Lincoln,,2015,6.1,1802,1920,118
32017,NV,Lincoln,,2016,5.4,1863,1969,106
32017,NV,Lincoln,,2017,4.8,1902,1997,95
32017,NV,Lincoln,,2018,4.3,1961,2049,88
32017,NV,Lincoln,,2019,4,2051,2136,85
32017,NV,Lincoln,,2020,5.1,1922,2025,103
32017,NV,Lincoln,,2021,3.4,2078,2151,73
32019,NV,Lyon,,2007,6.5,21047,22518,1471
32019,NV,Lyon,,2008,10,20517,22800,2283
32019,NV,Lyon,,2009,16,19531,23245,3714
32019,NV,Lyon,,2010,17.8,18858,22954,4096
32019,NV,Lyon,,2011,17.1,18857,22753,3896
32019,NV,Lyon,,2012,15.3,18995,22423,3428
32019,NV,Lyon,,2013,13.2,19274,22209,2935
32019,NV,Lyon,,2014,10.7,19879,22258,2379
32019,NV,Lyon,,2015,9.6,19251,21287,2036
32019,NV,Lyon,,2016,7.6,19500,21106,1606
32019,NV,Lyon,,2017,6,20190,21479,1289
32019,NV,Lyon,,2018,5.3,20999,22172,1173
32019,NV,Lyon,,2019,4.9,22069,23210,1141
32019,NV,Lyon,,2020,8.9,20617,22635,2018
32019,NV,Lyon,,2021,5.2,22197,23425,1228
32021,NV,Mineral,,2007,6.4,2116,2260,144
32021,NV,Mineral,,2008,7.6,2225,2409,184
32021,NV,Mineral,,2009,9,2167,2381,214
32021,NV,Mineral,,2010,15.4,1866,2206,340
32021,NV,Mineral,,2011,14.4,1860,2174,314
32021,NV,Mineral,,2012,14.1,1627,1893,266
32021,NV,Mineral,,2013,13,1592,1829,237
32021,NV,Mineral,,2014,11.2,1508,1698,190
32021,NV,Mineral,,2015,10.2,1448,1613,165
32021,NV,Mineral,,2016,6.4,1866,1994,128
32021,NV,Mineral,,2017,5.5,1856,1963,107
32021,NV,Mineral,,2018,5.1,1856,1956,100
32021,NV,Mineral,,2019,4,2004,2087,83
32021,NV,Mineral,,2020,5.8,1985,2107,122
32021,NV,Mineral,,2021,3.8,1999,2078,79
32023,NV,Nye,,2007,6.6,16810,18006,1196
32023,NV,Nye,,2008,10,15990,17760,1770
32023,NV,Nye,,2009,14.4,15452,18042,2590
32023,NV,Nye,,2010,17.6,13805,16746,2941
32023,NV,Nye,,2011,17.1,13915,16781,2866
32023,NV,Nye,,2012,14.9,14128,16611,2483
32023,NV,Nye,,2013,12.6,14199,16244,2045
32023,NV,Nye,,2014,10,14434,16035,1601
32023,NV,Nye,,2015,8.9,14399,15802,1403
32023,NV,Nye,,2016,7.4,14721,15905,1184
32023,NV,Nye,,2017,6.4,14962,15988,1026
32023,NV,Nye,,2018,5.6,15659,16581,922
32023,NV,Nye,,2019,5.3,16391,17305,914
32023,NV,Nye,,2020,10.2,15604,17371,1767
32023,NV,Nye,,2021,6.1,16230,17290,1060
32027,NV,Pershing,,2007,5,2390,2517,127
32027,NV,Pershing,,2008,7.2,2356,2538,182
32027,NV,Pershing,,2009,10.1,2366,2632,266
32027,NV,Pershing,,2010,11.1,2064,2321,257
32027,NV,Pershing,,2011,11,2185,2455,270
32027,NV,Pershing,,2012,10,2329,2589,260
32027,NV,Pershing,,2013,9.3,2357,2598,241
32027,NV,Pershing,,2014,7.5,2343,2534,191
32027,NV,Pershing,,2015,7,2259,2429,170
32027,NV,Pershing,,2016,6,2293,2439,146
32027,NV,Pershing,,2017,4.6,2404,2520,116
32027,NV,Pershing,,2018,4,2458,2561,103
32027,NV,Pershing,,2019,4,2503,2608,105
32027,NV,Pershing,,2020,4.8,2436,2559,123
32027,NV,Pershing,,2021,3.6,2539,2633,94
32029,NV,Storey,,2007,5,2300,2422,122
32029,NV,Storey,,2008,7.1,2304,2480,176
32029,NV,Storey,,2009,12.2,2197,2503,306
32029,NV,Storey,,2010,17,1673,2015,342
32029,NV,Storey,,2011,16,1644,1958,314
32029,NV,Storey,,2012,13.8,1641,1904,263
32029,NV,Storey,,2013,12,1657,1883,226
32029,NV,Storey,,2014,9.3,1660,1831,171
32029,NV,Storey,,2015,7.5,1714,1853,139
32029,NV,Storey,,2016,6.4,1770,1891,121
32029,NV,Storey,,2017,5,1803,1898,95
32029,NV,Storey,,2018,4.2,1893,1977,84
32029,NV,Storey,,2019,3.8,1975,2054,79
32029,NV,Storey,,2020,8.5,1838,2009,171
32029,NV,Storey,,2021,4.6,1955,2050,95
32031,NV,Washoe,,2007,4.4,214900,224730,9830
32031,NV,Washoe,,2008,7,210215,225931,15716
32031,NV,Washoe,,2009,11.5,197997,223760,25763
32031,NV,Washoe,,2010,13.1,191887,220840,28953
32031,NV,Washoe,,2011,12.8,191407,219619,28212
32031,NV,Washoe,,2012,11.5,194330,219463,25133
32031,NV,Washoe,,2013,9.8,198371,219924,21553
32031,NV,Washoe,,2014,7.8,203367,220570,17203
32031,NV,Washoe,,2015,6.3,209279,223392,14113
32031,NV,Washoe,,2016,5.1,216417,227991,11574
32031,NV,Washoe,,2017,4.1,226656,236461,9805
32031,NV,Washoe,,2018,3.5,239242,247905,8663
32031,NV,Washoe,,2019,3.3,246719,255215,8496
32031,NV,Washoe,,2020,8.2,227627,247852,20225
32031,NV,Washoe,,2021,4.3,241797,252682,10885
32033,NV,White Pine,,2007,3.7,4618,4796,178
32033,NV,White Pine,,2008,4.8,4591,4823,232
32033,NV,White Pine,,2009,7.2,4649,5010,361
32033,NV,White Pine,,2010,9.3,4207,4636,429
32033,NV,White Pine,,2011,8.9,4593,5041,448
32033,NV,White Pine,,2012,7.9,4620,5019,399
32033,NV,White Pine,,2013,7.6,4455,4824,369
32033,NV,White Pine,,2014,6.3,4492,4793,301
32033,NV,White Pine,,2015,5.5,4429,4685,256
32033,NV,White Pine,,2016,4.7,4238,4448,210
32033,NV,White Pine,,2017,4.1,4244,4424,180
32033,NV,White Pine,,2018,3.5,4385,4546,161
32033,NV,White Pine,,2019,3,4530,4672,142
32033,NV,White Pine,,2020,4.2,4350,4542,192
32033,NV,White Pine,,2021,3,4487,4628,141
32510,NV,Carson,,2007,4.9,27299,28705,1406
32510,NV,Carson,,2008,7.3,26826,28927,2101
32510,NV,Carson,,2009,11.5,25892,29243,3351
32510,NV,Carson,,2010,13.7,23056,26706,3650
32510,NV,Carson,,2011,13.5,22734,26275,3541
32510,NV,Carson,,2012,12.2,22588,25720,3132
32510,NV,Carson,,2013,10.8,22498,25214,2716
32510,NV,Carson,,2014,8.9,22548,24752,2204
32510,NV,Carson,,2015,7.3,22808,24601,1793
32510,NV,Carson,,2016,6.2,23017,24529,1512
32510,NV,Carson,,2017,5,23882,25143,1261
32510,NV,Carson,,2018,4.6,24349,25512,1163
32510,NV,Carson,,2019,4.1,25124,26185,1061
32510,NV,Carson,,2020,8.6,23362,25557,2195
32510,NV,Carson,,2021,4.8,24434,25665,1231
33000,NH,New Hampshire,,2007,3.5,712023,737928,25905
33000,NH,New Hampshire,,2008,3.7,715076,742881,27805
33000,NH,New Hampshire,,2009,6.1,694362,739802,45440
33000,NH,New Hampshire,,2010,6.1,694132,739340,45208
33000,NH,New Hampshire,,2011,5.5,696591,736785,40194
33000,NH,New Hampshire,,2012,5.4,700448,740796,40348
33000,NH,New Hampshire,,2013,5.3,704023,743036,39013
33000,NH,New Hampshire,,2014,4.3,711740,743756,32016
33000,NH,New Hampshire,,2015,3.4,720832,746317,25485
33000,NH,New Hampshire,,2016,2.9,731002,752478,21476
33000,NH,New Hampshire,,2017,2.8,736918,758133,21215
33000,NH,New Hampshire,,2018,2.6,747415,767629,20214
33000,NH,New Hampshire,,2019,2.6,756267,776471,20204
33000,NH,New Hampshire,,2020,6.7,708566,759770,51204
33000,NH,New Hampshire,,2021,3.5,728940,755422,26482
33001,NH,Belknap,,2007,3.6,31252,32406,1154
33001,NH,Belknap,,2008,4,31354,32646,1292
33001,NH,Belknap,,2009,6.6,30220,32342,2122
33001,NH,Belknap,,2010,6.7,30166,32321,2155
33001,NH,Belknap,,2011,5.6,30286,32069,1783
33001,NH,Belknap,,2012,5.4,30321,32041,1720
33001,NH,Belknap,,2013,5.2,30410,32066,1656
33001,NH,Belknap,,2014,4.2,30359,31688,1329
33001,NH,Belknap,,2015,3.4,30580,31646,1066
33001,NH,Belknap,,2016,2.8,30536,31427,891
33001,NH,Belknap,,2017,2.8,30407,31267,860
33001,NH,Belknap,,2018,2.6,30638,31463,825
33001,NH,Belknap,,2019,2.6,30879,31696,817
33001,NH,Belknap,,2020,7,28750,30922,2172
33001,NH,Belknap,,2021,3.7,29882,31024,1142
33003,NH,Carroll,,2007,3.4,24620,25495,875
33003,NH,Carroll,,2008,3.5,25014,25915,901
33003,NH,Carroll,,2009,5.5,24294,25706,1412
33003,NH,Carroll,,2010,5.9,23495,24978,1483
33003,NH,Carroll,,2011,5.5,23415,24777,1362
33003,NH,Carroll,,2012,5.2,23372,24657,1285
33003,NH,Carroll,,2013,5.1,23245,24485,1240
33003,NH,Carroll,,2014,4.2,23205,24229,1024
33003,NH,Carroll,,2015,3.5,22997,23833,836
33003,NH,Carroll,,2016,2.9,23003,23702,699
33003,NH,Carroll,,2017,2.8,23019,23675,656
33003,NH,Carroll,,2018,2.6,23226,23854,628
33003,NH,Carroll,,2019,2.6,23461,24085,624
33003,NH,Carroll,,2020,7.7,21209,22990,1781
33003,NH,Carroll,,2021,3.8,22185,23067,882
33005,NH,Cheshire,,2007,3.5,40599,42089,1490
33005,NH,Cheshire,,2008,3.5,40665,42158,1493
33005,NH,Cheshire,,2009,5.6,39435,41792,2357
33005,NH,Cheshire,,2010,5.8,40207,42682,2475
33005,NH,Cheshire,,2011,5.1,40413,42571,2158
33005,NH,Cheshire,,2012,5,40455,42600,2145
33005,NH,Cheshire,,2013,4.9,39987,42042,2055
33005,NH,Cheshire,,2014,4.1,40413,42125,1712
33005,NH,Cheshire,,2015,3.2,40280,41610,1330
33005,NH,Cheshire,,2016,2.7,40323,41458,1135
33005,NH,Cheshire,,2017,2.7,40065,41174,1109
33005,NH,Cheshire,,2018,2.6,39910,40992,1082
33005,NH,Cheshire,,2019,2.7,39780,40867,1087
33005,NH,Cheshire,,2020,6.2,37126,39589,2463
33005,NH,Cheshire,,2021,3.9,37904,39426,1522
33007,NH,Coos,,2007,4.6,15928,16698,770
33007,NH,Coos,,2008,5,15674,16500,826
33007,NH,Coos,,2009,7.8,15011,16278,1267
33007,NH,Coos,,2010,7.7,15346,16625,1279
33007,NH,Coos,,2011,7.4,15157,16360,1203
33007,NH,Coos,,2012,7.3,14904,16081,1177
33007,NH,Coos,,2013,6.2,14971,15969,998
33007,NH,Coos,,2014,5.7,14321,15189,868
33007,NH,Coos,,2015,4.4,14190,14844,654
33007,NH,Coos,,2016,3.8,14109,14662,553
33007,NH,Coos,,2017,3.6,14020,14540,520
33007,NH,Coos,,2018,3.3,14197,14686,489
33007,NH,Coos,,2019,3.2,14296,14774,478
33007,NH,Coos,,2020,8,13091,14229,1138
33007,NH,Coos,,2021,4.4,13689,14322,633
33009,NH,Grafton,,2007,3,46859,48284,1425
33009,NH,Grafton,,2008,3.1,47321,48810,1489
33009,NH,Grafton,,2009,5,46151,48605,2454
33009,NH,Grafton,,2010,5,45941,48372,2431
33009,NH,Grafton,,2011,4.5,46566,48761,2195
33009,NH,Grafton,,2012,4.4,46569,48717,2148
33009,NH,Grafton,,2013,4.4,46354,48468,2114
33009,NH,Grafton,,2014,3.5,46898,48584,1686
33009,NH,Grafton,,2015,2.8,47378,48731,1353
33009,NH,Grafton,,2016,2.4,47659,48813,1154
33009,NH,Grafton,,2017,2.3,48412,49540,1128
33009,NH,Grafton,,2018,2.2,48600,49679,1079
33009,NH,Grafton,,2019,2.3,48658,49782,1124
33009,NH,Grafton,,2020,5.9,45034,47865,2831
33009,NH,Grafton,,2021,3.3,46882,48491,1609
33011,NH,Hillsborough,,2007,3.5,220135,228211,8076
33011,NH,Hillsborough,,2008,3.7,220458,229028,8570
33011,NH,Hillsborough,,2009,6.4,213775,228322,14547
33011,NH,Hillsborough,,2010,6.4,211916,226498,14582
33011,NH,Hillsborough,,2011,5.7,212365,225235,12870
33011,NH,Hillsborough,,2012,5.7,213815,226816,13001
33011,NH,Hillsborough,,2013,5.5,215685,228331,12646
33011,NH,Hillsborough,,2014,4.5,218847,229211,10364
33011,NH,Hillsborough,,2015,3.6,221822,230126,8304
33011,NH,Hillsborough,,2016,3,225276,232312,7036
33011,NH,Hillsborough,,2017,3,228253,235223,6970
33011,NH,Hillsborough,,2018,2.7,233073,239623,6550
33011,NH,Hillsborough,,2019,2.7,237190,243727,6537
33011,NH,Hillsborough,,2020,7,222896,239777,16881
33011,NH,Hillsborough,,2021,3.6,228610,237144,8534
33013,NH,Merrimack,,2007,3.3,77659,80318,2659
33013,NH,Merrimack,,2008,3.5,78250,81113,2863
33013,NH,Merrimack,,2009,5.6,76734,81246,4512
33013,NH,Merrimack,,2010,5.6,76943,81506,4563
33013,NH,Merrimack,,2011,5,77111,81147,4036
33013,NH,Merrimack,,2012,4.9,77154,81132,3978
33013,NH,Merrimack,,2013,4.8,77196,81060,3864
33013,NH,Merrimack,,2014,3.8,77975,81097,3122
33013,NH,Merrimack,,2015,3.1,78901,81434,2533
33013,NH,Merrimack,,2016,2.6,79943,82037,2094
33013,NH,Merrimack,,2017,2.5,80429,82459,2030
33013,NH,Merrimack,,2018,2.3,81575,83502,1927
33013,NH,Merrimack,,2019,2.3,82202,84141,1939
33013,NH,Merrimack,,2020,5.9,77539,82373,4834
33013,NH,Merrimack,,2021,3.2,78615,81221,2606
33015,NH,Rockingham,,2007,3.8,167114,173670,6556
33015,NH,Rockingham,,2008,4.1,167104,174279,7175
33015,NH,Rockingham,,2009,6.5,162273,173534,11261
33015,NH,Rockingham,,2010,6.3,161814,172614,10800
33015,NH,Rockingham,,2011,5.7,162489,172239,9750
33015,NH,Rockingham,,2012,5.8,164616,174688,10072
33015,NH,Rockingham,,2013,5.6,166282,176160,9878
33015,NH,Rockingham,,2014,4.6,168833,177057,8224
33015,NH,Rockingham,,2015,3.6,172520,179022,6502
33015,NH,Rockingham,,2016,3,176410,181925,5515
33015,NH,Rockingham,,2017,3,178435,184018,5583
33015,NH,Rockingham,,2018,2.9,181129,186485,5356
33015,NH,Rockingham,,2019,2.8,184075,189328,5253
33015,NH,Rockingham,,2020,7.1,172685,185899,13214
33015,NH,Rockingham,,2021,3.5,178612,185013,6401
33017,NH,Strafford,,2007,3.3,65983,68206,2223
33017,NH,Strafford,,2008,3.5,67240,69689,2449
33017,NH,Strafford,,2009,6.1,65101,69326,4225
33017,NH,Strafford,,2010,5.9,65540,69674,4134
33017,NH,Strafford,,2011,5.3,65934,69660,3726
33017,NH,Strafford,,2012,5.4,66275,70030,3755
33017,NH,Strafford,,2013,5,66776,70314,3538
33017,NH,Strafford,,2014,4,67943,70790,2847
33017,NH,Strafford,,2015,3.2,69110,71360,2250
33017,NH,Strafford,,2016,2.5,70666,72514,1848
33017,NH,Strafford,,2017,2.5,71060,72879,1819
33017,NH,Strafford,,2018,2.4,72271,74034,1763
33017,NH,Strafford,,2019,2.4,73011,74807,1796
33017,NH,Strafford,,2020,6.3,68574,73209,4635
33017,NH,Strafford,,2021,3.3,70416,72806,2390
33019,NH,Sullivan,,2007,3,21875,22548,673
33019,NH,Sullivan,,2008,3.3,22008,22756,748
33019,NH,Sullivan,,2009,5.7,21381,22664,1283
33019,NH,Sullivan,,2010,5.4,22762,24068,1306
33019,NH,Sullivan,,2011,4.6,22857,23965,1108
33019,NH,Sullivan,,2012,4.4,22966,24035,1069
33019,NH,Sullivan,,2013,4.2,23116,24141,1025
33019,NH,Sullivan,,2014,3.5,22946,23790,844
33019,NH,Sullivan,,2015,2.8,23057,23714,657
33019,NH,Sullivan,,2016,2.3,23075,23626,551
33019,NH,Sullivan,,2017,2.3,22818,23357,539
33019,NH,Sullivan,,2018,2.2,22794,23308,514
33019,NH,Sullivan,,2019,2.3,22715,23259,544
33019,NH,Sullivan,,2020,5.5,21664,22917,1253
33019,NH,Sullivan,,2021,3.3,22147,22909,762
34000,NJ,New Jersey,,2007,4.2,4248982,4436092,187110
34000,NJ,New Jersey,,2008,5.4,4251455,4495936,244481
34000,NJ,New Jersey,,2009,9,4133366,4540303,406937
34000,NJ,New Jersey,,2010,9.7,4118982,4559778,440796
34000,NJ,New Jersey,,2011,9.4,4134708,4561786,427078
34000,NJ,New Jersey,,2012,9.4,4147221,4576286,429065
34000,NJ,New Jersey,,2013,8.4,4147661,4528019,380358
34000,NJ,New Jersey,,2014,6.7,4191318,4493894,302576
34000,NJ,New Jersey,,2015,5.7,4237876,4494606,256730
34000,NJ,New Jersey,,2016,4.9,4271201,4492821,221620
34000,NJ,New Jersey,,2017,4.5,4406151,4614953,208802
34000,NJ,New Jersey,,2018,4,4426617,4609773,183156
34000,NJ,New Jersey,,2019,3.4,4528168,4686701,158533
34000,NJ,New Jersey,,2020,9.5,4203278,4642945,439667
34000,NJ,New Jersey,,2021,6.3,4365397,4661087,295690
34001,NJ,Atlantic,,2007,5.8,127092,134896,7804
34001,NJ,Atlantic,,2008,6.9,126103,135516,9413
34001,NJ,Atlantic,,2009,11.8,120629,136729,16100
34001,NJ,Atlantic,,2010,12.5,122988,140527,17539
34001,NJ,Atlantic,,2011,12.6,121730,139203,17473
34001,NJ,Atlantic,,2012,12.8,122261,140161,17900
34001,NJ,Atlantic,,2013,11.9,120654,136972,16318
34001,NJ,Atlantic,,2014,10.5,117800,131656,13856
34001,NJ,Atlantic,,2015,9.5,114279,126239,11960
34001,NJ,Atlantic,,2016,7.4,113793,122855,9062
34001,NJ,Atlantic,,2017,7.1,113992,122687,8695
34001,NJ,Atlantic,,2018,5.7,116516,123520,7004
34001,NJ,Atlantic,,2019,4.8,120115,126175,6060
34001,NJ,Atlantic,,2020,17.2,102874,124180,21306
34001,NJ,Atlantic,,2021,9.5,111516,123181,11665
34003,NJ,Bergen,,2007,3.4,454919,470927,16008
34003,NJ,Bergen,,2008,4.5,455885,477222,21337
34003,NJ,Bergen,,2009,7.7,443081,480078,36997
34003,NJ,Bergen,,2010,8.1,441308,480364,39056
34003,NJ,Bergen,,2011,7.7,445121,482252,37131
34003,NJ,Bergen,,2012,7.7,446819,484140,37321
34003,NJ,Bergen,,2013,6.8,446896,479683,32787
34003,NJ,Bergen,,2014,5.4,452867,478747,25880
34003,NJ,Bergen,,2015,4.6,457997,480273,22276
34003,NJ,Bergen,,2016,4.1,460970,480916,19946
34003,NJ,Bergen,,2017,3.8,474208,492960,18752
34003,NJ,Bergen,,2018,3.3,477681,493894,16213
34003,NJ,Bergen,,2019,2.8,488445,502366,13921
34003,NJ,Bergen,,2020,9.2,448791,494483,45692
34003,NJ,Bergen,,2021,6,463475,493303,29828
34005,NJ,Burlington,,2007,3.8,228359,237345,8986
34005,NJ,Burlington,,2008,5,227028,238994,11966
34005,NJ,Burlington,,2009,8.3,221307,241460,20153
34005,NJ,Burlington,,2010,9.1,215253,236893,21640
34005,NJ,Burlington,,2011,8.7,214809,235402,20593
34005,NJ,Burlington,,2012,8.7,214417,234925,20508
34005,NJ,Burlington,,2013,7.9,213110,231309,18199
34005,NJ,Burlington,,2014,6.4,213563,228227,14664
34005,NJ,Burlington,,2015,5.3,217476,229643,12167
34005,NJ,Burlington,,2016,4.4,220184,230410,10226
34005,NJ,Burlington,,2017,4,228177,237722,9545
34005,NJ,Burlington,,2018,3.6,227635,236181,8546
34005,NJ,Burlington,,2019,3.1,233163,240664,7501
34005,NJ,Burlington,,2020,7.9,220269,239256,18987
34005,NJ,Burlington,,2021,5.3,229429,242242,12813
34007,NJ,Camden,,2007,4.8,249711,262212,12501
34007,NJ,Camden,,2008,6,250683,266721,16038
34007,NJ,Camden,,2009,9.8,244323,270872,26549
34007,NJ,Camden,,2010,11.1,235220,264642,29422
34007,NJ,Camden,,2011,10.9,233908,262449,28541
34007,NJ,Camden,,2012,10.8,233077,261304,28227
34007,NJ,Camden,,2013,9.6,231711,256334,24623
34007,NJ,Camden,,2014,7.7,232010,251359,19349
34007,NJ,Camden,,2015,6.4,235944,252080,16136
34007,NJ,Camden,,2016,5.5,239027,252853,13826
34007,NJ,Camden,,2017,5,248410,261449,13039
34007,NJ,Camden,,2018,4.5,247900,259479,11579
34007,NJ,Camden,,2019,3.9,253535,263710,10175
34007,NJ,Camden,,2020,9.7,238958,264683,25725
34007,NJ,Camden,,2021,6.8,248814,266839,18025
34009,NJ,Cape May,,2007,6.5,52731,56376,3645
34009,NJ,Cape May,,2008,8,51937,56464,4527
34009,NJ,Cape May,,2009,11.1,51390,57805,6415
34009,NJ,Cape May,,2010,14.2,43082,50222,7140
34009,NJ,Cape May,,2011,14.9,42134,49492,7358
34009,NJ,Cape May,,2012,15.5,42076,49803,7727
34009,NJ,Cape May,,2013,14.5,42027,49179,7152
34009,NJ,Cape May,,2014,12.2,42589,48513,5924
34009,NJ,Cape May,,2015,11,42733,48008,5275
34009,NJ,Cape May,,2016,9.8,42204,46780,4576
34009,NJ,Cape May,,2017,9.1,43332,47648,4316
34009,NJ,Cape May,,2018,8.2,43385,47243,3858
34009,NJ,Cape May,,2019,6.9,44433,47702,3269
34009,NJ,Cape May,,2020,13.6,39544,45776,6232
34009,NJ,Cape May,,2021,8.9,43177,47377,4200
34011,NJ,Cumberland,,2007,6.4,63677,68063,4386
34011,NJ,Cumberland,,2008,8,63425,68949,5524
34011,NJ,Cumberland,,2009,12.4,61891,70655,8764
34011,NJ,Cumberland,,2010,13.2,63067,72646,9579
34011,NJ,Cumberland,,2011,13,62430,71744,9314
34011,NJ,Cumberland,,2012,13.2,61727,71123,9396
34011,NJ,Cumberland,,2013,12,61064,69373,8309
34011,NJ,Cumberland,,2014,9.9,60887,67567,6680
34011,NJ,Cumberland,,2015,8.7,61495,67376,5881
34011,NJ,Cumberland,,2016,7.4,61546,66489,4943
34011,NJ,Cumberland,,2017,6.8,62922,67532,4610
34011,NJ,Cumberland,,2018,6.2,62889,67059,4170
34011,NJ,Cumberland,,2019,5.2,64344,67882,3538
34011,NJ,Cumberland,,2020,10.4,61463,68560,7097
34011,NJ,Cumberland,,2021,7.7,63655,68943,5288
34013,NJ,Essex,,2007,5.3,342021,361059,19038
34013,NJ,Essex,,2008,6.6,340984,364912,23928
34013,NJ,Essex,,2009,10.2,329127,366635,37508
34013,NJ,Essex,,2010,11,340655,382784,42129
34013,NJ,Essex,,2011,10.8,341486,382969,41483
34013,NJ,Essex,,2012,10.8,342112,383508,41396
34013,NJ,Essex,,2013,9.9,341374,378765,37391
34013,NJ,Essex,,2014,8,344497,374393,29896
34013,NJ,Essex,,2015,6.8,346533,371928,25395
34013,NJ,Essex,,2016,6,347867,369898,22031
34013,NJ,Essex,,2017,5.5,359991,381045,21054
34013,NJ,Essex,,2018,5,360905,379747,18842
34013,NJ,Essex,,2019,4.2,369214,385558,16344
34013,NJ,Essex,,2020,11.3,343539,387319,43780
34013,NJ,Essex,,2021,8,355103,385997,30894
34015,NJ,Gloucester,,2007,4.3,147157,153695,6538
34015,NJ,Gloucester,,2008,5.4,147822,156276,8454
34015,NJ,Gloucester,,2009,9.1,144922,159515,14593
34015,NJ,Gloucester,,2010,10.4,136584,152479,15895
34015,NJ,Gloucester,,2011,10.2,136216,151671,15455
34015,NJ,Gloucester,,2012,10.2,135879,151261,15382
34015,NJ,Gloucester,,2013,9.2,135537,149276,13739
34015,NJ,Gloucester,,2014,7.3,136496,147254,10758
34015,NJ,Gloucester,,2015,6,139106,147986,8880
34015,NJ,Gloucester,,2016,5,141551,149058,7507
34015,NJ,Gloucester,,2017,4.6,146898,154014,7116
34015,NJ,Gloucester,,2018,4.1,147232,153473,6241
34015,NJ,Gloucester,,2019,3.5,150907,156379,5472
34015,NJ,Gloucester,,2020,8.9,142899,156923,14024
34015,NJ,Gloucester,,2021,6,148799,158303,9504
34017,NJ,Hudson,,2007,4.9,275369,289627,14258
34017,NJ,Hudson,,2008,6.3,274966,293535,18569
34017,NJ,Hudson,,2009,10.4,268245,299436,31191
34017,NJ,Hudson,,2010,9.7,319751,354023,34272
34017,NJ,Hudson,,2011,9.1,325055,357668,32613
34017,NJ,Hudson,,2012,8.9,328173,360287,32114
34017,NJ,Hudson,,2013,8,329624,358333,28709
34017,NJ,Hudson,,2014,6.3,335475,358154,22679
34017,NJ,Hudson,,2015,5.3,340432,359524,19092
34017,NJ,Hudson,,2016,4.6,344004,360730,16726
34017,NJ,Hudson,,2017,4.3,357634,373519,15885
34017,NJ,Hudson,,2018,3.7,356625,370381,13756
34017,NJ,Hudson,,2019,3.1,364450,376163,11713
34017,NJ,Hudson,,2020,10.2,334859,373057,38198
34017,NJ,Hudson,,2021,6.8,345672,371044,25372
34019,NJ,Hunterdon,,2007,2.8,69949,71971,2022
34019,NJ,Hunterdon,,2008,3.8,70054,72804,2750
34019,NJ,Hunterdon,,2009,6.6,68235,73072,4837
34019,NJ,Hunterdon,,2010,7.5,63243,68375,5132
34019,NJ,Hunterdon,,2011,6.9,63055,67741,4686
34019,NJ,Hunterdon,,2012,6.9,62776,67414,4638
34019,NJ,Hunterdon,,2013,6,62370,66324,3954
34019,NJ,Hunterdon,,2014,4.9,62323,65500,3177
34019,NJ,Hunterdon,,2015,4.2,62282,65006,2724
34019,NJ,Hunterdon,,2016,3.7,62163,64574,2411
34019,NJ,Hunterdon,,2017,3.5,63591,65868,2277
34019,NJ,Hunterdon,,2018,3.1,64187,66234,2047
34019,NJ,Hunterdon,,2019,2.6,65629,67383,1754
34019,NJ,Hunterdon,,2020,6.9,61218,65783,4565
34019,NJ,Hunterdon,,2021,4.6,63356,66384,3028
34021,NJ,Mercer,,2007,3.8,188709,196121,7412
34021,NJ,Mercer,,2008,4.8,191976,201705,9729
34021,NJ,Mercer,,2009,7.5,189706,205099,15393
34021,NJ,Mercer,,2010,8.5,177008,193388,16380
34021,NJ,Mercer,,2011,8.3,177808,193855,16047
34021,NJ,Mercer,,2012,8.3,178269,194366,16097
34021,NJ,Mercer,,2013,7.4,179370,193723,14353
34021,NJ,Mercer,,2014,5.8,183732,195126,11394
34021,NJ,Mercer,,2015,4.9,187904,197628,9724
34021,NJ,Mercer,,2016,4.3,190295,198847,8552
34021,NJ,Mercer,,2017,4,195887,204042,8155
34021,NJ,Mercer,,2018,3.5,199513,206705,7192
34021,NJ,Mercer,,2019,3,205453,211808,6355
34021,NJ,Mercer,,2020,7.2,196139,211423,15284
34021,NJ,Mercer,,2021,5.2,201755,212752,10997
34023,NJ,Middlesex,,2007,3.8,403901,419879,15978
34023,NJ,Middlesex,,2008,5,403436,424692,21256
34023,NJ,Middlesex,,2009,8.4,390883,426829,35946
34023,NJ,Middlesex,,2010,9.1,385060,423623,38563
34023,NJ,Middlesex,,2011,8.8,388452,425816,37364
34023,NJ,Middlesex,,2012,8.7,392361,429638,37277
34023,NJ,Middlesex,,2013,7.7,396365,429433,33068
34023,NJ,Middlesex,,2014,6.1,405922,432197,26275
34023,NJ,Middlesex,,2015,5.1,413742,435900,22158
34023,NJ,Middlesex,,2016,4.4,418503,437739,19236
34023,NJ,Middlesex,,2017,4,434331,452408,18077
34023,NJ,Middlesex,,2018,3.5,434819,450549,15730
34023,NJ,Middlesex,,2019,3,442757,456287,13530
34023,NJ,Middlesex,,2020,8.5,409364,447472,38108
34023,NJ,Middlesex,,2021,5.7,427204,453161,25957
34025,NJ,Monmouth,,2007,3.7,318516,330722,12206
34025,NJ,Monmouth,,2008,4.9,318165,334387,16222
34025,NJ,Monmouth,,2009,8.2,308421,336127,27706
34025,NJ,Monmouth,,2010,8.9,300440,329770,29330
34025,NJ,Monmouth,,2011,8.6,300711,329005,28294
34025,NJ,Monmouth,,2012,8.8,301087,330054,28967
34025,NJ,Monmouth,,2013,7.7,301616,326755,25139
34025,NJ,Monmouth,,2014,6.1,305977,325689,19712
34025,NJ,Monmouth,,2015,5.1,309683,326367,16684
34025,NJ,Monmouth,,2016,4.4,313165,327641,14476
34025,NJ,Monmouth,,2017,4,322602,336172,13570
34025,NJ,Monmouth,,2018,3.5,325256,337138,11882
34025,NJ,Monmouth,,2019,3,331651,341980,10329
34025,NJ,Monmouth,,2020,8.6,308005,336908,28903
34025,NJ,Monmouth,,2021,5.5,321712,340535,18823
34027,NJ,Morris,,2007,3,263313,271413,8100
34027,NJ,Morris,,2008,4,263856,274808,10952
34027,NJ,Morris,,2009,7,255530,274752,19222
34027,NJ,Morris,,2010,7.5,245208,265152,19944
34027,NJ,Morris,,2011,7.1,246715,265475,18760
34027,NJ,Morris,,2012,7.1,247908,266982,19074
34027,NJ,Morris,,2013,6.3,247409,264014,16605
34027,NJ,Morris,,2014,5,247892,260996,13104
34027,NJ,Morris,,2015,4.3,248715,259938,11223
34027,NJ,Morris,,2016,3.9,249294,259361,10067
34027,NJ,Morris,,2017,3.5,254986,264364,9378
34027,NJ,Morris,,2018,3.1,255505,263758,8253
34027,NJ,Morris,,2019,2.7,260411,267542,7131
34027,NJ,Morris,,2020,7.5,241500,261110,19610
34027,NJ,Morris,,2021,5,249661,262719,13058
34029,NJ,Ocean,,2007,4.5,244647,256167,11520
34029,NJ,Ocean,,2008,5.9,245781,261271,15490
34029,NJ,Ocean,,2009,9.4,239548,264523,24975
34029,NJ,Ocean,,2010,10.4,236591,264164,27573
34029,NJ,Ocean,,2011,10.5,237652,265401,27749
34029,NJ,Ocean,,2012,10.7,238964,267594,28630
34029,NJ,Ocean,,2013,9.5,240258,265401,25143
34029,NJ,Ocean,,2014,7.4,245127,264604,19477
34029,NJ,Ocean,,2015,6.1,249320,265533,16213
34029,NJ,Ocean,,2016,5.2,254901,268831,13930
34029,NJ,Ocean,,2017,4.7,264758,277823,13065
34029,NJ,Ocean,,2018,4.1,270779,282342,11563
34029,NJ,Ocean,,2019,3.5,279736,289829,10093
34029,NJ,Ocean,,2020,9.1,263021,289421,26400
34029,NJ,Ocean,,2021,6,274713,292150,17437
34031,NJ,Passaic,,2007,5.3,223703,236167,12464
34031,NJ,Passaic,,2008,6.8,223873,240108,16235
34031,NJ,Passaic,,2009,10.9,217853,244491,26638
34031,NJ,Passaic,,2010,11.5,225034,254268,29234
34031,NJ,Passaic,,2011,11,226023,253964,27941
34031,NJ,Passaic,,2012,11.1,225598,253766,28168
34031,NJ,Passaic,,2013,10.1,224904,250300,25396
34031,NJ,Passaic,,2014,8.2,227260,247571,20311
34031,NJ,Passaic,,2015,7,229613,246856,17243
34031,NJ,Passaic,,2016,6.1,229603,244584,14981
34031,NJ,Passaic,,2017,5.6,236165,250172,14007
34031,NJ,Passaic,,2018,4.9,236540,248727,12187
34031,NJ,Passaic,,2019,4.1,242385,252768,10383
34031,NJ,Passaic,,2020,12.2,222250,253121,30871
34031,NJ,Passaic,,2021,8.4,229429,250345,20916
34033,NJ,Salem,,2007,4.9,29709,31235,1526
34033,NJ,Salem,,2008,6.2,29564,31530,1966
34033,NJ,Salem,,2009,10.5,28381,31713,3332
34033,NJ,Salem,,2010,11.8,28352,32156,3804
34033,NJ,Salem,,2011,11.7,28599,32374,3775
34033,NJ,Salem,,2012,11.9,28293,32107,3814
34033,NJ,Salem,,2013,10.6,28280,31648,3368
34033,NJ,Salem,,2014,8.5,28429,31064,2635
34033,NJ,Salem,,2015,7.3,28554,30790,2236
34033,NJ,Salem,,2016,6.4,28162,30073,1911
34033,NJ,Salem,,2017,6,28370,30191,1821
34033,NJ,Salem,,2018,5.3,28308,29880,1572
34033,NJ,Salem,,2019,4.6,29024,30422,1398
34033,NJ,Salem,,2020,9.3,27661,30482,2821
34033,NJ,Salem,,2021,7.3,28158,30386,2228
34035,NJ,Somerset,,2007,3.1,173572,179046,5474
34035,NJ,Somerset,,2008,4.1,173810,181200,7390
34035,NJ,Somerset,,2009,7.2,169248,182330,13082
34035,NJ,Somerset,,2010,7.7,160303,173689,13386
34035,NJ,Somerset,,2011,7.4,161458,174341,12883
34035,NJ,Somerset,,2012,7.5,162471,175600,13129
34035,NJ,Somerset,,2013,6.5,162793,174044,11251
34035,NJ,Somerset,,2014,5.2,163952,172945,8993
34035,NJ,Somerset,,2015,4.5,165130,172921,7791
34035,NJ,Somerset,,2016,4,165923,172875,6952
34035,NJ,Somerset,,2017,3.7,170185,176740,6555
34035,NJ,Somerset,,2018,3.3,170228,176026,5798
34035,NJ,Somerset,,2019,2.9,173194,178277,5083
34035,NJ,Somerset,,2020,7.5,160966,174041,13075
34035,NJ,Somerset,,2021,5.1,166372,175249,8877
34037,NJ,Sussex,,2007,3.9,80747,84000,3253
34037,NJ,Sussex,,2008,5,80763,85034,4271
34037,NJ,Sussex,,2009,8.5,78167,85415,7248
34037,NJ,Sussex,,2010,9.6,74496,82375,7879
34037,NJ,Sussex,,2011,9.3,74190,81753,7563
34037,NJ,Sussex,,2012,9.1,73766,81110,7344
34037,NJ,Sussex,,2013,8.1,72728,79129,6401
34037,NJ,Sussex,,2014,6.4,72262,77201,4939
34037,NJ,Sussex,,2015,5.4,71918,76012,4094
34037,NJ,Sussex,,2016,4.7,71667,75182,3515
34037,NJ,Sussex,,2017,4.3,72659,75942,3283
34037,NJ,Sussex,,2018,3.8,73110,75983,2873
34037,NJ,Sussex,,2019,3.3,74754,77275,2521
34037,NJ,Sussex,,2020,9.1,69247,76156,6909
34037,NJ,Sussex,,2021,5.9,71642,76170,4528
34039,NJ,Union,,2007,4.4,254927,266732,11805
34039,NJ,Union,,2008,5.7,255251,270753,15502
34039,NJ,Union,,2009,9.2,248204,273350,25146
34039,NJ,Union,,2010,9.7,252569,279607,27038
34039,NJ,Union,,2011,9.5,253809,280533,26724
34039,NJ,Union,,2012,9.5,255811,282619,26808
34039,NJ,Union,,2013,8.5,256494,280457,23963
34039,NJ,Union,,2014,6.9,258991,278280,19289
34039,NJ,Union,,2015,6,261341,277921,16580
34039,NJ,Union,,2016,5.1,262443,276619,14176
34039,NJ,Union,,2017,4.6,271857,285104,13247
34039,NJ,Union,,2018,4.1,272640,284367,11727
34039,NJ,Union,,2019,3.5,278358,288467,10109
34039,NJ,Union,,2020,9.6,257873,285238,27365
34039,NJ,Union,,2021,6.7,266463,285486,19023
34041,NJ,Warren,,2007,3.7,56253,58441,2188
34041,NJ,Warren,,2008,5,56096,59059,2963
34041,NJ,Warren,,2009,8.7,54278,59420,5142
34041,NJ,Warren,,2010,10,52774,58636,5862
34041,NJ,Warren,,2011,9.1,53348,58683,5335
34041,NJ,Warren,,2012,8.8,53376,58523,5147
34041,NJ,Warren,,2013,7.8,53077,57569,4492
34041,NJ,Warren,,2014,6.3,53267,56852,3585
34041,NJ,Warren,,2015,5.3,53677,56676,2999
34041,NJ,Warren,,2016,4.6,53937,56509,2572
34041,NJ,Warren,,2017,4.1,55197,57554,2357
34041,NJ,Warren,,2018,3.7,54966,57090,2124
34041,NJ,Warren,,2019,3.2,56211,58065,1854
34041,NJ,Warren,,2020,8.2,52839,57556,4717
34041,NJ,Warren,,2021,5.5,55292,58523,3231
35000,NM,New Mexico,,2007,3.6,887565,920673,33108
35000,NM,New Mexico,,2008,4.3,893645,933628,39983
35000,NM,New Mexico,,2009,7.1,862687,928373,65686
35000,NM,New Mexico,,2010,7.8,856602,928862,72260
35000,NM,New Mexico,,2011,7.2,858165,925108,66943
35000,NM,New Mexico,,2012,7,863937,928762,64825
35000,NM,New Mexico,,2013,6.9,865207,929410,64203
35000,NM,New Mexico,,2014,6.6,870570,931950,61380
35000,NM,New Mexico,,2015,6.6,876206,938300,62094
35000,NM,New Mexico,,2016,6.7,880515,944245,63730
35000,NM,New Mexico,,2017,6.1,890988,948581,57593
35000,NM,New Mexico,,2018,4.9,903757,950366,46609
35000,NM,New Mexico,,2019,4.9,916149,963804,47655
35000,NM,New Mexico,,2020,8.1,860105,935706,75601
35000,NM,New Mexico,,2021,6.8,879329,943356,64027
35001,NM,Bernalillo,,2007,3.4,297337,307876,10539
35001,NM,Bernalillo,,2008,4.2,296852,309849,12997
35001,NM,Bernalillo,,2009,7.1,284520,306172,21652
35001,NM,Bernalillo,,2010,7.4,300114,324142,24028
35001,NM,Bernalillo,,2011,6.9,299644,321894,22250
35001,NM,Bernalillo,,2012,6.6,300007,321332,21325
35001,NM,Bernalillo,,2013,6.4,300844,321539,20695
35001,NM,Bernalillo,,2014,6.1,302407,322126,19719
35001,NM,Bernalillo,,2015,6,305108,324436,19328
35001,NM,Bernalillo,,2016,5.9,309914,329282,19368
35001,NM,Bernalillo,,2017,5.4,314092,332042,17950
35001,NM,Bernalillo,,2018,4.5,317570,332444,14874
35001,NM,Bernalillo,,2019,4.5,321688,336903,15215
35001,NM,Bernalillo,,2020,7.7,303245,328702,25457
35001,NM,Bernalillo,,2021,6.2,313598,334378,20780
35003,NM,Catron,,2007,4.7,1414,1483,69
35003,NM,Catron,,2008,5.1,1440,1518,78
35003,NM,Catron,,2009,8.7,1422,1557,135
35003,NM,Catron,,2010,11.6,1066,1206,140
35003,NM,Catron,,2011,10.8,1030,1155,125
35003,NM,Catron,,2012,9.4,1132,1249,117
35003,NM,Catron,,2013,8.9,1137,1248,111
35003,NM,Catron,,2014,8.2,1096,1194,98
35003,NM,Catron,,2015,8.4,1099,1200,101
35003,NM,Catron,,2016,8.2,1115,1214,99
35003,NM,Catron,,2017,6.9,1095,1176,81
35003,NM,Catron,,2018,6.4,1056,1128,72
35003,NM,Catron,,2019,6.4,1074,1147,73
35003,NM,Catron,,2020,7.2,1063,1145,82
35003,NM,Catron,,2021,6.2,1109,1182,73
35005,NM,Chaves,,2007,3.7,25436,26424,988
35005,NM,Chaves,,2008,4.2,25420,26526,1106
35005,NM,Chaves,,2009,6.6,25203,26971,1768
35005,NM,Chaves,,2010,7.2,25820,27829,2009
35005,NM,Chaves,,2011,6.5,25668,27447,1779
35005,NM,Chaves,,2012,6.4,25287,27003,1716
35005,NM,Chaves,,2013,6.3,25117,26792,1675
35005,NM,Chaves,,2014,6,25604,27248,1644
35005,NM,Chaves,,2015,6.4,26121,27901,1780
35005,NM,Chaves,,2016,6.8,26338,28257,1919
35005,NM,Chaves,,2017,6.4,25999,27762,1763
35005,NM,Chaves,,2018,4.8,26085,27404,1319
35005,NM,Chaves,,2019,4.9,26235,27597,1362
35005,NM,Chaves,,2020,7.8,25452,27617,2165
35005,NM,Chaves,,2021,7.1,25813,27776,1963
35006,NM,Cibola,,2007,4,11317,11794,477
35006,NM,Cibola,,2008,4.4,11672,12215,543
35006,NM,Cibola,,2009,6.4,11402,12185,783
35006,NM,Cibola,,2010,9.2,8396,9246,850
35006,NM,Cibola,,2011,9.1,8376,9216,840
35006,NM,Cibola,,2012,8.4,8516,9302,786
35006,NM,Cibola,,2013,8.6,8383,9173,790
35006,NM,Cibola,,2014,8.5,8347,9122,775
35006,NM,Cibola,,2015,8.1,8578,9334,756
35006,NM,Cibola,,2016,8.3,8600,9379,779
35006,NM,Cibola,,2017,7.7,8501,9206,705
35006,NM,Cibola,,2018,6.2,8455,9012,557
35006,NM,Cibola,,2019,6.4,8503,9080,577
35006,NM,Cibola,,2020,8.9,8168,8968,800
35006,NM,Cibola,,2021,9.3,8050,8875,825
35007,NM,Colfax,,2007,3.4,6248,6467,219
35007,NM,Colfax,,2008,4.2,6270,6546,276
35007,NM,Colfax,,2009,7.1,6055,6521,466
35007,NM,Colfax,,2010,8,5806,6314,508
35007,NM,Colfax,,2011,7.8,5790,6281,491
35007,NM,Colfax,,2012,7.7,5664,6136,472
35007,NM,Colfax,,2013,7.1,5772,6210,438
35007,NM,Colfax,,2014,6.2,5801,6185,384
35007,NM,Colfax,,2015,6.1,5709,6078,369
35007,NM,Colfax,,2016,6.1,5517,5874,357
35007,NM,Colfax,,2017,5.9,5411,5751,340
35007,NM,Colfax,,2018,4.8,5282,5551,269
35007,NM,Colfax,,2019,4.7,5297,5559,262
35007,NM,Colfax,,2020,6.9,4747,5098,351
35007,NM,Colfax,,2021,5.9,5313,5645,332
35009,NM,Curry,,2007,2.7,20109,20673,564
35009,NM,Curry,,2008,3,20154,20785,631
35009,NM,Curry,,2009,4.2,20235,21130,895
35009,NM,Curry,,2010,5.1,20344,21443,1099
35009,NM,Curry,,2011,4.9,20337,21379,1042
35009,NM,Curry,,2012,4.9,20565,21614,1049
35009,NM,Curry,,2013,5.1,20457,21556,1099
35009,NM,Curry,,2014,5,20723,21814,1091
35009,NM,Curry,,2015,4.9,20954,22043,1089
35009,NM,Curry,,2016,5.1,21004,22136,1132
35009,NM,Curry,,2017,4.7,21457,22524,1067
35009,NM,Curry,,2018,4,20941,21811,870
35009,NM,Curry,,2019,4.2,20955,21869,914
35009,NM,Curry,,2020,5.3,20749,21910,1161
35009,NM,Curry,,2021,4.9,20979,22066,1087
35011,NM,De Baca,,2007,3.8,739,768,29
35011,NM,De Baca,,2008,3.9,766,797,31
35011,NM,De Baca,,2009,4.9,779,819,40
35011,NM,De Baca,,2010,5.7,780,827,47
35011,NM,De Baca,,2011,4.9,774,814,40
35011,NM,De Baca,,2012,4.2,789,824,35
35011,NM,De Baca,,2013,4.5,777,814,37
35011,NM,De Baca,,2014,4.6,806,845,39
35011,NM,De Baca,,2015,5.1,812,856,44
35011,NM,De Baca,,2016,4.8,799,839,40
35011,NM,De Baca,,2017,4.6,818,857,39
35011,NM,De Baca,,2018,4.4,738,772,34
35011,NM,De Baca,,2019,4.3,763,797,34
35011,NM,De Baca,,2020,4.6,662,694,32
35011,NM,De Baca,,2021,5.1,647,682,35
35013,NM,Doña Ana,,2007,4,82263,85682,3419
35013,NM,Doña Ana,,2008,4.6,83858,87857,3999
35013,NM,Doña Ana,,2009,6.9,82937,89070,6133
35013,NM,Doña Ana,,2010,7.4,85982,92896,6914
35013,NM,Doña Ana,,2011,7.3,86124,92873,6749
35013,NM,Doña Ana,,2012,7.2,87140,93870,6730
35013,NM,Doña Ana,,2013,7.5,87259,94284,7025
35013,NM,Doña Ana,,2014,7.2,87658,94455,6797
35013,NM,Doña Ana,,2015,7.4,87947,94974,7027
35013,NM,Doña Ana,,2016,7.2,89390,96370,6980
35013,NM,Doña Ana,,2017,6.7,90304,96802,6498
35013,NM,Doña Ana,,2018,5.6,91928,97423,5495
35013,NM,Doña Ana,,2019,5.8,93228,98941,5713
35013,NM,Doña Ana,,2020,8,89187,96941,7754
35013,NM,Doña Ana,,2021,6.6,91648,98170,6522
35015,NM,Eddy,,2007,2.8,24958,25690,732
35015,NM,Eddy,,2008,2.9,26222,27012,790
35015,NM,Eddy,,2009,5.5,26155,27680,1525
35015,NM,Eddy,,2010,6.1,23916,25475,1559
35015,NM,Eddy,,2011,4.9,25081,26368,1287
35015,NM,Eddy,,2012,4.6,25644,26874,1230
35015,NM,Eddy,,2013,4.6,26565,27837,1272
35015,NM,Eddy,,2014,4.4,27936,29214,1278
35015,NM,Eddy,,2015,5,28513,30009,1496
35015,NM,Eddy,,2016,6.6,27013,28918,1905
35015,NM,Eddy,,2017,5.2,27954,29475,1521
35015,NM,Eddy,,2018,3.3,30809,31861,1052
35015,NM,Eddy,,2019,3.1,33748,34843,1095
35015,NM,Eddy,,2020,6.6,30859,33054,2195
35015,NM,Eddy,,2021,6.4,29501,31522,2021
35017,NM,Grant,,2007,3.7,11612,12054,442
35017,NM,Grant,,2008,4.7,11647,12227,580
35017,NM,Grant,,2009,12,10247,11648,1401
35017,NM,Grant,,2010,9.3,11110,12247,1137
35017,NM,Grant,,2011,7,11816,12705,889
35017,NM,Grant,,2012,6.5,12174,13023,849
35017,NM,Grant,,2013,6.7,12048,12919,871
35017,NM,Grant,,2014,6.5,11766,12587,821
35017,NM,Grant,,2015,6.5,11733,12555,822
35017,NM,Grant,,2016,6.5,11740,12559,819
35017,NM,Grant,,2017,6,11635,12379,744
35017,NM,Grant,,2018,4.8,11818,12413,595
35017,NM,Grant,,2019,4.8,11738,12335,597
35017,NM,Grant,,2020,8.7,10764,11784,1020
35017,NM,Grant,,2021,7.3,10626,11457,831
35019,NM,Guadalupe,,2007,5.6,1664,1763,99
35019,NM,Guadalupe,,2008,5.9,1605,1706,101
35019,NM,Guadalupe,,2009,7.4,1629,1759,130
35019,NM,Guadalupe,,2010,9.7,1479,1637,158
35019,NM,Guadalupe,,2011,10.1,1478,1644,166
35019,NM,Guadalupe,,2012,9.8,1485,1646,161
35019,NM,Guadalupe,,2013,8.7,1499,1641,142
35019,NM,Guadalupe,,2014,7.6,1500,1624,124
35019,NM,Guadalupe,,2015,7.2,1527,1645,118
35019,NM,Guadalupe,,2016,6.6,1593,1705,112
35019,NM,Guadalupe,,2017,6.4,1554,1661,107
35019,NM,Guadalupe,,2018,5.4,1547,1636,89
35019,NM,Guadalupe,,2019,5.3,1497,1581,84
35019,NM,Guadalupe,,2020,6.6,1395,1493,98
35019,NM,Guadalupe,,2021,7,1520,1634,114
35021,NM,Harding,,2007,2.6,373,383,10
35021,NM,Harding,,2008,2.8,382,393,11
35021,NM,Harding,,2009,4.7,365,383,18
35021,NM,Harding,,2010,5.8,276,293,17
35021,NM,Harding,,2011,6.1,277,295,18
35021,NM,Harding,,2012,6.1,275,293,18
35021,NM,Harding,,2013,5.2,271,286,15
35021,NM,Harding,,2014,4.7,304,319,15
35021,NM,Harding,,2015,8.7,263,288,25
35021,NM,Harding,,2016,7.1,260,280,20
35021,NM,Harding,,2017,6,267,284,17
35021,NM,Harding,,2018,5.3,266,281,15
35021,NM,Harding,,2019,4.4,258,270,12
35021,NM,Harding,,2020,4,265,276,11
35021,NM,Harding,,2021,4.6,268,281,13
35023,NM,Hidalgo,,2007,2.9,2411,2483,72
35023,NM,Hidalgo,,2008,4.1,2483,2590,107
35023,NM,Hidalgo,,2009,7.7,2439,2643,204
35023,NM,Hidalgo,,2010,8.2,2097,2284,187
35023,NM,Hidalgo,,2011,7.3,2107,2272,165
35023,NM,Hidalgo,,2012,7.2,2172,2340,168
35023,NM,Hidalgo,,2013,7.5,2023,2187,164
35023,NM,Hidalgo,,2014,7,2007,2159,152
35023,NM,Hidalgo,,2015,6.3,2015,2150,135
35023,NM,Hidalgo,,2016,5.6,2095,2219,124
35023,NM,Hidalgo,,2017,5.1,2045,2154,109
35023,NM,Hidalgo,,2018,3.8,2149,2233,84
35023,NM,Hidalgo,,2019,4.3,2016,2107,91
35023,NM,Hidalgo,,2020,5.6,1805,1913,108
35023,NM,Hidalgo,,2021,5.4,1786,1888,102
35025,NM,Lea,,2007,2.4,26655,27304,649
35025,NM,Lea,,2008,2.7,28165,28960,795
35025,NM,Lea,,2009,7.4,25888,27963,2075
35025,NM,Lea,,2010,7.6,24123,26101,1978
35025,NM,Lea,,2011,5.4,25666,27121,1455
35025,NM,Lea,,2012,4.6,27061,28373,1312
35025,NM,Lea,,2013,4.5,28173,29488,1315
35025,NM,Lea,,2014,4.3,29550,30890,1340
35025,NM,Lea,,2015,6.3,28224,30113,1889
35025,NM,Lea,,2016,9.3,25359,27967,2608
35025,NM,Lea,,2017,6.5,26313,28133,1820
35025,NM,Lea,,2018,4.1,29031,30274,1243
35025,NM,Lea,,2019,4,30278,31555,1277
35025,NM,Lea,,2020,10.7,25974,29081,3107
35025,NM,Lea,,2021,9.6,25280,27957,2677
35027,NM,Lincoln,,2007,3,10413,10731,318
35027,NM,Lincoln,,2008,3.4,10553,10925,372
35027,NM,Lincoln,,2009,5.5,10169,10759,590
35027,NM,Lincoln,,2010,7.2,8646,9314,668
35027,NM,Lincoln,,2011,6.5,8471,9062,591
35027,NM,Lincoln,,2012,6.4,8401,8975,574
35027,NM,Lincoln,,2013,6.4,8290,8858,568
35027,NM,Lincoln,,2014,5.9,8329,8855,526
35027,NM,Lincoln,,2015,5.8,8240,8751,511
35027,NM,Lincoln,,2016,6,8184,8708,524
35027,NM,Lincoln,,2017,5.4,8327,8806,479
35027,NM,Lincoln,,2018,4.5,8402,8800,398
35027,NM,Lincoln,,2019,4.7,8669,9093,424
35027,NM,Lincoln,,2020,8.7,7925,8679,754
35027,NM,Lincoln,,2021,7.5,8183,8843,660
35028,NM,Los Alamos,,2007,2.1,10126,10342,216
35028,NM,Los Alamos,,2008,2.9,9604,9889,285
35028,NM,Los Alamos,,2009,3,9492,9790,298
35028,NM,Los Alamos,,2010,3.5,9076,9405,329
35028,NM,Los Alamos,,2011,3.4,8927,9240,313
35028,NM,Los Alamos,,2012,3.8,8672,9016,344
35028,NM,Los Alamos,,2013,4.2,8308,8673,365
35028,NM,Los Alamos,,2014,4.1,8162,8509,347
35028,NM,Los Alamos,,2015,4.1,8208,8558,350
35028,NM,Los Alamos,,2016,4.3,8482,8862,380
35028,NM,Los Alamos,,2017,3.8,8871,9221,350
35028,NM,Los Alamos,,2018,3.4,8882,9192,310
35028,NM,Los Alamos,,2019,3.2,9345,9657,312
35028,NM,Los Alamos,,2020,3.6,9432,9788,356
35028,NM,Los Alamos,,2021,3,9737,10035,298
35029,NM,Luna,,2007,9.7,10925,12105,1180
35029,NM,Luna,,2008,11.7,10732,12148,1416
35029,NM,Luna,,2009,16.6,10175,12193,2018
35029,NM,Luna,,2010,19.3,9288,11516,2228
35029,NM,Luna,,2011,19.5,9146,11366,2220
35029,NM,Luna,,2012,19.6,9195,11438,2243
35029,NM,Luna,,2013,18.9,9210,11362,2152
35029,NM,Luna,,2014,17.9,9373,11410,2037
35029,NM,Luna,,2015,17.5,9184,11130,1946
35029,NM,Luna,,2016,14.6,9283,10870,1587
35029,NM,Luna,,2017,13.9,9178,10657,1479
35029,NM,Luna,,2018,11.8,9034,10238,1204
35029,NM,Luna,,2019,12.3,9182,10474,1292
35029,NM,Luna,,2020,15.7,8590,10185,1595
35029,NM,Luna,,2021,15.2,8471,9989,1518
35031,NM,McKinley,,2007,4.5,25160,26334,1174
35031,NM,McKinley,,2008,5.3,24947,26348,1401
35031,NM,McKinley,,2009,7.8,24628,26720,2092
35031,NM,McKinley,,2010,9.5,22834,25221,2387
35031,NM,McKinley,,2011,9.6,22440,24810,2370
35031,NM,McKinley,,2012,9.4,22584,24929,2345
35031,NM,McKinley,,2013,10.1,21984,24447,2463
35031,NM,McKinley,,2014,10,21657,24064,2407
35031,NM,McKinley,,2015,9.9,22055,24475,2420
35031,NM,McKinley,,2016,9.5,22260,24587,2327
35031,NM,McKinley,,2017,8.5,22468,24556,2088
35031,NM,McKinley,,2018,7,22354,24046,1692
35031,NM,McKinley,,2019,7.1,22710,24444,1734
35031,NM,McKinley,,2020,10,21250,23613,2363
35031,NM,McKinley,,2021,9.6,21209,23454,2245
35033,NM,Mora,,2007,7.6,1835,1985,150
35033,NM,Mora,,2008,8.3,1834,1999,165
35033,NM,Mora,,2009,12.1,1770,2013,243
35033,NM,Mora,,2010,11.8,2125,2410,285
35033,NM,Mora,,2011,11.8,2080,2359,279
35033,NM,Mora,,2012,10.8,2066,2315,249
35033,NM,Mora,,2013,11.6,2003,2267,264
35033,NM,Mora,,2014,10.9,2029,2276,247
35033,NM,Mora,,2015,9.8,2062,2286,224
35033,NM,Mora,,2016,8.8,2057,2256,199
35033,NM,Mora,,2017,7.8,2057,2232,175
35033,NM,Mora,,2018,6,2159,2298,139
35033,NM,Mora,,2019,6.1,2103,2240,137
35033,NM,Mora,,2020,7.8,1873,2032,159
35033,NM,Mora,,2021,6.2,1874,1998,124
35035,NM,Otero,,2007,3.6,24685,25620,935
35035,NM,Otero,,2008,4.2,24512,25590,1078
35035,NM,Otero,,2009,6.3,24000,25622,1622
35035,NM,Otero,,2010,6.9,23075,24796,1721
35035,NM,Otero,,2011,6.6,22947,24557,1610
35035,NM,Otero,,2012,6.4,23482,25081,1599
35035,NM,Otero,,2013,6.4,23784,25397,1613
35035,NM,Otero,,2014,6.2,23347,24883,1536
35035,NM,Otero,,2015,6.3,23594,25168,1574
35035,NM,Otero,,2016,6.1,24101,25674,1573
35035,NM,Otero,,2017,6,23695,25216,1521
35035,NM,Otero,,2018,4.9,23702,24918,1216
35035,NM,Otero,,2019,5,23878,25142,1264
35035,NM,Otero,,2020,8.1,23181,25226,2045
35035,NM,Otero,,2021,6.6,23434,25093,1659
35037,NM,Quay,,2007,4.3,3619,3783,164
35037,NM,Quay,,2008,4.7,3697,3881,184
35037,NM,Quay,,2009,6.4,3662,3912,250
35037,NM,Quay,,2010,9,3157,3470,313
35037,NM,Quay,,2011,9.3,3058,3371,313
35037,NM,Quay,,2012,8,3123,3393,270
35037,NM,Quay,,2013,7.2,3085,3326,241
35037,NM,Quay,,2014,6.5,3106,3323,217
35037,NM,Quay,,2015,7.2,3056,3293,237
35037,NM,Quay,,2016,6.9,3013,3235,222
35037,NM,Quay,,2017,6.1,3089,3289,200
35037,NM,Quay,,2018,4.8,3088,3242,154
35037,NM,Quay,,2019,5.3,3076,3248,172
35037,NM,Quay,,2020,7.2,2816,3035,219
35037,NM,Quay,,2021,7.1,2747,2956,209
35039,NM,Rio Arriba,,2007,4.6,19099,20011,912
35039,NM,Rio Arriba,,2008,5.2,19170,20230,1060
35039,NM,Rio Arriba,,2009,7.2,18510,19938,1428
35039,NM,Rio Arriba,,2010,8.8,16291,17861,1570
35039,NM,Rio Arriba,,2011,8.9,15614,17143,1529
35039,NM,Rio Arriba,,2012,9.1,15332,16870,1538
35039,NM,Rio Arriba,,2013,9.5,15148,16738,1590
35039,NM,Rio Arriba,,2014,8.6,15158,16593,1435
35039,NM,Rio Arriba,,2015,8.1,15354,16709,1355
35039,NM,Rio Arriba,,2016,7.5,15617,16892,1275
35039,NM,Rio Arriba,,2017,6.3,15902,16973,1071
35039,NM,Rio Arriba,,2018,5.2,15910,16776,866
35039,NM,Rio Arriba,,2019,5.4,16015,16921,906
35039,NM,Rio Arriba,,2020,7.8,15191,16483,1292
35039,NM,Rio Arriba,,2021,7,15424,16592,1168
35041,NM,Roosevelt,,2007,2.7,9126,9379,253
35041,NM,Roosevelt,,2008,3,9090,9371,281
35041,NM,Roosevelt,,2009,4.5,8795,9210,415
35041,NM,Roosevelt,,2010,6,7850,8349,499
35041,NM,Roosevelt,,2011,5.5,7830,8285,455
35041,NM,Roosevelt,,2012,5.5,7900,8358,458
35041,NM,Roosevelt,,2013,5.6,7926,8392,466
35041,NM,Roosevelt,,2014,5.5,7723,8170,447
35041,NM,Roosevelt,,2015,5.5,7652,8095,443
35041,NM,Roosevelt,,2016,5.8,7661,8130,469
35041,NM,Roosevelt,,2017,5.1,7667,8082,415
35041,NM,Roosevelt,,2018,4.3,7559,7900,341
35041,NM,Roosevelt,,2019,4.5,7577,7936,359
35041,NM,Roosevelt,,2020,6,7358,7824,466
35041,NM,Roosevelt,,2021,5.6,7465,7904,439
35043,NM,Sandoval,,2007,4.1,51042,53232,2190
35043,NM,Sandoval,,2008,5,52388,55150,2762
35043,NM,Sandoval,,2009,8,51132,55582,4450
35043,NM,Sandoval,,2010,8.1,55563,60446,4883
35043,NM,Sandoval,,2011,7.7,55796,60480,4684
35043,NM,Sandoval,,2012,7.6,55966,60586,4620
35043,NM,Sandoval,,2013,7.4,56417,60938,4521
35043,NM,Sandoval,,2014,7.1,57186,61533,4347
35043,NM,Sandoval,,2015,6.7,58296,62492,4196
35043,NM,Sandoval,,2016,6.7,60300,64607,4307
35043,NM,Sandoval,,2017,6.1,61293,65261,3968
35043,NM,Sandoval,,2018,4.9,62980,66225,3245
35043,NM,Sandoval,,2019,4.9,64430,67742,3312
35043,NM,Sandoval,,2020,8.1,61164,66586,5422
35043,NM,Sandoval,,2021,6.6,63252,67732,4480
35045,NM,San Juan,,2007,3.2,53075,54851,1776
35045,NM,San Juan,,2008,3.8,54331,56467,2136
35045,NM,San Juan,,2009,7.4,51546,55673,4127
35045,NM,San Juan,,2010,9,49509,54401,4892
35045,NM,San Juan,,2011,7.6,50576,54710,4134
35045,NM,San Juan,,2012,7,51522,55371,3849
35045,NM,San Juan,,2013,6.8,51165,54873,3708
35045,NM,San Juan,,2014,6.3,52119,55623,3504
35045,NM,San Juan,,2015,7,52098,56002,3904
35045,NM,San Juan,,2016,8.9,49824,54678,4854
35045,NM,San Juan,,2017,7.4,50494,54555,4061
35045,NM,San Juan,,2018,5.7,49735,52750,3015
35045,NM,San Juan,,2019,5.8,49450,52486,3036
35045,NM,San Juan,,2020,9.6,45217,50020,4803
35045,NM,San Juan,,2021,8,45550,49527,3977
35047,NM,San Miguel,,2007,4,12622,13150,528
35047,NM,San Miguel,,2008,4.8,12532,13158,626
35047,NM,San Miguel,,2009,6.9,12221,13127,906
35047,NM,San Miguel,,2010,9.2,10089,11113,1024
35047,NM,San Miguel,,2011,9.2,10018,11027,1009
35047,NM,San Miguel,,2012,8.7,10142,11108,966
35047,NM,San Miguel,,2013,8.3,10230,11155,925
35047,NM,San Miguel,,2014,8,10170,11058,888
35047,NM,San Miguel,,2015,7.8,10299,11166,867
35047,NM,San Miguel,,2016,7.8,10310,11179,869
35047,NM,San Miguel,,2017,7.3,10279,11091,812
35047,NM,San Miguel,,2018,5.9,10373,11020,647
35047,NM,San Miguel,,2019,5.9,10246,10883,637
35047,NM,San Miguel,,2020,7.9,9602,10429,827
35047,NM,San Miguel,,2021,7.3,9609,10367,758
35049,NM,Santa Fe,,2007,2.9,74709,76926,2217
35049,NM,Santa Fe,,2008,3.6,74506,77291,2785
35049,NM,Santa Fe,,2009,6.2,70920,75574,4654
35049,NM,Santa Fe,,2010,6.5,68957,73742,4785
35049,NM,Santa Fe,,2011,6,68875,73251,4376
35049,NM,Santa Fe,,2012,5.7,69587,73761,4174
35049,NM,Santa Fe,,2013,5.6,69565,73660,4095
35049,NM,Santa Fe,,2014,5.4,69128,73054,3926
35049,NM,Santa Fe,,2015,5.4,69678,73665,3987
35049,NM,Santa Fe,,2016,5.3,70098,74060,3962
35049,NM,Santa Fe,,2017,5,70515,74245,3730
35049,NM,Santa Fe,,2018,4.1,71783,74861,3078
35049,NM,Santa Fe,,2019,4.1,71439,74486,3047
35049,NM,Santa Fe,,2020,7.9,65447,71037,5590
35049,NM,Santa Fe,,2021,6.2,68094,72572,4478
35051,NM,Sierra,,2007,3.4,5281,5466,185
35051,NM,Sierra,,2008,3.9,5599,5826,227
35051,NM,Sierra,,2009,5.4,5574,5893,319
35051,NM,Sierra,,2010,8.8,3641,3993,352
35051,NM,Sierra,,2011,9.5,3497,3865,368
35051,NM,Sierra,,2012,9.6,3593,3975,382
35051,NM,Sierra,,2013,9.7,3623,4013,390
35051,NM,Sierra,,2014,9.1,3610,3970,360
35051,NM,Sierra,,2015,9.2,3685,4058,373
35051,NM,Sierra,,2016,8.5,3745,4094,349
35051,NM,Sierra,,2017,7.7,3890,4214,324
35051,NM,Sierra,,2018,6.9,3844,4130,286
35051,NM,Sierra,,2019,6.8,3689,3957,268
35051,NM,Sierra,,2020,8.9,3704,4068,364
35051,NM,Sierra,,2021,8.1,3742,4074,332
35053,NM,Socorro,,2007,3.1,8935,9219,284
35053,NM,Socorro,,2008,3.4,9085,9407,322
35053,NM,Socorro,,2009,4.9,8899,9361,462
35053,NM,Socorro,,2010,7.4,6314,6822,508
35053,NM,Socorro,,2011,7.3,6302,6801,499
35053,NM,Socorro,,2012,6.8,6360,6826,466
35053,NM,Socorro,,2013,7.4,6163,6652,489
35053,NM,Socorro,,2014,7.3,6038,6511,473
35053,NM,Socorro,,2015,7.6,6080,6583,503
35053,NM,Socorro,,2016,7.4,6233,6733,500
35053,NM,Socorro,,2017,6.3,6248,6669,421
35053,NM,Socorro,,2018,5.2,6166,6506,340
35053,NM,Socorro,,2019,5.9,6131,6515,384
35053,NM,Socorro,,2020,6.8,5736,6157,421
35053,NM,Socorro,,2021,6.3,5777,6166,389
35055,NM,Taos,,2007,4.7,16662,17482,820
35055,NM,Taos,,2008,5.3,16519,17435,916
35055,NM,Taos,,2009,8.3,15908,17351,1443
35055,NM,Taos,,2010,10.3,13700,15266,1566
35055,NM,Taos,,2011,10.1,13546,15076,1530
35055,NM,Taos,,2012,10.3,13470,15012,1542
35055,NM,Taos,,2013,10.3,13577,15135,1558
35055,NM,Taos,,2014,9.8,13628,15105,1477
35055,NM,Taos,,2015,9.3,13628,15020,1392
35055,NM,Taos,,2016,8.5,13780,15062,1282
35055,NM,Taos,,2017,7.8,14057,15246,1189
35055,NM,Taos,,2018,6.4,14167,15143,976
35055,NM,Taos,,2019,6.1,14420,15355,935
35055,NM,Taos,,2020,11.1,13068,14705,1637
35055,NM,Taos,,2021,8.9,13352,14663,1311
35057,NM,Torrance,,2007,4.5,6671,6982,311
35057,NM,Torrance,,2008,5.3,6468,6833,365
35057,NM,Torrance,,2009,8.8,6206,6808,602
35057,NM,Torrance,,2010,11.1,5309,5974,665
35057,NM,Torrance,,2011,11.1,5189,5836,647
35057,NM,Torrance,,2012,10.4,5166,5767,601
35057,NM,Torrance,,2013,10.2,5056,5629,573
35057,NM,Torrance,,2014,9.7,5059,5601,542
35057,NM,Torrance,,2015,9.1,5000,5503,503
35057,NM,Torrance,,2016,9.2,5042,5554,512
35057,NM,Torrance,,2017,8.5,5167,5644,477
35057,NM,Torrance,,2018,7.6,5235,5663,428
35057,NM,Torrance,,2019,6.9,5316,5707,391
35057,NM,Torrance,,2020,9.2,4835,5322,487
35057,NM,Torrance,,2021,7.9,4986,5412,426
35059,NM,Union,,2007,2.6,1800,1848,48
35059,NM,Union,,2008,2.8,1874,1928,54
35059,NM,Union,,2009,5.2,1805,1904,99
35059,NM,Union,,2010,6,1801,1915,114
35059,NM,Union,,2011,4.5,1846,1933,87
35059,NM,Union,,2012,4.3,1795,1875,80
35059,NM,Union,,2013,4.6,1790,1876,86
35059,NM,Union,,2014,4.5,1827,1914,87
35059,NM,Union,,2015,4.4,1821,1905,84
35059,NM,Union,,2016,4.1,1831,1909,78
35059,NM,Union,,2017,3.7,1861,1933,72
35059,NM,Union,,2018,3.3,1741,1800,59
35059,NM,Union,,2019,3.5,1809,1874,65
35059,NM,Union,,2020,5,1547,1628,81
35059,NM,Union,,2021,4.2,1506,1572,66
35061,NM,Valencia,,2007,3.8,29244,30385,1141
35061,NM,Valencia,,2008,4.9,29269,30773,1504
35061,NM,Valencia,,2009,8,28002,30445,2443
35061,NM,Valencia,,2010,9.2,28071,30910,2839
35061,NM,Valencia,,2011,8.6,27840,30472,2632
35061,NM,Valencia,,2012,8.5,27669,30227,2558
35061,NM,Valencia,,2013,8.3,27560,30046,2486
35061,NM,Valencia,,2014,7.8,27417,29721,2304
35061,NM,Valencia,,2015,7.5,27613,29860,2247
35061,NM,Valencia,,2016,7.3,27958,30156,2198
35061,NM,Valencia,,2017,6.6,28486,30485,1999
35061,NM,Valencia,,2018,5.4,28970,30621,1651
35061,NM,Valencia,,2019,5.4,29386,31059,1673
35061,NM,Valencia,,2020,7.9,27838,30216,2378
35061,NM,Valencia,,2021,6.9,28782,30901,2119
36000,NY,New York,,2007,4.4,9088287,9511023,422736
36000,NY,New York,,2008,5.4,9121271,9641100,519829
36000,NY,New York,,2009,8.4,8853905,9664010,810105
36000,NY,New York,,2010,8.7,8790607,9630297,839690
36000,NY,New York,,2011,8.3,8741662,9537752,796090
36000,NY,New York,,2012,8.6,8775083,9602599,827516
36000,NY,New York,,2013,7.8,8880792,9632949,752157
36000,NY,New York,,2014,6.3,8925328,9523567,598239
36000,NY,New York,,2015,5.2,9035989,9536519,500530
36000,NY,New York,,2016,4.9,9062866,9527021,464155
36000,NY,New York,,2017,4.6,9382750,9838170,455420
36000,NY,New York,,2018,4.1,9440487,9842263,401776
36000,NY,New York,,2019,3.8,9502625,9880211,377586
36000,NY,New York,,2020,9.9,8631276,9575032,943756
36000,NY,New York,,2021,6.9,8786280,9441458,655178
36001,NY,Albany,,2007,3.8,152391,158424,6033
36001,NY,Albany,,2008,4.8,151681,159330,7649
36001,NY,Albany,,2009,6.9,148024,158969,10945
36001,NY,Albany,,2010,7.1,150137,161626,11489
36001,NY,Albany,,2011,7,147443,158506,11063
36001,NY,Albany,,2012,7.2,148855,160401,11546
36001,NY,Albany,,2013,6.2,150583,160574,9991
36001,NY,Albany,,2014,4.9,149307,157049,7742
36001,NY,Albany,,2015,4.4,151269,158197,6928
36001,NY,Albany,,2016,4.1,151974,158526,6552
36001,NY,Albany,,2017,4.2,154316,161093,6777
36001,NY,Albany,,2018,3.7,154984,160911,5927
36001,NY,Albany,,2019,3.5,155432,161065,5633
36001,NY,Albany,,2020,6.9,148104,159064,10960
36001,NY,Albany,,2021,4.4,149645,156527,6882
36003,NY,Allegany,,2007,5.4,22102,23355,1253
36003,NY,Allegany,,2008,6.3,22419,23933,1514
36003,NY,Allegany,,2009,8.9,21794,23911,2117
36003,NY,Allegany,,2010,9.3,22004,24270,2266
36003,NY,Allegany,,2011,9,21561,23692,2131
36003,NY,Allegany,,2012,8.5,21638,23658,2020
36003,NY,Allegany,,2013,7.7,21945,23773,1828
36003,NY,Allegany,,2014,6.3,21833,23292,1459
36003,NY,Allegany,,2015,6.5,18979,20309,1330
36003,NY,Allegany,,2016,6.4,18781,20070,1289
36003,NY,Allegany,,2017,6.6,18740,20060,1320
36003,NY,Allegany,,2018,5.6,18789,19896,1107
36003,NY,Allegany,,2019,5.3,18658,19698,1040
36003,NY,Allegany,,2020,7.7,17886,19388,1502
36003,NY,Allegany,,2021,5,18098,19042,944
36005,NY,Bronx,,2007,6.6,478314,512095,33781
36005,NY,Bronx,,2008,7.5,486813,526398,39585
36005,NY,Bronx,,2009,12,471589,535750,64161
36005,NY,Bronx,,2010,12,516105,586805,70700
36005,NY,Bronx,,2011,12,516013,586219,70206
36005,NY,Bronx,,2012,12.5,520367,594885,74518
36005,NY,Bronx,,2013,11.7,530049,600525,70476
36005,NY,Bronx,,2014,9.5,545610,603201,57591
36005,NY,Bronx,,2015,7.6,556946,602931,45985
36005,NY,Bronx,,2016,7.1,560468,603006,42538
36005,NY,Bronx,,2017,6.2,593962,632929,38967
36005,NY,Bronx,,2018,5.6,594200,629681,35481
36005,NY,Bronx,,2019,5.2,596668,629583,32915
36005,NY,Bronx,,2020,16.2,517592,617657,100065
36005,NY,Bronx,,2021,13.6,524483,606729,82246
36007,NY,Broome,,2007,4.4,92442,96672,4230
36007,NY,Broome,,2008,5.5,92038,97404,5366
36007,NY,Broome,,2009,8.3,89457,97545,8088
36007,NY,Broome,,2010,8.9,89241,97931,8690
36007,NY,Broome,,2011,8.7,86646,94855,8209
36007,NY,Broome,,2012,8.8,85603,93879,8276
36007,NY,Broome,,2013,8,84512,91828,7316
36007,NY,Broome,,2014,6.7,82002,87879,5877
36007,NY,Broome,,2015,6,81430,86642,5212
36007,NY,Broome,,2016,5.5,81177,85916,4739
36007,NY,Broome,,2017,5.5,81335,86101,4766
36007,NY,Broome,,2018,4.8,81778,85937,4159
36007,NY,Broome,,2019,4.5,81493,85371,3878
36007,NY,Broome,,2020,8.3,76405,83341,6936
36007,NY,Broome,,2021,5.2,77161,81423,4262
36009,NY,Cattaraugus,,2007,5,39119,41186,2067
36009,NY,Cattaraugus,,2008,6,38946,41440,2494
36009,NY,Cattaraugus,,2009,8.8,38038,41689,3651
36009,NY,Cattaraugus,,2010,9.7,35851,39706,3855
36009,NY,Cattaraugus,,2011,9.4,34970,38612,3642
36009,NY,Cattaraugus,,2012,9.5,34639,38264,3625
36009,NY,Cattaraugus,,2013,8.7,34742,38072,3330
36009,NY,Cattaraugus,,2014,7.1,34000,36581,2581
36009,NY,Cattaraugus,,2015,6.3,32929,35157,2228
36009,NY,Cattaraugus,,2016,6.1,32760,34879,2119
36009,NY,Cattaraugus,,2017,6.2,32764,34913,2149
36009,NY,Cattaraugus,,2018,5.3,32926,34768,1842
36009,NY,Cattaraugus,,2019,4.9,32811,34487,1676
36009,NY,Cattaraugus,,2020,9.1,30565,33626,3061
36009,NY,Cattaraugus,,2021,5.3,31107,32847,1740
36011,NY,Cayuga,,2007,4.4,39267,41059,1792
36011,NY,Cayuga,,2008,5.5,39204,41480,2276
36011,NY,Cayuga,,2009,8.4,38116,41607,3491
36011,NY,Cayuga,,2010,8.7,36448,39915,3467
36011,NY,Cayuga,,2011,8.2,35927,39121,3194
36011,NY,Cayuga,,2012,8.4,35787,39056,3269
36011,NY,Cayuga,,2013,7.6,35875,38810,2935
36011,NY,Cayuga,,2014,6,35298,37566,2268
36011,NY,Cayuga,,2015,5.4,35015,37005,1990
36011,NY,Cayuga,,2016,5.1,34828,36716,1888
36011,NY,Cayuga,,2017,5,34715,36537,1822
36011,NY,Cayuga,,2018,4.4,35118,36748,1630
36011,NY,Cayuga,,2019,4.1,35190,36697,1507
36011,NY,Cayuga,,2020,7.6,33290,36024,2734
36011,NY,Cayuga,,2021,4.7,33473,35130,1657
36013,NY,Chautauqua,,2007,4.4,63716,66653,2937
36013,NY,Chautauqua,,2008,5.5,63143,66804,3661
36013,NY,Chautauqua,,2009,8.4,60400,65963,5563
36013,NY,Chautauqua,,2010,9,58211,63976,5765
36013,NY,Chautauqua,,2011,8.2,56660,61754,5094
36013,NY,Chautauqua,,2012,8.6,55903,61194,5291
36013,NY,Chautauqua,,2013,8.2,55211,60159,4948
36013,NY,Chautauqua,,2014,6.9,53745,57704,3959
36013,NY,Chautauqua,,2015,6.1,54012,57502,3490
36013,NY,Chautauqua,,2016,5.9,52844,56159,3315
36013,NY,Chautauqua,,2017,6,53096,56459,3363
36013,NY,Chautauqua,,2018,5,53150,55948,2798
36013,NY,Chautauqua,,2019,4.5,52973,55486,2513
36013,NY,Chautauqua,,2020,8.5,49233,53821,4588
36013,NY,Chautauqua,,2021,5.6,49847,52786,2939
36015,NY,Chemung,,2007,4.5,39035,40876,1841
36015,NY,Chemung,,2008,5.5,38872,41141,2269
36015,NY,Chemung,,2009,9.1,37324,41039,3715
36015,NY,Chemung,,2010,8.6,38073,41638,3565
36015,NY,Chemung,,2011,7.9,37636,40863,3227
36015,NY,Chemung,,2012,8.5,37041,40497,3456
36015,NY,Chemung,,2013,8.1,36364,39572,3208
36015,NY,Chemung,,2014,6.3,35717,38121,2404
36015,NY,Chemung,,2015,5.9,35195,37406,2211
36015,NY,Chemung,,2016,5.8,34123,36232,2109
36015,NY,Chemung,,2017,5.5,34337,36329,1992
36015,NY,Chemung,,2018,4.6,34451,36111,1660
36015,NY,Chemung,,2019,4,34542,35984,1442
36015,NY,Chemung,,2020,8.4,32893,35912,3019
36015,NY,Chemung,,2021,5.3,32734,34549,1815
36017,NY,Chenango,,2007,4.9,23173,24356,1183
36017,NY,Chenango,,2008,6.3,22941,24478,1537
36017,NY,Chenango,,2009,9.1,22206,24419,2213
36017,NY,Chenango,,2010,9.4,21490,23717,2227
36017,NY,Chenango,,2011,8.7,21777,23865,2088
36017,NY,Chenango,,2012,8.8,21984,24093,2109
36017,NY,Chenango,,2013,7.5,22265,24071,1806
36017,NY,Chenango,,2014,6.3,21704,23155,1451
36017,NY,Chenango,,2015,5.5,21780,23047,1267
36017,NY,Chenango,,2016,5.1,21668,22844,1176
36017,NY,Chenango,,2017,5.3,21537,22745,1208
36017,NY,Chenango,,2018,4.6,21748,22803,1055
36017,NY,Chenango,,2019,4.3,21464,22423,959
36017,NY,Chenango,,2020,6.6,20650,22117,1467
36017,NY,Chenango,,2021,4.4,20678,21630,952
36019,NY,Clinton,,2007,5.5,37513,39699,2186
36019,NY,Clinton,,2008,6.5,37106,39673,2567
36019,NY,Clinton,,2009,9.5,36046,39812,3766
36019,NY,Clinton,,2010,10,35778,39748,3970
36019,NY,Clinton,,2011,9.6,34756,38468,3712
36019,NY,Clinton,,2012,9.5,34331,37952,3621
36019,NY,Clinton,,2013,8.5,33977,37145,3168
36019,NY,Clinton,,2014,6.7,33543,35938,2395
36019,NY,Clinton,,2015,5.9,33758,35861,2103
36019,NY,Clinton,,2016,5.5,33869,35822,1953
36019,NY,Clinton,,2017,5.2,34880,36810,1930
36019,NY,Clinton,,2018,4.4,35431,37046,1615
36019,NY,Clinton,,2019,4.2,35474,37029,1555
36019,NY,Clinton,,2020,7.7,33328,36090,2762
36019,NY,Clinton,,2021,4.6,33639,35269,1630
36021,NY,Columbia,,2007,3.8,30495,31708,1213
36021,NY,Columbia,,2008,4.8,30128,31638,1510
36021,NY,Columbia,,2009,7.5,29090,31442,2352
36021,NY,Columbia,,2010,7.5,29763,32162,2399
36021,NY,Columbia,,2011,7.2,29238,31498,2260
36021,NY,Columbia,,2012,7.2,29371,31633,2262
36021,NY,Columbia,,2013,6.2,29841,31801,1960
36021,NY,Columbia,,2014,4.8,29794,31281,1487
36021,NY,Columbia,,2015,4,30094,31352,1258
36021,NY,Columbia,,2016,3.7,30294,31473,1179
36021,NY,Columbia,,2017,3.8,30493,31685,1192
36021,NY,Columbia,,2018,3.3,30872,31928,1056
36021,NY,Columbia,,2019,3.1,30883,31865,982
36021,NY,Columbia,,2020,5.9,29034,30869,1835
36021,NY,Columbia,,2021,3.8,29085,30238,1153
36023,NY,Cortland,,2007,5.1,22482,23688,1206
36023,NY,Cortland,,2008,6.3,22464,23979,1515
36023,NY,Cortland,,2009,9.3,22065,24318,2253
36023,NY,Cortland,,2010,9.1,22286,24504,2218
36023,NY,Cortland,,2011,8.5,22301,24380,2079
36023,NY,Cortland,,2012,8.8,22305,24444,2139
36023,NY,Cortland,,2013,7.9,22356,24285,1929
36023,NY,Cortland,,2014,6.6,22082,23633,1551
36023,NY,Cortland,,2015,5.9,21855,23233,1378
36023,NY,Cortland,,2016,5.8,21667,22999,1332
36023,NY,Cortland,,2017,5.8,22035,23380,1345
36023,NY,Cortland,,2018,5.1,22161,23343,1182
36023,NY,Cortland,,2019,4.7,22343,23442,1099
36023,NY,Cortland,,2020,7.7,21027,22779,1752
36023,NY,Cortland,,2021,5.1,20978,22100,1122
36025,NY,Delaware,,2007,4.3,22102,23085,983
36025,NY,Delaware,,2008,5.9,21398,22739,1341
36025,NY,Delaware,,2009,8.7,20340,22274,1934
36025,NY,Delaware,,2010,8.9,20447,22450,2003
36025,NY,Delaware,,2011,8.7,19848,21748,1900
36025,NY,Delaware,,2012,8.9,19649,21560,1911
36025,NY,Delaware,,2013,8.1,19333,21030,1697
36025,NY,Delaware,,2014,6.6,18681,20004,1323
36025,NY,Delaware,,2015,6,18290,19467,1177
36025,NY,Delaware,,2016,5.6,18154,19234,1080
36025,NY,Delaware,,2017,5.5,18252,19313,1061
36025,NY,Delaware,,2018,4.8,18547,19485,938
36025,NY,Delaware,,2019,4.5,18565,19445,880
36025,NY,Delaware,,2020,7,17637,18957,1320
36025,NY,Delaware,,2021,4.6,18042,18914,872
36027,NY,Dutchess,,2007,3.8,139676,145248,5572
36027,NY,Dutchess,,2008,5.1,138199,145570,7371
36027,NY,Dutchess,,2009,7.8,133601,144898,11297
36027,NY,Dutchess,,2010,7.9,137561,149288,11727
36027,NY,Dutchess,,2011,7.6,135428,146498,11070
36027,NY,Dutchess,,2012,7.9,134622,146160,11538
36027,NY,Dutchess,,2013,6.8,135453,145403,9950
36027,NY,Dutchess,,2014,5.4,134432,142064,7632
36027,NY,Dutchess,,2015,4.5,136526,142997,6471
36027,NY,Dutchess,,2016,4.2,137045,143108,6063
36027,NY,Dutchess,,2017,4.3,139767,145985,6218
36027,NY,Dutchess,,2018,3.7,141342,146721,5379
36027,NY,Dutchess,,2019,3.5,143053,148184,5131
36027,NY,Dutchess,,2020,7.3,133963,144551,10588
36027,NY,Dutchess,,2021,4.4,135918,142246,6328
36029,NY,Erie,,2007,4.6,442978,464418,21440
36029,NY,Erie,,2008,5.6,443377,469884,26507
36029,NY,Erie,,2009,8.2,432055,470857,38802
36029,NY,Erie,,2010,8.5,426603,466015,39412
36029,NY,Erie,,2011,8,422449,459408,36959
36029,NY,Erie,,2012,8.4,422256,461103,38847
36029,NY,Erie,,2013,7.6,424800,459781,34981
36029,NY,Erie,,2014,6.2,420334,447882,27548
36029,NY,Erie,,2015,5.4,423855,447913,24058
36029,NY,Erie,,2016,5,423060,445373,22313
36029,NY,Erie,,2017,5.1,429193,452441,23248
36029,NY,Erie,,2018,4.4,431796,451624,19828
36029,NY,Erie,,2019,4.1,434058,452537,18479
36029,NY,Erie,,2020,9.1,404444,445070,40626
36029,NY,Erie,,2021,5.5,411823,435588,23765
36031,NY,Essex,,2007,5.6,17486,18518,1032
36031,NY,Essex,,2008,6.6,17253,18470,1217
36031,NY,Essex,,2009,9.3,16653,18351,1698
36031,NY,Essex,,2010,9.3,17006,18753,1747
36031,NY,Essex,,2011,9.2,16559,18227,1668
36031,NY,Essex,,2012,9.7,16392,18152,1760
36031,NY,Essex,,2013,8.5,16561,18095,1534
36031,NY,Essex,,2014,6.9,16312,17528,1216
36031,NY,Essex,,2015,6.1,16235,17283,1048
36031,NY,Essex,,2016,5.4,16311,17248,937
36031,NY,Essex,,2017,5.4,16531,17481,950
36031,NY,Essex,,2018,4.8,16575,17412,837
36031,NY,Essex,,2019,4.5,16603,17389,786
36031,NY,Essex,,2020,7.9,15526,16852,1326
36031,NY,Essex,,2021,4.7,15955,16744,789
36033,NY,Franklin,,2007,5.5,21354,22586,1232
36033,NY,Franklin,,2008,6.8,21312,22872,1560
36033,NY,Franklin,,2009,8.6,21051,23041,1990
36033,NY,Franklin,,2010,9.1,20232,22260,2028
36033,NY,Franklin,,2011,9.2,19759,21754,1995
36033,NY,Franklin,,2012,9.7,19658,21768,2110
36033,NY,Franklin,,2013,9.1,19578,21529,1951
36033,NY,Franklin,,2014,7.3,18990,20489,1499
36033,NY,Franklin,,2015,6.6,18632,19940,1308
36033,NY,Franklin,,2016,5.8,18662,19804,1142
36033,NY,Franklin,,2017,6,18901,20110,1209
36033,NY,Franklin,,2018,5.1,18995,20017,1022
36033,NY,Franklin,,2019,4.8,19006,19954,948
36033,NY,Franklin,,2020,7.9,17898,19443,1545
36033,NY,Franklin,,2021,4.7,18211,19114,903
36035,NY,Fulton,,2007,5.3,25845,27288,1443
36035,NY,Fulton,,2008,6.6,25626,27447,1821
36035,NY,Fulton,,2009,9.8,24602,27264,2662
36035,NY,Fulton,,2010,10.8,23317,26148,2831
36035,NY,Fulton,,2011,10.7,22871,25603,2732
36035,NY,Fulton,,2012,11.2,22534,25370,2836
36035,NY,Fulton,,2013,9.7,22323,24724,2401
36035,NY,Fulton,,2014,7.7,21599,23407,1808
36035,NY,Fulton,,2015,6.5,21892,23409,1517
36035,NY,Fulton,,2016,5.8,21886,23238,1352
36035,NY,Fulton,,2017,5.7,22235,23587,1352
36035,NY,Fulton,,2018,5.1,22117,23298,1181
36035,NY,Fulton,,2019,4.8,21947,23063,1116
36035,NY,Fulton,,2020,8.3,21009,22899,1890
36035,NY,Fulton,,2021,5.5,21121,22353,1232
36037,NY,Genesee,,2007,4.5,31339,32805,1466
36037,NY,Genesee,,2008,5.5,31435,33281,1846
36037,NY,Genesee,,2009,7.8,30543,33110,2567
36037,NY,Genesee,,2010,8.2,29163,31762,2599
36037,NY,Genesee,,2011,7.9,28539,30974,2435
36037,NY,Genesee,,2012,8,28365,30841,2476
36037,NY,Genesee,,2013,7,28357,30500,2143
36037,NY,Genesee,,2014,5.6,28310,29986,1676
36037,NY,Genesee,,2015,5,28549,30049,1500
36037,NY,Genesee,,2016,4.7,28357,29744,1387
36037,NY,Genesee,,2017,4.7,28650,30078,1428
36037,NY,Genesee,,2018,4.1,29111,30368,1257
36037,NY,Genesee,,2019,3.8,29270,30415,1145
36037,NY,Genesee,,2020,7.1,27427,29514,2087
36037,NY,Genesee,,2021,4.3,28024,29268,1244
36039,NY,Greene,,2007,4.7,22951,24076,1125
36039,NY,Greene,,2008,5.8,22777,24181,1404
36039,NY,Greene,,2009,8.5,22052,24090,2038
36039,NY,Greene,,2010,9.3,20080,22130,2050
36039,NY,Greene,,2011,9.5,19568,21619,2051
36039,NY,Greene,,2012,10.1,19354,21525,2171
36039,NY,Greene,,2013,9,19422,21339,1917
36039,NY,Greene,,2014,6.8,19282,20691,1409
36039,NY,Greene,,2015,5.7,19511,20686,1175
36039,NY,Greene,,2016,5.1,19517,20575,1058
36039,NY,Greene,,2017,5.2,19807,20887,1080
36039,NY,Greene,,2018,4.5,20102,21055,953
36039,NY,Greene,,2019,4.3,19809,20699,890
36039,NY,Greene,,2020,8,18925,20564,1639
36039,NY,Greene,,2021,4.9,19302,20305,1003
36041,NY,Hamilton,,2007,4.6,3053,3201,148
36041,NY,Hamilton,,2008,6.2,2866,3054,188
36041,NY,Hamilton,,2009,7.6,2787,3016,229
36041,NY,Hamilton,,2010,10.1,2254,2506,252
36041,NY,Hamilton,,2011,10,2203,2448,245
36041,NY,Hamilton,,2012,10.9,2181,2448,267
36041,NY,Hamilton,,2013,9.8,2191,2430,239
36041,NY,Hamilton,,2014,7.5,2245,2427,182
36041,NY,Hamilton,,2015,6.8,2265,2430,165
36041,NY,Hamilton,,2016,6.6,2210,2366,156
36041,NY,Hamilton,,2017,7.3,2186,2359,173
36041,NY,Hamilton,,2018,6.8,2178,2337,159
36041,NY,Hamilton,,2019,5.7,2136,2266,130
36041,NY,Hamilton,,2020,7.7,2023,2192,169
36041,NY,Hamilton,,2021,4.4,2112,2210,98
36043,NY,Herkimer,,2007,4.8,29422,30911,1489
36043,NY,Herkimer,,2008,6,29192,31065,1873
36043,NY,Herkimer,,2009,8.1,28664,31185,2521
36043,NY,Herkimer,,2010,8.8,28817,31587,2770
36043,NY,Herkimer,,2011,8.8,28070,30770,2700
36043,NY,Herkimer,,2012,8.9,27786,30496,2710
36043,NY,Herkimer,,2013,8,27569,29975,2406
36043,NY,Herkimer,,2014,6.8,26846,28817,1971
36043,NY,Herkimer,,2015,6.3,26590,28373,1783
36043,NY,Herkimer,,2016,5.6,26620,28187,1567
36043,NY,Herkimer,,2017,5.7,26923,28541,1618
36043,NY,Herkimer,,2018,4.9,27001,28390,1389
36043,NY,Herkimer,,2019,4.7,27209,28556,1347
36043,NY,Herkimer,,2020,7.9,25770,27973,2203
36043,NY,Herkimer,,2021,5.8,25918,27514,1596
36045,NY,Jefferson,,2007,5.4,45457,48036,2579
36045,NY,Jefferson,,2008,6.7,45589,48885,3296
36045,NY,Jefferson,,2009,9,45092,49539,4447
36045,NY,Jefferson,,2010,9.4,45598,50335,4737
36045,NY,Jefferson,,2011,9.8,44189,48994,4805
36045,NY,Jefferson,,2012,10,43529,48359,4830
36045,NY,Jefferson,,2013,9.5,43729,48298,4569
36045,NY,Jefferson,,2014,7.7,42979,46554,3575
36045,NY,Jefferson,,2015,6.6,43366,46451,3085
36045,NY,Jefferson,,2016,6.3,42795,45691,2896
36045,NY,Jefferson,,2017,6.5,42859,45820,2961
36045,NY,Jefferson,,2018,5.5,42923,45439,2516
36045,NY,Jefferson,,2019,5.4,42496,44902,2406
36045,NY,Jefferson,,2020,8.4,40387,44090,3703
36045,NY,Jefferson,,2021,5,41564,43765,2201
36047,NY,Kings,,2007,5.3,1029077,1086150,57073
36047,NY,Kings,,2008,6,1045310,1111934,66624
36047,NY,Kings,,2009,9.9,1012858,1123905,111047
36047,NY,Kings,,2010,10,1055400,1172462,117062
36047,NY,Kings,,2011,9.6,1061492,1174299,112807
36047,NY,Kings,,2012,9.9,1072483,1189756,117273
36047,NY,Kings,,2013,9.3,1093739,1206307,112568
36047,NY,Kings,,2014,7.4,1123287,1213696,90409
36047,NY,Kings,,2015,5.8,1139369,1209375,70006
36047,NY,Kings,,2016,5.3,1142605,1206229,63624
36047,NY,Kings,,2017,4.6,1206327,1264625,58298
36047,NY,Kings,,2018,4.2,1208420,1261337,52917
36047,NY,Kings,,2019,4,1213528,1263500,49972
36047,NY,Kings,,2020,12.6,1057917,1210703,152786
36047,NY,Kings,,2021,10.1,1072663,1193447,120784
36049,NY,Lewis,,2007,5.3,11795,12460,665
36049,NY,Lewis,,2008,6.6,11712,12537,825
36049,NY,Lewis,,2009,8.9,11623,12760,1137
36049,NY,Lewis,,2010,9.3,11582,12772,1190
36049,NY,Lewis,,2011,9.7,11206,12413,1207
36049,NY,Lewis,,2012,10.1,11013,12254,1241
36049,NY,Lewis,,2013,9.7,11052,12239,1187
36049,NY,Lewis,,2014,7.9,10915,11853,938
36049,NY,Lewis,,2015,7,10930,11749,819
36049,NY,Lewis,,2016,6.8,10949,11752,803
36049,NY,Lewis,,2017,6.6,11034,11812,778
36049,NY,Lewis,,2018,5.5,11215,11870,655
36049,NY,Lewis,,2019,5.3,11216,11847,631
36049,NY,Lewis,,2020,7.5,10741,11607,866
36049,NY,Lewis,,2021,5,10955,11534,579
36051,NY,Livingston,,2007,4.8,30635,32185,1550
36051,NY,Livingston,,2008,5.9,30379,32275,1896
36051,NY,Livingston,,2009,8.5,29411,32157,2746
36051,NY,Livingston,,2010,8.2,30079,32783,2704
36051,NY,Livingston,,2011,7.7,29583,32043,2460
36051,NY,Livingston,,2012,7.9,29545,32096,2551
36051,NY,Livingston,,2013,7.2,29547,31843,2296
36051,NY,Livingston,,2014,5.8,29103,30909,1806
36051,NY,Livingston,,2015,5.3,29543,31195,1652
36051,NY,Livingston,,2016,5,29491,31052,1561
36051,NY,Livingston,,2017,5,29646,31205,1559
36051,NY,Livingston,,2018,4.3,30001,31348,1347
36051,NY,Livingston,,2019,4.1,30117,31397,1280
36051,NY,Livingston,,2020,6.8,28189,30254,2065
36051,NY,Livingston,,2021,4.3,28533,29821,1288
36053,NY,Madison,,2007,4.6,34246,35889,1643
36053,NY,Madison,,2008,5.7,34168,36222,2054
36053,NY,Madison,,2009,8.2,33140,36103,2963
36053,NY,Madison,,2010,8.4,32603,35610,3007
36053,NY,Madison,,2011,8.2,31921,34777,2856
36053,NY,Madison,,2012,8.6,31589,34568,2979
36053,NY,Madison,,2013,7.8,31702,34385,2683
36053,NY,Madison,,2014,6.5,31224,33382,2158
36053,NY,Madison,,2015,5.7,30957,32835,1878
36053,NY,Madison,,2016,5.4,30966,32717,1751
36053,NY,Madison,,2017,5.5,31177,32984,1807
36053,NY,Madison,,2018,4.8,31773,33358,1585
36053,NY,Madison,,2019,4.3,32187,33637,1450
36053,NY,Madison,,2020,7.5,30462,32945,2483
36053,NY,Madison,,2021,4.5,30749,32206,1457
36055,NY,Monroe,,2007,4.3,356147,372313,16166
36055,NY,Monroe,,2008,5.4,354893,375178,20285
36055,NY,Monroe,,2009,8,345560,375537,29977
36055,NY,Monroe,,2010,8.2,347553,378548,30995
36055,NY,Monroe,,2011,7.7,345365,374302,28937
36055,NY,Monroe,,2012,8,345696,375735,30039
36055,NY,Monroe,,2013,7.2,347423,374202,26779
36055,NY,Monroe,,2014,5.8,342750,364023,21273
36055,NY,Monroe,,2015,5.1,346195,364827,18632
36055,NY,Monroe,,2016,4.8,346044,363421,17377
36055,NY,Monroe,,2017,4.9,350616,368701,18085
36055,NY,Monroe,,2018,4.2,354079,369758,15679
36055,NY,Monroe,,2019,4,355735,370549,14814
36055,NY,Monroe,,2020,8.2,335839,365713,29874
36055,NY,Monroe,,2021,5.2,341760,360379,18619
36057,NY,Montgomery,,2007,5.8,23019,24424,1405
36057,NY,Montgomery,,2008,7,22902,24622,1720
36057,NY,Montgomery,,2009,9.6,22094,24441,2347
36057,NY,Montgomery,,2010,10.3,21488,23951,2463
36057,NY,Montgomery,,2011,10.3,21051,23472,2421
36057,NY,Montgomery,,2012,10.5,20954,23424,2470
36057,NY,Montgomery,,2013,9.4,20982,23163,2181
36057,NY,Montgomery,,2014,7.5,20565,22241,1676
36057,NY,Montgomery,,2015,6.6,20765,22235,1470
36057,NY,Montgomery,,2016,5.8,21022,22321,1299
36057,NY,Montgomery,,2017,5.7,21638,22942,1304
36057,NY,Montgomery,,2018,5.1,21730,22905,1175
36057,NY,Montgomery,,2019,4.9,21663,22776,1113
36057,NY,Montgomery,,2020,8.4,20553,22442,1889
36057,NY,Montgomery,,2021,5.7,20661,21900,1239
36059,NY,Nassau,,2007,3.6,668578,693675,25097
36059,NY,Nassau,,2008,4.7,662814,695385,32571
36059,NY,Nassau,,2009,7,644412,693067,48655
36059,NY,Nassau,,2010,7.3,641573,691973,50400
36059,NY,Nassau,,2011,6.9,637173,684374,47201
36059,NY,Nassau,,2012,7.1,643054,692547,49493
36059,NY,Nassau,,2013,6.1,653821,696036,42215
36059,NY,Nassau,,2014,4.8,651793,684808,33015
36059,NY,Nassau,,2015,4.3,666770,696394,29624
36059,NY,Nassau,,2016,4,672300,700139,27839
36059,NY,Nassau,,2017,4.1,690355,719512,29157
36059,NY,Nassau,,2018,3.5,696501,721744,25243
36059,NY,Nassau,,2019,3.3,703155,727084,23929
36059,NY,Nassau,,2020,8,653335,710248,56913
36059,NY,Nassau,,2021,4.5,676654,708286,31632
36061,NY,New York,,2007,4.2,879249,917707,38458
36061,NY,New York,,2008,4.9,890733,936462,45729
36061,NY,New York,,2009,8.4,856532,935069,78537
36061,NY,New York,,2010,8.6,811259,887865,76606
36061,NY,New York,,2011,7.9,815453,884930,69477
36061,NY,New York,,2012,8.1,822146,894573,72427
36061,NY,New York,,2013,7.5,833170,900600,67430
36061,NY,New York,,2014,6,851252,905240,53988
36061,NY,New York,,2015,4.8,862865,906077,43212
36061,NY,New York,,2016,4.5,867324,908259,40935
36061,NY,New York,,2017,4,920354,958723,38369
36061,NY,New York,,2018,3.6,924960,959905,34945
36061,NY,New York,,2019,3.4,937012,970004,32992
36061,NY,New York,,2020,9.6,815372,902268,86896
36061,NY,New York,,2021,7.6,826846,894457,67611
36063,NY,Niagara,,2007,5.2,105306,111140,5834
36063,NY,Niagara,,2008,6.6,105618,113118,7500
36063,NY,Niagara,,2009,9.4,103033,113741,10708
36063,NY,Niagara,,2010,9.8,97385,107989,10604
36063,NY,Niagara,,2011,9.2,96025,105772,9747
36063,NY,Niagara,,2012,9.5,95634,105621,9987
36063,NY,Niagara,,2013,8.7,95856,104967,9111
36063,NY,Niagara,,2014,7.1,94233,101415,7182
36063,NY,Niagara,,2015,6.2,94705,100970,6265
36063,NY,Niagara,,2016,5.9,94345,100281,5936
36063,NY,Niagara,,2017,6.1,95048,101274,6226
36063,NY,Niagara,,2018,5.2,95896,101154,5258
36063,NY,Niagara,,2019,4.8,96034,100833,4799
36063,NY,Niagara,,2020,10.1,89223,99206,9983
36063,NY,Niagara,,2021,5.7,90759,96212,5453
36065,NY,Oneida,,2007,4.2,105098,109712,4614
36065,NY,Oneida,,2008,5.3,104554,110436,5882
36065,NY,Oneida,,2009,7.5,102360,110657,8297
36065,NY,Oneida,,2010,7.8,103595,112343,8748
36065,NY,Oneida,,2011,8.1,100348,109138,8790
36065,NY,Oneida,,2012,8.4,99345,108406,9061
36065,NY,Oneida,,2013,7.6,98964,107128,8164
36065,NY,Oneida,,2014,6.2,96696,103036,6340
36065,NY,Oneida,,2015,5.4,96471,101948,5477
36065,NY,Oneida,,2016,4.9,96689,101706,5017
36065,NY,Oneida,,2017,5,98506,103660,5154
36065,NY,Oneida,,2018,4.4,98517,103077,4560
36065,NY,Oneida,,2019,4.1,99643,103906,4263
36065,NY,Oneida,,2020,7.8,94429,102413,7984
36065,NY,Oneida,,2021,5.1,95112,100177,5065
36067,NY,Onondaga,,2007,4,222787,232090,9303
36067,NY,Onondaga,,2008,5.1,221809,233793,11984
36067,NY,Onondaga,,2009,7.8,215560,233715,18155
36067,NY,Onondaga,,2010,8.2,217786,237164,19378
36067,NY,Onondaga,,2011,7.8,214840,232929,18089
36067,NY,Onondaga,,2012,8,214042,232618,18576
36067,NY,Onondaga,,2013,7,215189,231423,16234
36067,NY,Onondaga,,2014,5.6,211780,224355,12575
36067,NY,Onondaga,,2015,5,211070,222097,11027
36067,NY,Onondaga,,2016,4.6,211093,221252,10159
36067,NY,Onondaga,,2017,4.6,213395,223790,10395
36067,NY,Onondaga,,2018,4,215593,224527,8934
36067,NY,Onondaga,,2019,3.8,216807,225329,8522
36067,NY,Onondaga,,2020,8,206289,224224,17935
36067,NY,Onondaga,,2021,4.9,209099,219876,10777
36069,NY,Ontario,,2007,4.1,53810,56121,2311
36069,NY,Ontario,,2008,5.1,53662,56544,2882
36069,NY,Ontario,,2009,7.4,52770,56971,4201
36069,NY,Ontario,,2010,7.6,52132,56411,4279
36069,NY,Ontario,,2011,7.1,51845,55834,3989
36069,NY,Ontario,,2012,7.4,51830,55960,4130
36069,NY,Ontario,,2013,6.5,52231,55834,3603
36069,NY,Ontario,,2014,5.3,51815,54704,2889
36069,NY,Ontario,,2015,4.8,52355,54971,2616
36069,NY,Ontario,,2016,4.4,52667,55084,2417
36069,NY,Ontario,,2017,4.5,53365,55853,2488
36069,NY,Ontario,,2018,3.9,54359,56567,2208
36069,NY,Ontario,,2019,3.7,54688,56803,2115
36069,NY,Ontario,,2020,6.9,51828,55699,3871
36069,NY,Ontario,,2021,4.3,52622,54962,2340
36071,NY,Orange,,2007,4.2,171341,178890,7549
36071,NY,Orange,,2008,5.3,170568,180142,9574
36071,NY,Orange,,2009,8,166191,180557,14366
36071,NY,Orange,,2010,8.1,166688,181433,14745
36071,NY,Orange,,2011,7.8,165198,179117,13919
36071,NY,Orange,,2012,8,164966,179353,14387
36071,NY,Orange,,2013,7,166198,178723,12525
36071,NY,Orange,,2014,5.5,165500,175195,9695
36071,NY,Orange,,2015,4.7,169318,177655,8337
36071,NY,Orange,,2016,4.4,171096,178963,7867
36071,NY,Orange,,2017,4.5,175754,184071,8317
36071,NY,Orange,,2018,3.9,180244,187500,7256
36071,NY,Orange,,2019,3.6,184535,191494,6959
36071,NY,Orange,,2020,8,171729,186598,14869
36071,NY,Orange,,2021,4.7,175160,183818,8658
36073,NY,Orleans,,2007,5.7,18328,19435,1107
36073,NY,Orleans,,2008,6.9,18086,19419,1333
36073,NY,Orleans,,2009,9.5,17553,19388,1835
36073,NY,Orleans,,2010,9.8,17299,19174,1875
36073,NY,Orleans,,2011,9.3,17088,18842,1754
36073,NY,Orleans,,2012,9.8,16999,18852,1853
36073,NY,Orleans,,2013,9.3,16956,18699,1743
36073,NY,Orleans,,2014,7.7,16633,18026,1393
36073,NY,Orleans,,2015,6.4,16702,17846,1144
36073,NY,Orleans,,2016,5.8,16727,17760,1033
36073,NY,Orleans,,2017,5.9,16800,17847,1047
36073,NY,Orleans,,2018,4.9,17029,17910,881
36073,NY,Orleans,,2019,4.5,17110,17924,814
36073,NY,Orleans,,2020,8.1,15957,17354,1397
36073,NY,Orleans,,2021,5.2,16100,16976,876
36075,NY,Oswego,,2007,5.5,56021,59289,3268
36075,NY,Oswego,,2008,6.9,55918,60047,4129
36075,NY,Oswego,,2009,10,54081,60070,5989
36075,NY,Oswego,,2010,10.9,52573,58976,6403
36075,NY,Oswego,,2011,10.9,51792,58096,6304
36075,NY,Oswego,,2012,11.1,51445,57885,6440
36075,NY,Oswego,,2013,10.1,51407,57193,5786
36075,NY,Oswego,,2014,8.1,50518,54993,4475
36075,NY,Oswego,,2015,7.2,50041,53940,3899
36075,NY,Oswego,,2016,6.6,49835,53335,3500
36075,NY,Oswego,,2017,6.4,50231,53681,3450
36075,NY,Oswego,,2018,5.4,50939,53863,2924
36075,NY,Oswego,,2019,5.2,51056,53874,2818
36075,NY,Oswego,,2020,8.6,48386,52954,4568
36075,NY,Oswego,,2021,5.5,48999,51853,2854
36077,NY,Otsego,,2007,4.4,30159,31561,1402
36077,NY,Otsego,,2008,5.6,29689,31457,1768
36077,NY,Otsego,,2009,7.6,29229,31648,2419
36077,NY,Otsego,,2010,7.7,29443,31907,2464
36077,NY,Otsego,,2011,7.8,28972,31420,2448
36077,NY,Otsego,,2012,8,28909,31411,2502
36077,NY,Otsego,,2013,7,28920,31094,2174
36077,NY,Otsego,,2014,5.8,28240,29966,1726
36077,NY,Otsego,,2015,5.4,27100,28657,1557
36077,NY,Otsego,,2016,5,26806,28215,1409
36077,NY,Otsego,,2017,5,27119,28539,1420
36077,NY,Otsego,,2018,4.3,27397,28636,1239
36077,NY,Otsego,,2019,4.1,27394,28559,1165
36077,NY,Otsego,,2020,6.9,25196,27071,1875
36077,NY,Otsego,,2021,4.4,25595,26786,1191
36079,NY,Putnam,,2007,3.3,53725,55576,1851
36079,NY,Putnam,,2008,4.4,53204,55642,2438
36079,NY,Putnam,,2009,6.8,51273,55021,3748
36079,NY,Putnam,,2010,7.3,48765,52633,3868
36079,NY,Putnam,,2011,7.1,48016,51682,3666
36079,NY,Putnam,,2012,7.3,47769,51525,3756
36079,NY,Putnam,,2013,6.2,48099,51300,3201
36079,NY,Putnam,,2014,5,47713,50199,2486
36079,NY,Putnam,,2015,4.3,48354,50525,2171
36079,NY,Putnam,,2016,4.1,48646,50700,2054
36079,NY,Putnam,,2017,4.2,49642,51807,2165
36079,NY,Putnam,,2018,3.7,50259,52172,1913
36079,NY,Putnam,,2019,3.6,50452,52312,1860
36079,NY,Putnam,,2020,7.2,47520,51204,3684
36079,NY,Putnam,,2021,4.2,48268,50366,2098
36081,NY,Queens,,2007,4.3,1054783,1102462,47679
36081,NY,Queens,,2008,5,1070035,1126326,56291
36081,NY,Queens,,2009,8.4,1038748,1133603,94855
36081,NY,Queens,,2010,8.7,1018207,1114830,96623
36081,NY,Queens,,2011,8.1,1021978,1112280,90302
36081,NY,Queens,,2012,8.4,1029794,1123639,93845
36081,NY,Queens,,2013,7.7,1049995,1137783,87788
36081,NY,Queens,,2014,6.2,1077982,1149271,71289
36081,NY,Queens,,2015,4.9,1095485,1152142,56657
36081,NY,Queens,,2016,4.5,1099048,1150751,51703
36081,NY,Queens,,2017,3.9,1164592,1212317,47725
36081,NY,Queens,,2018,3.6,1156122,1198967,42845
36081,NY,Queens,,2019,3.4,1158834,1199264,40430
36081,NY,Queens,,2020,12.6,1005557,1150966,145409
36081,NY,Queens,,2021,9.6,1019350,1127854,108504
36083,NY,Rensselaer,,2007,4.2,79498,82971,3473
36083,NY,Rensselaer,,2008,5.1,79411,83684,4273
36083,NY,Rensselaer,,2009,7.5,77597,83921,6324
36083,NY,Rensselaer,,2010,7.9,77980,84679,6699
36083,NY,Rensselaer,,2011,7.7,76538,82885,6347
36083,NY,Rensselaer,,2012,7.9,76917,83475,6558
36083,NY,Rensselaer,,2013,6.8,77684,83391,5707
36083,NY,Rensselaer,,2014,5.4,76657,81048,4391
36083,NY,Rensselaer,,2015,4.7,77625,81439,3814
36083,NY,Rensselaer,,2016,4.4,78036,81585,3549
36083,NY,Rensselaer,,2017,4.4,78844,82480,3636
36083,NY,Rensselaer,,2018,3.9,79721,82929,3208
36083,NY,Rensselaer,,2019,3.6,80006,83012,3006
36083,NY,Rensselaer,,2020,6.7,76421,81921,5500
36083,NY,Rensselaer,,2021,4.4,77206,80735,3529
36085,NY,Richmond,,2007,4.4,229204,239804,10600
36085,NY,Richmond,,2008,5.1,232990,245424,12434
36085,NY,Richmond,,2009,8.2,226828,247007,20179
36085,NY,Richmond,,2010,9.5,197881,218630,20749
36085,NY,Richmond,,2011,9.2,197400,217461,20061
36085,NY,Richmond,,2012,9.6,197348,218185,20837
36085,NY,Richmond,,2013,8.9,200334,220021,19687
36085,NY,Richmond,,2014,7.3,203725,219670,15945
36085,NY,Richmond,,2015,5.7,206018,218528,12510
36085,NY,Richmond,,2016,5.2,207941,219313,11372
36085,NY,Richmond,,2017,4.6,219832,230331,10499
36085,NY,Richmond,,2018,4.1,224382,233890,9508
36085,NY,Richmond,,2019,3.7,227662,236515,8853
36085,NY,Richmond,,2020,10.6,199333,223073,23740
36085,NY,Richmond,,2021,8.7,201965,221184,19219
36087,NY,Rockland,,2007,3.8,147773,153592,5819
36087,NY,Rockland,,2008,4.7,147721,155013,7292
36087,NY,Rockland,,2009,7,143105,153887,10782
36087,NY,Rockland,,2010,7.6,138686,150109,11423
36087,NY,Rockland,,2011,7.2,138351,149100,10749
36087,NY,Rockland,,2012,7.4,139075,150225,11150
36087,NY,Rockland,,2013,6.4,140889,150571,9682
36087,NY,Rockland,,2014,5.2,141405,149157,7752
36087,NY,Rockland,,2015,4.6,144999,151923,6924
36087,NY,Rockland,,2016,4.3,146064,152561,6497
36087,NY,Rockland,,2017,4.3,149629,156380,6751
36087,NY,Rockland,,2018,3.7,151936,157770,5834
36087,NY,Rockland,,2019,3.4,154087,159539,5452
36087,NY,Rockland,,2020,7.7,143862,155842,11980
36087,NY,Rockland,,2021,4.4,147064,153829,6765
36089,NY,St. Lawrence,,2007,5.7,46422,49230,2808
36089,NY,St. Lawrence,,2008,7,46391,49885,3494
36089,NY,St. Lawrence,,2009,10,44835,49791,4956
36089,NY,St. Lawrence,,2010,10.5,44765,50019,5254
36089,NY,St. Lawrence,,2011,10.4,43858,48973,5115
36089,NY,St. Lawrence,,2012,10.3,43508,48530,5022
36089,NY,St. Lawrence,,2013,9.4,43931,48468,4537
36089,NY,St. Lawrence,,2014,7.8,43347,47022,3675
36089,NY,St. Lawrence,,2015,7.4,40602,43825,3223
36089,NY,St. Lawrence,,2016,6.7,40479,43387,2908
36089,NY,St. Lawrence,,2017,6.6,41187,44110,2923
36089,NY,St. Lawrence,,2018,5.6,41841,44306,2465
36089,NY,St. Lawrence,,2019,5.4,41723,44082,2359
36089,NY,St. Lawrence,,2020,7.9,40266,43703,3437
36089,NY,St. Lawrence,,2021,5.1,40730,42919,2189
36091,NY,Saratoga,,2007,3.6,114914,119208,4294
36091,NY,Saratoga,,2008,4.5,115542,120995,5453
36091,NY,Saratoga,,2009,6.5,114192,122067,7875
36091,NY,Saratoga,,2010,7,109818,118131,8313
36091,NY,Saratoga,,2011,6.7,108056,115824,7768
36091,NY,Saratoga,,2012,6.9,109223,117330,8107
36091,NY,Saratoga,,2013,6,110894,117926,7032
36091,NY,Saratoga,,2014,4.7,110057,115485,5428
36091,NY,Saratoga,,2015,4.2,111795,116670,4875
36091,NY,Saratoga,,2016,3.9,112934,117493,4559
36091,NY,Saratoga,,2017,3.9,115722,120478,4756
36091,NY,Saratoga,,2018,3.5,117408,121671,4263
36091,NY,Saratoga,,2019,3.2,118200,122162,3962
36091,NY,Saratoga,,2020,6.4,113590,121388,7798
36091,NY,Saratoga,,2021,3.8,114754,119267,4513
36093,NY,Schenectady,,2007,4.1,72334,75410,3076
36093,NY,Schenectady,,2008,5,72573,76416,3843
36093,NY,Schenectady,,2009,7.4,71134,76815,5681
36093,NY,Schenectady,,2010,7.8,72913,79085,6172
36093,NY,Schenectady,,2011,7.6,71348,77178,5830
36093,NY,Schenectady,,2012,7.8,71862,77934,6072
36093,NY,Schenectady,,2013,6.9,72602,77957,5355
36093,NY,Schenectady,,2014,5.4,71888,75998,4110
36093,NY,Schenectady,,2015,4.8,72028,75620,3592
36093,NY,Schenectady,,2016,4.4,72465,75807,3342
36093,NY,Schenectady,,2017,4.5,73869,77313,3444
36093,NY,Schenectady,,2018,4,74695,77799,3104
36093,NY,Schenectady,,2019,3.7,75277,78157,2880
36093,NY,Schenectady,,2020,7.7,72204,78220,6016
36093,NY,Schenectady,,2021,4.9,72958,76733,3775
36095,NY,Schoharie,,2007,5.7,14799,15691,892
36095,NY,Schoharie,,2008,6.8,14717,15786,1069
36095,NY,Schoharie,,2009,9,14183,15588,1405
36095,NY,Schoharie,,2010,9.1,14492,15942,1450
36095,NY,Schoharie,,2011,9,14174,15582,1408
36095,NY,Schoharie,,2012,9.3,13996,15435,1439
36095,NY,Schoharie,,2013,8.3,14013,15287,1274
36095,NY,Schoharie,,2014,6.8,13728,14724,996
36095,NY,Schoharie,,2015,5.8,13793,14650,857
36095,NY,Schoharie,,2016,5.5,13917,14731,814
36095,NY,Schoharie,,2017,5.4,14123,14936,813
36095,NY,Schoharie,,2018,4.8,14219,14935,716
36095,NY,Schoharie,,2019,4.5,14329,14999,670
36095,NY,Schoharie,,2020,6.8,13774,14783,1009
36095,NY,Schoharie,,2021,4.5,13852,14511,659
36097,NY,Schuyler,,2007,4.9,9458,9946,488
36097,NY,Schuyler,,2008,5.7,9501,10078,577
36097,NY,Schuyler,,2009,8.5,9206,10059,853
36097,NY,Schuyler,,2010,9.3,8213,9053,840
36097,NY,Schuyler,,2011,8.9,8219,9022,803
36097,NY,Schuyler,,2012,9.5,8162,9021,859
36097,NY,Schuyler,,2013,9,8073,8873,800
36097,NY,Schuyler,,2014,7.1,7987,8595,608
36097,NY,Schuyler,,2015,6.7,7784,8339,555
36097,NY,Schuyler,,2016,6.1,7775,8281,506
36097,NY,Schuyler,,2017,5.8,7881,8363,482
36097,NY,Schuyler,,2018,5.1,7974,8401,427
36097,NY,Schuyler,,2019,4.4,7887,8254,367
36097,NY,Schuyler,,2020,8.3,7500,8180,680
36097,NY,Schuyler,,2021,4.9,7649,8046,397
36099,NY,Seneca,,2007,4.4,16218,16960,742
36099,NY,Seneca,,2008,5.4,16123,17052,929
36099,NY,Seneca,,2009,7.7,15886,17212,1326
36099,NY,Seneca,,2010,8.4,15065,16439,1374
36099,NY,Seneca,,2011,8,14840,16127,1287
36099,NY,Seneca,,2012,8.1,14905,16217,1312
36099,NY,Seneca,,2013,7.1,14770,15901,1131
36099,NY,Seneca,,2014,5.7,14616,15497,881
36099,NY,Seneca,,2015,5.2,14883,15699,816
36099,NY,Seneca,,2016,4.8,14743,15494,751
36099,NY,Seneca,,2017,4.5,15631,16370,739
36099,NY,Seneca,,2018,3.8,15807,16437,630
36099,NY,Seneca,,2019,3.7,15722,16324,602
36099,NY,Seneca,,2020,7.8,14305,15516,1211
36099,NY,Seneca,,2021,4.7,14317,15025,708
36101,NY,Steuben,,2007,5.2,42337,44642,2305
36101,NY,Steuben,,2008,6,42828,45565,2737
36101,NY,Steuben,,2009,9.8,41528,46044,4516
36101,NY,Steuben,,2010,9.8,42744,47365,4621
36101,NY,Steuben,,2011,9.2,41952,46196,4244
36101,NY,Steuben,,2012,9.5,41432,45766,4334
36101,NY,Steuben,,2013,8.7,41698,45649,3951
36101,NY,Steuben,,2014,6.9,40980,44037,3057
36101,NY,Steuben,,2015,6.3,40872,43642,2770
36101,NY,Steuben,,2016,5.9,40628,43187,2559
36101,NY,Steuben,,2017,5.7,40984,43455,2471
36101,NY,Steuben,,2018,4.9,41388,43522,2134
36101,NY,Steuben,,2019,4.4,41579,43490,1911
36101,NY,Steuben,,2020,7.9,39303,42654,3351
36101,NY,Steuben,,2021,5,39389,41448,2059
36103,NY,Suffolk,,2007,3.8,756666,786514,29848
36103,NY,Suffolk,,2008,5,754554,793907,39353
36103,NY,Suffolk,,2009,7.4,733488,792114,58626
36103,NY,Suffolk,,2010,7.9,716989,778551,61562
36103,NY,Suffolk,,2011,7.7,712479,771638,59159
36103,NY,Suffolk,,2012,7.9,716784,778227,61443
36103,NY,Suffolk,,2013,6.8,727742,780519,52777
36103,NY,Suffolk,,2014,5.4,723564,765069,41505
36103,NY,Suffolk,,2015,4.7,738096,774850,36754
36103,NY,Suffolk,,2016,4.4,739954,774238,34284
36103,NY,Suffolk,,2017,4.4,755844,791045,35201
36103,NY,Suffolk,,2018,3.8,762913,793197,30284
36103,NY,Suffolk,,2019,3.6,769100,797446,28346
36103,NY,Suffolk,,2020,8.1,715866,778961,63095
36103,NY,Suffolk,,2021,4.6,740989,776355,35366
36105,NY,Sullivan,,2007,5.1,33353,35155,1802
36105,NY,Sullivan,,2008,6.4,33103,35380,2277
36105,NY,Sullivan,,2009,8.8,32273,35397,3124
36105,NY,Sullivan,,2010,9.1,33196,36509,3313
36105,NY,Sullivan,,2011,8.9,32361,35535,3174
36105,NY,Sullivan,,2012,9.2,32006,35265,3259
36105,NY,Sullivan,,2013,8.3,31677,34561,2884
36105,NY,Sullivan,,2014,6.6,31034,33241,2207
36105,NY,Sullivan,,2015,5.4,31826,33658,1832
36105,NY,Sullivan,,2016,4.9,32392,34048,1656
36105,NY,Sullivan,,2017,4.9,33233,34938,1705
36105,NY,Sullivan,,2018,4.1,35203,36701,1498
36105,NY,Sullivan,,2019,3.8,36028,37452,1424
36105,NY,Sullivan,,2020,8.4,33409,36460,3051
36105,NY,Sullivan,,2021,4.9,34350,36118,1768
36107,NY,Tioga,,2007,4.6,24923,26127,1204
36107,NY,Tioga,,2008,5.2,24797,26164,1367
36107,NY,Tioga,,2009,8.2,24098,26255,2157
36107,NY,Tioga,,2010,8.1,24427,26588,2161
36107,NY,Tioga,,2011,7.7,23851,25853,2002
36107,NY,Tioga,,2012,8,23394,25429,2035
36107,NY,Tioga,,2013,7.3,23121,24943,1822
36107,NY,Tioga,,2014,6.1,22288,23748,1460
36107,NY,Tioga,,2015,5.6,22042,23346,1304
36107,NY,Tioga,,2016,5.2,21824,23027,1203
36107,NY,Tioga,,2017,5.1,21984,23168,1184
36107,NY,Tioga,,2018,4.3,22344,23359,1015
36107,NY,Tioga,,2019,4,22267,23191,924
36107,NY,Tioga,,2020,7.5,20836,22528,1692
36107,NY,Tioga,,2021,4.4,21005,21974,969
36109,NY,Tompkins,,2007,3.3,53423,55255,1832
36109,NY,Tompkins,,2008,4.1,53517,55800,2283
36109,NY,Tompkins,,2009,6,53291,56668,3377
36109,NY,Tompkins,,2010,6.3,51355,54798,3443
36109,NY,Tompkins,,2011,6.1,50948,54259,3311
36109,NY,Tompkins,,2012,6.2,51558,54976,3418
36109,NY,Tompkins,,2013,5.3,52848,55830,2982
36109,NY,Tompkins,,2014,4.4,52262,54678,2416
36109,NY,Tompkins,,2015,4.4,48107,50336,2229
36109,NY,Tompkins,,2016,4.2,48245,50377,2132
36109,NY,Tompkins,,2017,4.3,48645,50839,2194
36109,NY,Tompkins,,2018,3.6,49252,51090,1838
36109,NY,Tompkins,,2019,3.5,48664,50428,1764
36109,NY,Tompkins,,2020,5.8,46632,49514,2882
36109,NY,Tompkins,,2021,3.7,47093,48914,1821
36111,NY,Ulster,,2007,4.3,86455,90314,3859
36111,NY,Ulster,,2008,5.4,85167,90018,4851
36111,NY,Ulster,,2009,7.8,82926,89978,7052
36111,NY,Ulster,,2010,7.9,86236,93679,7443
36111,NY,Ulster,,2011,7.9,84188,91417,7229
36111,NY,Ulster,,2012,8.4,83282,90914,7632
36111,NY,Ulster,,2013,7.3,83635,90249,6614
36111,NY,Ulster,,2014,5.7,82831,87883,5052
36111,NY,Ulster,,2015,4.8,83923,88193,4270
36111,NY,Ulster,,2016,4.5,84222,88189,3967
36111,NY,Ulster,,2017,4.5,85621,89679,4058
36111,NY,Ulster,,2018,3.9,86660,90161,3501
36111,NY,Ulster,,2019,3.6,86588,89833,3245
36111,NY,Ulster,,2020,7.7,80700,87421,6721
36111,NY,Ulster,,2021,4.7,82332,86356,4024
36113,NY,Warren,,2007,4.4,34666,36254,1588
36113,NY,Warren,,2008,5.6,34380,36405,2025
36113,NY,Warren,,2009,8,33520,36446,2926
36113,NY,Warren,,2010,9.2,31054,34192,3138
36113,NY,Warren,,2011,9,30644,33672,3028
36113,NY,Warren,,2012,9.3,30577,33716,3139
36113,NY,Warren,,2013,8.4,30340,33115,2775
36113,NY,Warren,,2014,6.6,30116,32260,2144
36113,NY,Warren,,2015,5.6,30407,32202,1795
36113,NY,Warren,,2016,5.3,30292,32003,1711
36113,NY,Warren,,2017,5.2,30733,32434,1701
36113,NY,Warren,,2018,4.6,30712,32202,1490
36113,NY,Warren,,2019,4.4,30502,31907,1405
36113,NY,Warren,,2020,8.1,28821,31372,2551
36113,NY,Warren,,2021,4.9,29531,31045,1514
36115,NY,Washington,,2007,4.1,31024,32343,1319
36115,NY,Washington,,2008,5.3,30879,32596,1717
36115,NY,Washington,,2009,7.6,30059,32518,2459
36115,NY,Washington,,2010,8.4,27716,30265,2549
36115,NY,Washington,,2011,8.2,27340,29772,2432
36115,NY,Washington,,2012,8.4,27351,29857,2506
36115,NY,Washington,,2013,7.7,27135,29383,2248
36115,NY,Washington,,2014,6.1,26779,28530,1751
36115,NY,Washington,,2015,5.1,27159,28605,1446
36115,NY,Washington,,2016,4.7,27012,28352,1340
36115,NY,Washington,,2017,4.6,27325,28646,1321
36115,NY,Washington,,2018,4.1,27356,28536,1180
36115,NY,Washington,,2019,3.9,27411,28525,1114
36115,NY,Washington,,2020,6.9,25668,27578,1910
36115,NY,Washington,,2021,4.6,26147,27402,1255
36117,NY,Wayne,,2007,4.6,45264,47470,2206
36117,NY,Wayne,,2008,5.8,45050,47814,2764
36117,NY,Wayne,,2009,8.5,43678,47710,4032
36117,NY,Wayne,,2010,9,43191,47452,4261
36117,NY,Wayne,,2011,8.5,42565,46497,3932
36117,NY,Wayne,,2012,8.7,42421,46460,4039
36117,NY,Wayne,,2013,7.8,42348,45916,3568
36117,NY,Wayne,,2014,6.2,41591,44353,2762
36117,NY,Wayne,,2015,5.4,41844,44217,2373
36117,NY,Wayne,,2016,5.1,41779,44010,2231
36117,NY,Wayne,,2017,4.9,42273,44470,2197
36117,NY,Wayne,,2018,4.1,42870,44711,1841
36117,NY,Wayne,,2019,3.9,43203,44937,1734
36117,NY,Wayne,,2020,7.1,40462,43562,3100
36117,NY,Wayne,,2021,4.5,40936,42847,1911
36119,NY,Westchester,,2007,3.6,470894,488704,17810
36119,NY,Westchester,,2008,4.7,468768,492072,23304
36119,NY,Westchester,,2009,7.2,452610,487767,35157
36119,NY,Westchester,,2010,7.5,443099,479056,35957
36119,NY,Westchester,,2011,7.1,440360,474161,33801
36119,NY,Westchester,,2012,7.4,441625,476735,35110
36119,NY,Westchester,,2013,6.4,446382,476999,30617
36119,NY,Westchester,,2014,5.2,445694,470006,24312
36119,NY,Westchester,,2015,4.6,455780,477632,21852
36119,NY,Westchester,,2016,4.4,457115,477963,20848
36119,NY,Westchester,,2017,4.5,467736,489676,21940
36119,NY,Westchester,,2018,3.9,473384,492401,19017
36119,NY,Westchester,,2019,3.6,479626,497594,17968
36119,NY,Westchester,,2020,8,446883,485745,38862
36119,NY,Westchester,,2021,4.8,457009,480109,23100
36121,NY,Wyoming,,2007,4.8,20351,21381,1030
36121,NY,Wyoming,,2008,6.1,19921,21224,1303
36121,NY,Wyoming,,2009,9.1,19127,21041,1914
36121,NY,Wyoming,,2010,9.6,17601,19470,1869
36121,NY,Wyoming,,2011,8.8,17246,18909,1663
36121,NY,Wyoming,,2012,9,17183,18876,1693
36121,NY,Wyoming,,2013,8.1,17272,18800,1528
36121,NY,Wyoming,,2014,6.6,17126,18331,1205
36121,NY,Wyoming,,2015,5.7,17307,18350,1043
36121,NY,Wyoming,,2016,5.4,17133,18115,982
36121,NY,Wyoming,,2017,5.6,17220,18237,1017
36121,NY,Wyoming,,2018,4.6,17508,18352,844
36121,NY,Wyoming,,2019,4.2,17742,18522,780
36121,NY,Wyoming,,2020,7.2,16866,18181,1315
36121,NY,Wyoming,,2021,4.5,17115,17916,801
36123,NY,Yates,,2007,4.1,12493,13030,537
36123,NY,Yates,,2008,4.8,12505,13140,635
36123,NY,Yates,,2009,6.9,12328,13235,907
36123,NY,Yates,,2010,7.5,11317,12239,922
36123,NY,Yates,,2011,7.6,11190,12104,914
36123,NY,Yates,,2012,7.9,11116,12071,955
36123,NY,Yates,,2013,7,11122,11961,839
36123,NY,Yates,,2014,5.7,11011,11677,666
36123,NY,Yates,,2015,5,11134,11722,588
36123,NY,Yates,,2016,4.5,11194,11720,526
36123,NY,Yates,,2017,4.4,11322,11838,516
36123,NY,Yates,,2018,3.7,11585,12036,451
36123,NY,Yates,,2019,3.6,11771,12208,437
36123,NY,Yates,,2020,6.3,11039,11777,738
36123,NY,Yates,,2021,3.8,11089,11527,438
37000,NC,North Carolina,,2007,5.1,4297692,4528594,230902
37000,NC,North Carolina,,2008,6.2,4296605,4578477,281872
37000,NC,North Carolina,,2009,11,4104074,4613198,509124
37000,NC,North Carolina,,2010,10.7,4135783,4633695,497912
37000,NC,North Carolina,,2011,10.3,4180071,4657873,477802
37000,NC,North Carolina,,2012,9.5,4271383,4720203,448820
37000,NC,North Carolina,,2013,7.8,4336379,4701391,365012
37000,NC,North Carolina,,2014,6.1,4410647,4698287,287640
37000,NC,North Carolina,,2015,5.7,4493882,4763821,269939
37000,NC,North Carolina,,2016,5.1,4598456,4844851,246395
37000,NC,North Carolina,,2017,4.5,4646212,4865900,219688
37000,NC,North Carolina,,2018,4,4719018,4915963,196945
37000,NC,North Carolina,,2019,3.8,4808270,4999810,191540
37000,NC,North Carolina,,2020,7.1,4505462,4848893,343431
37000,NC,North Carolina,,2021,4.8,4721198,4959672,238474
37001,NC,Alamance,,2007,5.5,66406,70249,3843
37001,NC,Alamance,,2008,6.4,66884,71473,4589
37001,NC,Alamance,,2009,12.2,63318,72085,8767
37001,NC,Alamance,,2010,10.8,68786,77083,8297
37001,NC,Alamance,,2011,9.6,70181,77660,7479
37001,NC,Alamance,,2012,8.7,71776,78641,6865
37001,NC,Alamance,,2013,7.1,71939,77398,5459
37001,NC,Alamance,,2014,5.5,72595,76826,4231
37001,NC,Alamance,,2015,5.3,73126,77206,4080
37001,NC,Alamance,,2016,4.7,74964,78694,3730
37001,NC,Alamance,,2017,4.3,75458,78810,3352
37001,NC,Alamance,,2018,3.8,76663,79720,3057
37001,NC,Alamance,,2019,3.8,78642,81719,3077
37001,NC,Alamance,,2020,7,73409,78921,5512
37001,NC,Alamance,,2021,4.8,77122,81009,3887
37003,NC,Alexander,,2007,5.7,17244,18278,1034
37003,NC,Alexander,,2008,7,17006,18289,1283
37003,NC,Alexander,,2009,14.5,15721,18379,2658
37003,NC,Alexander,,2010,12.9,15955,18322,2367
37003,NC,Alexander,,2011,11.3,15961,17989,2028
37003,NC,Alexander,,2012,9.8,16078,17826,1748
37003,NC,Alexander,,2013,7.6,16189,17513,1324
37003,NC,Alexander,,2014,5.5,16518,17471,953
37003,NC,Alexander,,2015,4.9,16671,17523,852
37003,NC,Alexander,,2016,4.3,17022,17778,756
37003,NC,Alexander,,2017,3.6,17073,17718,645
37003,NC,Alexander,,2018,3.2,17121,17692,571
37003,NC,Alexander,,2019,3.3,17231,17812,581
37003,NC,Alexander,,2020,7.3,15874,17127,1253
37003,NC,Alexander,,2021,4.2,16553,17283,730
37005,NC,Alleghany,,2007,5.6,4642,4917,275
37005,NC,Alleghany,,2008,7.5,4226,4569,343
37005,NC,Alleghany,,2009,12.4,4130,4714,584
37005,NC,Alleghany,,2010,11.9,4199,4764,565
37005,NC,Alleghany,,2011,12.2,4086,4655,569
37005,NC,Alleghany,,2012,10.7,4148,4643,495
37005,NC,Alleghany,,2013,8.5,4047,4425,378
37005,NC,Alleghany,,2014,6.6,4099,4390,291
37005,NC,Alleghany,,2015,6.1,4191,4462,271
37005,NC,Alleghany,,2016,5.5,4170,4413,243
37005,NC,Alleghany,,2017,5.1,4083,4301,218
37005,NC,Alleghany,,2018,4.6,4058,4253,195
37005,NC,Alleghany,,2019,4.6,4149,4351,202
37005,NC,Alleghany,,2020,7.1,3814,4105,291
37005,NC,Alleghany,,2021,4.6,4029,4224,195
37007,NC,Anson,,2007,7.9,9541,10361,820
37007,NC,Anson,,2008,8.9,9381,10295,914
37007,NC,Anson,,2009,15.4,8639,10209,1570
37007,NC,Anson,,2010,14,9649,11217,1568
37007,NC,Anson,,2011,12.3,9787,11157,1370
37007,NC,Anson,,2012,11.2,9910,11158,1248
37007,NC,Anson,,2013,9.2,9928,10934,1006
37007,NC,Anson,,2014,6.9,10166,10918,752
37007,NC,Anson,,2015,6.5,10119,10817,698
37007,NC,Anson,,2016,5.8,10011,10627,616
37007,NC,Anson,,2017,5.2,9841,10377,536
37007,NC,Anson,,2018,4.5,9807,10271,464
37007,NC,Anson,,2019,4.1,10192,10626,434
37007,NC,Anson,,2020,7.4,9351,10100,749
37007,NC,Anson,,2021,6.3,9469,10111,642
37009,NC,Ashe,,2007,5.4,12416,13127,711
37009,NC,Ashe,,2008,6.8,11751,12605,854
37009,NC,Ashe,,2009,12.5,11088,12677,1589
37009,NC,Ashe,,2010,11.7,12159,13771,1612
37009,NC,Ashe,,2011,11,11859,13318,1459
37009,NC,Ashe,,2012,10.7,11881,13302,1421
37009,NC,Ashe,,2013,8.9,11725,12877,1152
37009,NC,Ashe,,2014,6.7,11586,12412,826
37009,NC,Ashe,,2015,5.9,11566,12297,731
37009,NC,Ashe,,2016,4.8,11870,12468,598
37009,NC,Ashe,,2017,4.1,11970,12483,513
37009,NC,Ashe,,2018,3.7,12063,12521,458
37009,NC,Ashe,,2019,3.6,12297,12759,462
37009,NC,Ashe,,2020,6.1,11501,12245,744
37009,NC,Ashe,,2021,4,12113,12614,501
37011,NC,Avery,,2007,5.1,7865,8285,420
37011,NC,Avery,,2008,5.7,8354,8863,509
37011,NC,Avery,,2009,9.7,8189,9065,876
37011,NC,Avery,,2010,10.7,7124,7974,850
37011,NC,Avery,,2011,11.1,6941,7808,867
37011,NC,Avery,,2012,10.9,6962,7812,850
37011,NC,Avery,,2013,8.7,7029,7699,670
37011,NC,Avery,,2014,6.4,7165,7651,486
37011,NC,Avery,,2015,5.9,7082,7524,442
37011,NC,Avery,,2016,5,7171,7551,380
37011,NC,Avery,,2017,4.3,7208,7530,322
37011,NC,Avery,,2018,3.7,7213,7491,278
37011,NC,Avery,,2019,3.6,7189,7461,272
37011,NC,Avery,,2020,6.1,6660,7095,435
37011,NC,Avery,,2021,3.9,7089,7380,291
37013,NC,Beaufort,,2007,6,20110,21404,1294
37013,NC,Beaufort,,2008,7.2,19336,20829,1493
37013,NC,Beaufort,,2009,11.8,18505,20992,2487
37013,NC,Beaufort,,2010,11.6,18783,21252,2469
37013,NC,Beaufort,,2011,11.1,19189,21592,2403
37013,NC,Beaufort,,2012,10.8,18934,21237,2303
37013,NC,Beaufort,,2013,9.2,18592,20483,1891
37013,NC,Beaufort,,2014,7.1,18653,20087,1434
37013,NC,Beaufort,,2015,6.5,18786,20094,1308
37013,NC,Beaufort,,2016,5.7,19091,20244,1153
37013,NC,Beaufort,,2017,5.1,18712,19708,996
37013,NC,Beaufort,,2018,4.7,18499,19405,906
37013,NC,Beaufort,,2019,4.5,18512,19384,872
37013,NC,Beaufort,,2020,6.1,17684,18841,1157
37013,NC,Beaufort,,2021,4.8,18537,19472,935
37015,NC,Bertie,,2007,6,8320,8855,535
37015,NC,Bertie,,2008,7.6,8064,8731,667
37015,NC,Bertie,,2009,11.4,8064,9102,1038
37015,NC,Bertie,,2010,11.7,8148,9225,1077
37015,NC,Bertie,,2011,12,8019,9115,1096
37015,NC,Bertie,,2012,11.7,7726,8746,1020
37015,NC,Bertie,,2013,9.8,7641,8470,829
37015,NC,Bertie,,2014,7.7,7865,8518,653
37015,NC,Bertie,,2015,7.1,7979,8592,613
37015,NC,Bertie,,2016,6.6,7854,8411,557
37015,NC,Bertie,,2017,5.9,7495,7966,471
37015,NC,Bertie,,2018,5,7340,7726,386
37015,NC,Bertie,,2019,4.7,7381,7742,361
37015,NC,Bertie,,2020,6.2,6922,7377,455
37015,NC,Bertie,,2021,5.9,6778,7203,425
37017,NC,Bladen,,2007,6.7,14693,15742,1049
37017,NC,Bladen,,2008,7.8,14307,15510,1203
37017,NC,Bladen,,2009,12.7,13536,15505,1969
37017,NC,Bladen,,2010,13.2,13233,15244,2011
37017,NC,Bladen,,2011,13.4,12941,14941,2000
37017,NC,Bladen,,2012,13,12691,14587,1896
37017,NC,Bladen,,2013,11.2,12746,14356,1610
37017,NC,Bladen,,2014,9.1,12981,14284,1303
37017,NC,Bladen,,2015,7.9,13563,14721,1158
37017,NC,Bladen,,2016,6.9,13519,14524,1005
37017,NC,Bladen,,2017,5.8,13389,14219,830
37017,NC,Bladen,,2018,5.4,13418,14177,759
37017,NC,Bladen,,2019,4.7,13766,14440,674
37017,NC,Bladen,,2020,7,13069,14056,987
37017,NC,Bladen,,2021,5.8,13397,14223,826
37019,NC,Brunswick,,2007,4.9,45622,47983,2361
37019,NC,Brunswick,,2008,6.4,46940,50139,3199
37019,NC,Brunswick,,2009,11.2,45703,51452,5749
37019,NC,Brunswick,,2010,12.4,40898,46692,5794
37019,NC,Brunswick,,2011,12.2,41500,47271,5771
37019,NC,Brunswick,,2012,11.5,42283,47781,5498
37019,NC,Brunswick,,2013,9.5,43204,47749,4545
37019,NC,Brunswick,,2014,7.7,44026,47685,3659
37019,NC,Brunswick,,2015,7.2,44982,48478,3496
37019,NC,Brunswick,,2016,6.5,46354,49551,3197
37019,NC,Brunswick,,2017,5.7,47744,50612,2868
37019,NC,Brunswick,,2018,5.4,49625,52434,2809
37019,NC,Brunswick,,2019,5.2,51350,54152,2802
37019,NC,Brunswick,,2020,8.5,47353,51779,4426
37019,NC,Brunswick,,2021,6,50920,54167,3247
37021,NC,Buncombe,,2007,3.8,115900,120498,4598
37021,NC,Buncombe,,2008,4.7,116987,122757,5770
37021,NC,Buncombe,,2009,8.7,112255,122941,10686
37021,NC,Buncombe,,2010,8.5,113649,124191,10542
37021,NC,Buncombe,,2011,7.9,115383,125337,9954
37021,NC,Buncombe,,2012,7.4,117988,127452,9464
37021,NC,Buncombe,,2013,5.8,120533,127980,7447
37021,NC,Buncombe,,2014,4.6,121978,127808,5830
37021,NC,Buncombe,,2015,4.3,124676,130295,5619
37021,NC,Buncombe,,2016,3.9,128768,133951,5183
37021,NC,Buncombe,,2017,3.4,130012,134657,4645
37021,NC,Buncombe,,2018,3,132876,137044,4168
37021,NC,Buncombe,,2019,3,135391,139527,4136
37021,NC,Buncombe,,2020,8.1,122736,133508,10772
37021,NC,Buncombe,,2021,4.2,130418,136123,5705
37023,NC,Burke,,2007,6.4,37662,40252,2590
37023,NC,Burke,,2008,8.2,37161,40462,3301
37023,NC,Burke,,2009,14.7,34201,40114,5913
37023,NC,Burke,,2010,12.8,36483,41829,5346
37023,NC,Burke,,2011,11.4,36680,41414,4734
37023,NC,Burke,,2012,10.1,36909,41048,4139
37023,NC,Burke,,2013,8.1,36937,40173,3236
37023,NC,Burke,,2014,6,36989,39369,2380
37023,NC,Burke,,2015,5.6,37103,39285,2182
37023,NC,Burke,,2016,4.9,37798,39733,1935
37023,NC,Burke,,2017,4.2,38249,39923,1674
37023,NC,Burke,,2018,3.7,38784,40264,1480
37023,NC,Burke,,2019,3.7,38941,40428,1487
37023,NC,Burke,,2020,7,35905,38606,2701
37023,NC,Burke,,2021,4.5,37481,39264,1783
37025,NC,Cabarrus,,2007,4.8,78964,82931,3967
37025,NC,Cabarrus,,2008,5.7,80371,85255,4884
37025,NC,Cabarrus,,2009,11.4,75860,85639,9779
37025,NC,Cabarrus,,2010,11.4,79159,89365,10206
37025,NC,Cabarrus,,2011,10.4,80923,90307,9384
37025,NC,Cabarrus,,2012,9.2,83642,92135,8493
37025,NC,Cabarrus,,2013,7.4,85569,92401,6832
37025,NC,Cabarrus,,2014,5.7,89007,94343,5336
37025,NC,Cabarrus,,2015,5.1,92526,97511,4985
37025,NC,Cabarrus,,2016,4.6,96254,100864,4610
37025,NC,Cabarrus,,2017,4.2,98929,103213,4284
37025,NC,Cabarrus,,2018,3.7,101702,105577,3875
37025,NC,Cabarrus,,2019,3.5,105158,109018,3860
37025,NC,Cabarrus,,2020,6.7,99996,107171,7175
37025,NC,Cabarrus,,2021,4.4,104845,109654,4809
37027,NC,Caldwell,,2007,7.6,35691,38639,2948
37027,NC,Caldwell,,2008,7.8,35332,38311,2979
37027,NC,Caldwell,,2009,15.6,32391,38395,6004
37027,NC,Caldwell,,2010,14.7,32701,38334,5633
37027,NC,Caldwell,,2011,13.2,32571,37542,4971
37027,NC,Caldwell,,2012,11.9,32811,37235,4424
37027,NC,Caldwell,,2013,9.3,33027,36422,3395
37027,NC,Caldwell,,2014,7.1,32983,35487,2504
37027,NC,Caldwell,,2015,6.2,33234,35421,2187
37027,NC,Caldwell,,2016,5.2,33928,35786,1858
37027,NC,Caldwell,,2017,4.5,34392,35997,1605
37027,NC,Caldwell,,2018,3.9,34479,35882,1403
37027,NC,Caldwell,,2019,4,34642,36080,1438
37027,NC,Caldwell,,2020,7.7,31936,34593,2657
37027,NC,Caldwell,,2021,4.9,33340,35073,1733
37029,NC,Camden,,2007,4.3,4434,4634,200
37029,NC,Camden,,2008,5.4,4312,4559,247
37029,NC,Camden,,2009,8.8,4108,4502,394
37029,NC,Camden,,2010,8.3,4230,4612,382
37029,NC,Camden,,2011,8.5,4221,4614,393
37029,NC,Camden,,2012,8,4191,4557,366
37029,NC,Camden,,2013,6.9,4218,4531,313
37029,NC,Camden,,2014,5.9,4284,4553,269
37029,NC,Camden,,2015,5.7,4347,4608,261
37029,NC,Camden,,2016,5.1,4404,4643,239
37029,NC,Camden,,2017,4.4,4457,4660,203
37029,NC,Camden,,2018,3.8,4464,4640,176
37029,NC,Camden,,2019,3.8,4491,4666,175
37029,NC,Camden,,2020,5.4,4208,4446,238
37029,NC,Camden,,2021,3.9,4336,4514,178
37031,NC,Carteret,,2007,4.3,31880,33324,1444
37031,NC,Carteret,,2008,5.4,31109,32879,1770
37031,NC,Carteret,,2009,9,29922,32898,2976
37031,NC,Carteret,,2010,9.5,28511,31496,2985
37031,NC,Carteret,,2011,9.7,28112,31130,3018
37031,NC,Carteret,,2012,9.1,28859,31763,2904
37031,NC,Carteret,,2013,7.6,28867,31237,2370
37031,NC,Carteret,,2014,6,29208,31079,1871
37031,NC,Carteret,,2015,5.8,29472,31300,1828
37031,NC,Carteret,,2016,5.2,29850,31473,1623
37031,NC,Carteret,,2017,4.4,30080,31480,1400
37031,NC,Carteret,,2018,4.4,30060,31440,1380
37031,NC,Carteret,,2019,4.1,30527,31819,1292
37031,NC,Carteret,,2020,6.1,28486,30331,1845
37031,NC,Carteret,,2021,4.1,29867,31149,1282
37033,NC,Caswell,,2007,7.2,9987,10762,775
37033,NC,Caswell,,2008,8.1,9922,10793,871
37033,NC,Caswell,,2009,13,9542,10973,1431
37033,NC,Caswell,,2010,13.1,8779,10102,1323
37033,NC,Caswell,,2011,11.8,8966,10162,1196
37033,NC,Caswell,,2012,10.9,8954,10050,1096
37033,NC,Caswell,,2013,8.8,9009,9873,864
37033,NC,Caswell,,2014,7,8976,9652,676
37033,NC,Caswell,,2015,6.2,9014,9613,599
37033,NC,Caswell,,2016,5.4,9135,9661,526
37033,NC,Caswell,,2017,4.7,9175,9630,455
37033,NC,Caswell,,2018,4.5,9257,9690,433
37033,NC,Caswell,,2019,4.4,9345,9776,431
37033,NC,Caswell,,2020,7.5,8684,9390,706
37033,NC,Caswell,,2021,5.3,8970,9473,503
37035,NC,Catawba,,2007,5.9,72163,76726,4563
37035,NC,Catawba,,2008,7.1,71548,77036,5488
37035,NC,Catawba,,2009,14.5,66567,77896,11329
37035,NC,Catawba,,2010,12.9,68058,78163,10105
37035,NC,Catawba,,2011,11.7,68220,77222,9002
37035,NC,Catawba,,2012,10.4,69223,77247,8024
37035,NC,Catawba,,2013,8.3,69845,76133,6288
37035,NC,Catawba,,2014,6.2,70051,74659,4608
37035,NC,Catawba,,2015,5.4,70986,75074,4088
37035,NC,Catawba,,2016,4.7,73016,76648,3632
37035,NC,Catawba,,2017,4.2,74314,77535,3221
37035,NC,Catawba,,2018,3.6,74780,77563,2783
37035,NC,Catawba,,2019,3.5,75402,78173,2771
37035,NC,Catawba,,2020,7.8,69884,75769,5885
37035,NC,Catawba,,2021,4.7,72869,76433,3564
37037,NC,Chatham,,2007,4.1,31244,32586,1342
37037,NC,Chatham,,2008,4.9,32226,33898,1672
37037,NC,Chatham,,2009,8.3,31746,34609,2863
37037,NC,Chatham,,2010,8.5,28176,30780,2604
37037,NC,Chatham,,2011,8.1,28750,31285,2535
37037,NC,Chatham,,2012,8,29313,31875,2562
37037,NC,Chatham,,2013,6.1,29700,31632,1932
37037,NC,Chatham,,2014,4.7,30729,32257,1528
37037,NC,Chatham,,2015,4.7,31789,33354,1565
37037,NC,Chatham,,2016,4.2,32957,34416,1459
37037,NC,Chatham,,2017,3.9,32374,33681,1307
37037,NC,Chatham,,2018,3.4,33426,34613,1187
37037,NC,Chatham,,2019,3.3,34710,35904,1194
37037,NC,Chatham,,2020,5.2,33157,34968,1811
37037,NC,Chatham,,2021,3.6,35108,36405,1297
37039,NC,Cherokee,,2007,6.7,9590,10280,690
37039,NC,Cherokee,,2008,9.2,9099,10021,922
37039,NC,Cherokee,,2009,15.9,8480,10089,1609
37039,NC,Cherokee,,2010,12.8,10200,11694,1494
37039,NC,Cherokee,,2011,11.8,10277,11657,1380
37039,NC,Cherokee,,2012,11.2,10232,11525,1293
37039,NC,Cherokee,,2013,9,10269,11281,1012
37039,NC,Cherokee,,2014,6.9,10337,11102,765
37039,NC,Cherokee,,2015,6.4,10400,11108,708
37039,NC,Cherokee,,2016,5.7,10479,11111,632
37039,NC,Cherokee,,2017,5,10467,11015,548
37039,NC,Cherokee,,2018,4.5,10608,11112,504
37039,NC,Cherokee,,2019,4.4,10633,11122,489
37039,NC,Cherokee,,2020,7.7,9832,10654,822
37039,NC,Cherokee,,2021,5,10066,10592,526
37041,NC,Chowan,,2007,6.6,6683,7157,474
37041,NC,Chowan,,2008,8.7,6137,6721,584
37041,NC,Chowan,,2009,12.3,5787,6598,811
37041,NC,Chowan,,2010,11.9,5440,6173,733
37041,NC,Chowan,,2011,12.2,5261,5989,728
37041,NC,Chowan,,2012,11.1,5294,5958,664
37041,NC,Chowan,,2013,9.6,5180,5728,548
37041,NC,Chowan,,2014,7.7,5241,5676,435
37041,NC,Chowan,,2015,7.1,5236,5634,398
37041,NC,Chowan,,2016,6.4,5227,5585,358
37041,NC,Chowan,,2017,5.3,5228,5520,292
37041,NC,Chowan,,2018,4.5,5258,5506,248
37041,NC,Chowan,,2019,4.5,5250,5500,250
37041,NC,Chowan,,2020,5.9,4987,5301,314
37041,NC,Chowan,,2021,4.9,5238,5510,272
37043,NC,Clay,,2007,4.4,4703,4917,214
37043,NC,Clay,,2008,6.5,4376,4678,302
37043,NC,Clay,,2009,12.2,4084,4649,565
37043,NC,Clay,,2010,12.4,3730,4257,527
37043,NC,Clay,,2011,11.5,3687,4168,481
37043,NC,Clay,,2012,10.6,3758,4204,446
37043,NC,Clay,,2013,8.5,3715,4061,346
37043,NC,Clay,,2014,6.4,3842,4103,261
37043,NC,Clay,,2015,6,3795,4038,243
37043,NC,Clay,,2016,5.5,3818,4039,221
37043,NC,Clay,,2017,5,3702,3896,194
37043,NC,Clay,,2018,4.4,3886,4066,180
37043,NC,Clay,,2019,4.4,3931,4114,183
37043,NC,Clay,,2020,7.2,3687,3973,286
37043,NC,Clay,,2021,4.9,3775,3970,195
37045,NC,Cleveland,,2007,6.4,46392,49586,3194
37045,NC,Cleveland,,2008,8.2,45002,49045,4043
37045,NC,Cleveland,,2009,15.7,41446,49153,7707
37045,NC,Cleveland,,2010,14.6,39084,45779,6695
37045,NC,Cleveland,,2011,12.4,40419,46118,5699
37045,NC,Cleveland,,2012,11.3,40947,46165,5218
37045,NC,Cleveland,,2013,9.2,42291,46592,4301
37045,NC,Cleveland,,2014,7.1,42710,45968,3258
37045,NC,Cleveland,,2015,6.3,43129,46037,2908
37045,NC,Cleveland,,2016,5.5,44114,46669,2555
37045,NC,Cleveland,,2017,4.6,44647,46812,2165
37045,NC,Cleveland,,2018,4,45326,47220,1894
37045,NC,Cleveland,,2019,3.9,46361,48241,1880
37045,NC,Cleveland,,2020,7.6,43522,47102,3580
37045,NC,Cleveland,,2021,5.3,45132,47667,2535
37047,NC,Columbus,,2007,5.8,23023,24447,1424
37047,NC,Columbus,,2008,7.8,22371,24252,1881
37047,NC,Columbus,,2009,13.4,21375,24688,3313
37047,NC,Columbus,,2010,13.3,21046,24265,3219
37047,NC,Columbus,,2011,13.4,20847,24067,3220
37047,NC,Columbus,,2012,12.5,20464,23400,2936
37047,NC,Columbus,,2013,10,21695,24109,2414
37047,NC,Columbus,,2014,8.3,21106,23009,1903
37047,NC,Columbus,,2015,7.4,20901,22581,1680
37047,NC,Columbus,,2016,6.4,21081,22528,1447
37047,NC,Columbus,,2017,5.5,20772,21973,1201
37047,NC,Columbus,,2018,5.1,20940,22055,1115
37047,NC,Columbus,,2019,4.9,21485,22583,1098
37047,NC,Columbus,,2020,7.8,20209,21929,1720
37047,NC,Columbus,,2021,6.3,20994,22400,1406
37049,NC,Craven,,2007,4.6,41363,43367,2004
37049,NC,Craven,,2008,6,39745,42264,2519
37049,NC,Craven,,2009,10.8,38104,42724,4620
37049,NC,Craven,,2010,10.6,37928,42438,4510
37049,NC,Craven,,2011,10.5,37703,42148,4445
37049,NC,Craven,,2012,9.7,38135,42237,4102
37049,NC,Craven,,2013,8.4,38026,41528,3502
37049,NC,Craven,,2014,6.7,38332,41089,2757
37049,NC,Craven,,2015,6,38826,41295,2469
37049,NC,Craven,,2016,5.2,39448,41628,2180
37049,NC,Craven,,2017,4.6,39252,41162,1910
37049,NC,Craven,,2018,4.3,39187,40942,1755
37049,NC,Craven,,2019,4,39649,41296,1647
37049,NC,Craven,,2020,6.3,37305,39827,2522
37049,NC,Craven,,2021,4.7,38789,40693,1904
37051,NC,Cumberland,,2007,5.7,122499,129942,7443
37051,NC,Cumberland,,2008,6.2,125512,133744,8232
37051,NC,Cumberland,,2009,9.3,125326,138201,12875
37051,NC,Cumberland,,2010,10,118405,131605,13200
37051,NC,Cumberland,,2011,10.6,119247,133317,14070
37051,NC,Cumberland,,2012,10.8,119256,133635,14379
37051,NC,Cumberland,,2013,9.4,118696,130999,12303
37051,NC,Cumberland,,2014,7.8,117510,127501,9991
37051,NC,Cumberland,,2015,7.2,117001,126103,9102
37051,NC,Cumberland,,2016,6.4,118818,126947,8129
37051,NC,Cumberland,,2017,5.7,118662,125896,7234
37051,NC,Cumberland,,2018,5.2,119228,125817,6589
37051,NC,Cumberland,,2019,5,120485,126870,6385
37051,NC,Cumberland,,2020,9.1,112350,123636,11286
37051,NC,Cumberland,,2021,6.9,116685,125305,8620
37053,NC,Currituck,,2007,3.4,12127,12557,430
37053,NC,Currituck,,2008,4.4,12280,12847,567
37053,NC,Currituck,,2009,7.2,11882,12801,919
37053,NC,Currituck,,2010,8.8,11158,12236,1078
37053,NC,Currituck,,2011,9.1,11293,12417,1124
37053,NC,Currituck,,2012,8.8,11464,12566,1102
37053,NC,Currituck,,2013,7.7,11660,12628,968
37053,NC,Currituck,,2014,6.1,11935,12712,777
37053,NC,Currituck,,2015,5.7,12099,12833,734
37053,NC,Currituck,,2016,5.1,12446,13111,665
37053,NC,Currituck,,2017,4.3,12806,13388,582
37053,NC,Currituck,,2018,3.6,13300,13800,500
37053,NC,Currituck,,2019,3.5,13707,14205,498
37053,NC,Currituck,,2020,6,13214,14055,841
37053,NC,Currituck,,2021,4.1,13632,14215,583
37055,NC,Dare,,2007,5.3,21547,22742,1195
37055,NC,Dare,,2008,6.5,20671,22102,1431
37055,NC,Dare,,2009,10.6,19622,21942,2320
37055,NC,Dare,,2010,12,17382,19761,2379
37055,NC,Dare,,2011,13.1,17541,20174,2633
37055,NC,Dare,,2012,12.6,18268,20913,2645
37055,NC,Dare,,2013,10.9,18323,20555,2232
37055,NC,Dare,,2014,8.2,18457,20099,1642
37055,NC,Dare,,2015,7.4,18781,20275,1494
37055,NC,Dare,,2016,6.8,18593,19939,1346
37055,NC,Dare,,2017,5.9,18659,19824,1165
37055,NC,Dare,,2018,5.2,18663,19681,1018
37055,NC,Dare,,2019,4.6,18976,19897,921
37055,NC,Dare,,2020,9.7,17258,19102,1844
37055,NC,Dare,,2021,6,18462,19631,1169
37057,NC,Davidson,,2007,6,74889,79680,4791
37057,NC,Davidson,,2008,7.1,72485,78037,5552
37057,NC,Davidson,,2009,13.3,67934,78371,10437
37057,NC,Davidson,,2010,12.2,71050,80902,9852
37057,NC,Davidson,,2011,11,71042,79829,8787
37057,NC,Davidson,,2012,9.9,72328,80304,7976
37057,NC,Davidson,,2013,8,73107,79435,6328
37057,NC,Davidson,,2014,6.1,73589,78382,4793
37057,NC,Davidson,,2015,5.5,74333,78652,4319
37057,NC,Davidson,,2016,4.8,75444,79258,3814
37057,NC,Davidson,,2017,4.3,75125,78497,3372
37057,NC,Davidson,,2018,3.7,76323,79268,2945
37057,NC,Davidson,,2019,3.6,77477,80389,2912
37057,NC,Davidson,,2020,6.8,72340,77645,5305
37057,NC,Davidson,,2021,4.5,75503,79091,3588
37059,NC,Davie,,2007,5.3,19570,20656,1086
37059,NC,Davie,,2008,6.1,19762,21035,1273
37059,NC,Davie,,2009,11.8,18522,21007,2485
37059,NC,Davie,,2010,11.7,17966,20338,2372
37059,NC,Davie,,2011,10.6,17973,20101,2128
37059,NC,Davie,,2012,9.3,18293,20166,1873
37059,NC,Davie,,2013,7.3,18542,20000,1458
37059,NC,Davie,,2014,5.7,18564,19684,1120
37059,NC,Davie,,2015,5,18843,19828,985
37059,NC,Davie,,2016,4.5,19202,20107,905
37059,NC,Davie,,2017,4,19257,20057,800
37059,NC,Davie,,2018,3.5,19545,20252,707
37059,NC,Davie,,2019,3.3,19772,20457,685
37059,NC,Davie,,2020,6.5,18470,19763,1293
37059,NC,Davie,,2021,4.3,19269,20130,861
37061,NC,Duplin,,2007,4.8,23187,24359,1172
37061,NC,Duplin,,2008,5.8,22720,24122,1402
37061,NC,Duplin,,2009,9.9,22215,24645,2430
37061,NC,Duplin,,2010,9.2,23531,25908,2377
37061,NC,Duplin,,2011,9.4,23879,26368,2489
37061,NC,Duplin,,2012,9.3,24156,26646,2490
37061,NC,Duplin,,2013,7.8,24439,26494,2055
37061,NC,Duplin,,2014,6.2,24937,26586,1649
37061,NC,Duplin,,2015,5.7,24962,26459,1497
37061,NC,Duplin,,2016,5.3,25012,26422,1410
37061,NC,Duplin,,2017,4.9,23873,25093,1220
37061,NC,Duplin,,2018,4.4,23611,24688,1077
37061,NC,Duplin,,2019,3.9,24172,25166,994
37061,NC,Duplin,,2020,5.4,22781,24090,1309
37061,NC,Duplin,,2021,4.4,23200,24263,1063
37063,NC,Durham,,2007,4.1,131286,136911,5625
37063,NC,Durham,,2008,4.7,135129,141862,6733
37063,NC,Durham,,2009,8.1,133083,144806,11723
37063,NC,Durham,,2010,8.2,132237,143974,11737
37063,NC,Durham,,2011,8.1,134256,146063,11807
37063,NC,Durham,,2012,7.6,138530,149901,11371
37063,NC,Durham,,2013,6.1,141530,150701,9171
37063,NC,Durham,,2014,5,145417,153026,7609
37063,NC,Durham,,2015,5,148713,156464,7751
37063,NC,Durham,,2016,4.5,154321,161608,7287
37063,NC,Durham,,2017,4.1,156312,162911,6599
37063,NC,Durham,,2018,3.6,160424,166378,5954
37063,NC,Durham,,2019,3.4,166108,171887,5779
37063,NC,Durham,,2020,6.2,158846,169356,10510
37063,NC,Durham,,2021,4.1,167710,174877,7167
37065,NC,Edgecombe,,2007,8.1,22415,24384,1969
37065,NC,Edgecombe,,2008,10.2,22101,24605,2504
37065,NC,Edgecombe,,2009,16.5,20645,24711,4066
37065,NC,Edgecombe,,2010,15.6,21591,25579,3988
37065,NC,Edgecombe,,2011,15.5,21171,25056,3885
37065,NC,Edgecombe,,2012,14.6,20997,24601,3604
37065,NC,Edgecombe,,2013,12.6,20937,23964,3027
37065,NC,Edgecombe,,2014,10,20885,23213,2328
37065,NC,Edgecombe,,2015,9.5,20629,22786,2157
37065,NC,Edgecombe,,2016,8.7,20411,22353,1942
37065,NC,Edgecombe,,2017,7.7,19967,21633,1666
37065,NC,Edgecombe,,2018,6.9,19728,21198,1470
37065,NC,Edgecombe,,2019,5.8,19559,20774,1215
37065,NC,Edgecombe,,2020,10.2,17928,19974,2046
37065,NC,Edgecombe,,2021,8.5,18531,20260,1729
37067,NC,Forsyth,,2007,4.7,165749,174005,8256
37067,NC,Forsyth,,2008,5.7,167604,177654,10050
37067,NC,Forsyth,,2009,9.9,162903,180733,17830
37067,NC,Forsyth,,2010,10,156216,173644,17428
37067,NC,Forsyth,,2011,9.8,157407,174540,17133
37067,NC,Forsyth,,2012,9.1,161767,177910,16143
37067,NC,Forsyth,,2013,7.3,164762,177824,13062
37067,NC,Forsyth,,2014,5.8,166984,177329,10345
37067,NC,Forsyth,,2015,5.4,169780,179552,9772
37067,NC,Forsyth,,2016,4.9,173210,182081,8871
37067,NC,Forsyth,,2017,4.4,174208,182173,7965
37067,NC,Forsyth,,2018,3.9,177103,184272,7169
37067,NC,Forsyth,,2019,3.7,180207,187105,6898
37067,NC,Forsyth,,2020,7.2,167293,180183,12890
37067,NC,Forsyth,,2021,4.9,174514,183512,8998
37069,NC,Franklin,,2007,4.8,25722,27018,1296
37069,NC,Franklin,,2008,6.3,26115,27856,1741
37069,NC,Franklin,,2009,10.7,24899,27886,2987
37069,NC,Franklin,,2010,10.8,25029,28055,3026
37069,NC,Franklin,,2011,10.6,25099,28089,2990
37069,NC,Franklin,,2012,9.9,25590,28408,2818
37069,NC,Franklin,,2013,8,26014,28284,2270
37069,NC,Franklin,,2014,6.3,26507,28295,1788
37069,NC,Franklin,,2015,5.8,27006,28684,1678
37069,NC,Franklin,,2016,5.2,27725,29255,1530
37069,NC,Franklin,,2017,4.7,28297,29683,1386
37069,NC,Franklin,,2018,4.1,29087,30330,1243
37069,NC,Franklin,,2019,4,30015,31266,1251
37069,NC,Franklin,,2020,6.5,28746,30757,2011
37069,NC,Franklin,,2021,4.7,30577,32086,1509
37071,NC,Gaston,,2007,6.1,91999,98017,6018
37071,NC,Gaston,,2008,7.6,92453,100046,7593
37071,NC,Gaston,,2009,14.4,86442,100933,14491
37071,NC,Gaston,,2010,13.4,87999,101585,13586
37071,NC,Gaston,,2011,11.9,89038,101008,11970
37071,NC,Gaston,,2012,10.7,90989,101897,10908
37071,NC,Gaston,,2013,8.7,92165,100951,8786
37071,NC,Gaston,,2014,6.6,94143,100806,6663
37071,NC,Gaston,,2015,5.9,96576,102672,6096
37071,NC,Gaston,,2016,5.3,99700,105324,5624
37071,NC,Gaston,,2017,4.6,101356,106267,4911
37071,NC,Gaston,,2018,4,103251,107538,4287
37071,NC,Gaston,,2019,3.8,105028,109230,4202
37071,NC,Gaston,,2020,7.8,98492,106773,8281
37071,NC,Gaston,,2021,5.2,103270,108927,5657
37073,NC,Gates,,2007,4.6,4771,5003,232
37073,NC,Gates,,2008,5.3,4613,4873,260
37073,NC,Gates,,2009,7.8,4483,4860,377
37073,NC,Gates,,2010,7.9,5049,5481,432
37073,NC,Gates,,2011,8.2,5008,5455,447
37073,NC,Gates,,2012,7.9,4976,5400,424
37073,NC,Gates,,2013,6.8,4910,5266,356
37073,NC,Gates,,2014,5.8,4898,5198,300
37073,NC,Gates,,2015,5.4,4860,5139,279
37073,NC,Gates,,2016,5.1,4909,5175,266
37073,NC,Gates,,2017,4.4,4975,5205,230
37073,NC,Gates,,2018,4.1,5030,5243,213
37073,NC,Gates,,2019,4,5048,5256,208
37073,NC,Gates,,2020,5.6,4610,4881,271
37073,NC,Gates,,2021,4.3,4749,4963,214
37075,NC,Graham,,2007,7.7,4342,4705,363
37075,NC,Graham,,2008,10.7,3920,4392,472
37075,NC,Graham,,2009,17.8,3076,3744,668
37075,NC,Graham,,2010,17.4,3067,3713,646
37075,NC,Graham,,2011,18.1,2981,3638,657
37075,NC,Graham,,2012,18.1,2962,3615,653
37075,NC,Graham,,2013,14.9,2993,3517,524
37075,NC,Graham,,2014,13,2881,3311,430
37075,NC,Graham,,2015,11.9,2804,3181,377
37075,NC,Graham,,2016,8.8,2819,3092,273
37075,NC,Graham,,2017,6.8,2874,3084,210
37075,NC,Graham,,2018,5.9,2952,3137,185
37075,NC,Graham,,2019,5.3,3036,3206,170
37075,NC,Graham,,2020,9.6,2698,2986,288
37075,NC,Graham,,2021,6.9,2814,3022,208
37077,NC,Granville,,2007,5.5,23801,25193,1392
37077,NC,Granville,,2008,6.7,23825,25541,1716
37077,NC,Granville,,2009,10.9,23030,25860,2830
37077,NC,Granville,,2010,9.6,24837,27483,2646
37077,NC,Granville,,2011,8.9,25518,28005,2487
37077,NC,Granville,,2012,8.2,26194,28529,2335
37077,NC,Granville,,2013,6.7,26507,28396,1889
37077,NC,Granville,,2014,5.3,26659,28141,1482
37077,NC,Granville,,2015,4.9,27113,28505,1392
37077,NC,Granville,,2016,4.3,27928,29191,1263
37077,NC,Granville,,2017,3.8,28467,29597,1130
37077,NC,Granville,,2018,3.5,28526,29547,1021
37077,NC,Granville,,2019,3.3,28964,29958,994
37077,NC,Granville,,2020,5.6,27275,28903,1628
37077,NC,Granville,,2021,4,28364,29541,1177
37079,NC,Greene,,2007,5.9,8670,9212,542
37079,NC,Greene,,2008,6.6,8686,9299,613
37079,NC,Greene,,2009,10.9,8325,9343,1018
37079,NC,Greene,,2010,10,8516,9464,948
37079,NC,Greene,,2011,9.6,8687,9609,922
37079,NC,Greene,,2012,8.8,8875,9733,858
37079,NC,Greene,,2013,7.6,8705,9426,721
37079,NC,Greene,,2014,6,8844,9413,569
37079,NC,Greene,,2015,5.5,8952,9469,517
37079,NC,Greene,,2016,5.3,8992,9496,504
37079,NC,Greene,,2017,4.4,8997,9414,417
37079,NC,Greene,,2018,3.9,9032,9398,366
37079,NC,Greene,,2019,3.7,9155,9504,349
37079,NC,Greene,,2020,5.5,8726,9230,504
37079,NC,Greene,,2021,4.1,8980,9364,384
37081,NC,Guilford,,2007,5.1,235493,248155,12662
37081,NC,Guilford,,2008,6,236423,251557,15134
37081,NC,Guilford,,2009,11.1,224093,252006,27913
37081,NC,Guilford,,2010,11,225137,252937,27800
37081,NC,Guilford,,2011,10.5,227869,254485,26616
37081,NC,Guilford,,2012,9.8,231822,256943,25121
37081,NC,Guilford,,2013,8,235225,255657,20432
37081,NC,Guilford,,2014,6.4,237205,253309,16104
37081,NC,Guilford,,2015,5.8,241158,256007,14849
37081,NC,Guilford,,2016,5.2,244175,257680,13505
37081,NC,Guilford,,2017,4.8,244858,257106,12248
37081,NC,Guilford,,2018,4.2,247437,258386,10949
37081,NC,Guilford,,2019,4.1,250142,260702,10560
37081,NC,Guilford,,2020,8.2,231469,252260,20791
37081,NC,Guilford,,2021,5.6,240484,254780,14296
37083,NC,Halifax,,2007,6.9,22779,24476,1697
37083,NC,Halifax,,2008,9,21751,23899,2148
37083,NC,Halifax,,2009,14.1,21037,24502,3465
37083,NC,Halifax,,2010,14.6,19530,22863,3333
37083,NC,Halifax,,2011,14.6,19188,22462,3274
37083,NC,Halifax,,2012,13.9,19086,22156,3070
37083,NC,Halifax,,2013,11.5,19276,21772,2496
37083,NC,Halifax,,2014,9.4,19245,21244,1999
37083,NC,Halifax,,2015,8.7,18936,20744,1808
37083,NC,Halifax,,2016,7.9,18985,20621,1636
37083,NC,Halifax,,2017,7.3,18799,20276,1477
37083,NC,Halifax,,2018,6.1,18677,19900,1223
37083,NC,Halifax,,2019,5.6,19106,20235,1129
37083,NC,Halifax,,2020,8.9,17699,19419,1720
37083,NC,Halifax,,2021,7.5,17747,19179,1432
37085,NC,Harnett,,2007,5.2,45607,48130,2523
37085,NC,Harnett,,2008,6.6,44901,48082,3181
37085,NC,Harnett,,2009,11.9,42949,48724,5775
37085,NC,Harnett,,2010,11.2,43463,48948,5485
37085,NC,Harnett,,2011,11.4,43788,49398,5610
37085,NC,Harnett,,2012,10.9,44712,50163,5451
37085,NC,Harnett,,2013,9,45276,49742,4466
37085,NC,Harnett,,2014,7.2,45824,49363,3539
37085,NC,Harnett,,2015,6.6,46864,50188,3324
37085,NC,Harnett,,2016,5.8,48328,51302,2974
37085,NC,Harnett,,2017,5.1,49181,51830,2649
37085,NC,Harnett,,2018,4.8,49659,52138,2479
37085,NC,Harnett,,2019,4.5,50521,52927,2406
37085,NC,Harnett,,2020,7.2,47823,51556,3733
37085,NC,Harnett,,2021,5.3,50144,52943,2799
37087,NC,Haywood,,2007,4.4,26300,27500,1200
37087,NC,Haywood,,2008,5.6,26357,27927,1570
37087,NC,Haywood,,2009,10,25258,28063,2805
37087,NC,Haywood,,2010,10.2,24883,27705,2822
37087,NC,Haywood,,2011,10.1,24871,27661,2790
37087,NC,Haywood,,2012,9.3,25160,27752,2592
37087,NC,Haywood,,2013,7.6,25536,27641,2105
37087,NC,Haywood,,2014,5.6,25713,27252,1539
37087,NC,Haywood,,2015,5.2,26189,27623,1434
37087,NC,Haywood,,2016,4.5,27104,28396,1292
37087,NC,Haywood,,2017,4,27389,28538,1149
37087,NC,Haywood,,2018,3.4,28229,29236,1007
37087,NC,Haywood,,2019,3.4,28690,29685,995
37087,NC,Haywood,,2020,7.3,26047,28092,2045
37087,NC,Haywood,,2021,4.2,27662,28887,1225
37089,NC,Henderson,,2007,3.8,46696,48538,1842
37089,NC,Henderson,,2008,4.7,47385,49735,2350
37089,NC,Henderson,,2009,9.2,45569,50191,4622
37089,NC,Henderson,,2010,9,44115,48487,4372
37089,NC,Henderson,,2011,8.5,44531,48668,4137
37089,NC,Henderson,,2012,7.7,45221,48982,3761
37089,NC,Henderson,,2013,6,46201,49173,2972
37089,NC,Henderson,,2014,4.9,47025,49445,2420
37089,NC,Henderson,,2015,4.7,48238,50614,2376
37089,NC,Henderson,,2016,4.3,49909,52134,2225
37089,NC,Henderson,,2017,3.8,50731,52744,2013
37089,NC,Henderson,,2018,3.3,51978,53756,1778
37089,NC,Henderson,,2019,3.3,52832,54613,1781
37089,NC,Henderson,,2020,6.7,47904,51335,3431
37089,NC,Henderson,,2021,4.1,50879,53037,2158
37091,NC,Hertford,,2007,5.7,9400,9964,564
37091,NC,Hertford,,2008,6.7,9196,9852,656
37091,NC,Hertford,,2009,10.1,9121,10143,1022
37091,NC,Hertford,,2010,10.5,8830,9865,1035
37091,NC,Hertford,,2011,11.3,8585,9682,1097
37091,NC,Hertford,,2012,11,8595,9660,1065
37091,NC,Hertford,,2013,9.1,8646,9515,869
37091,NC,Hertford,,2014,7.2,8706,9380,674
37091,NC,Hertford,,2015,7,8568,9211,643
37091,NC,Hertford,,2016,6.6,8676,9287,611
37091,NC,Hertford,,2017,5.8,8535,9056,521
37091,NC,Hertford,,2018,5.1,8539,8999,460
37091,NC,Hertford,,2019,5,8672,9133,461
37091,NC,Hertford,,2020,6.7,8120,8703,583
37091,NC,Hertford,,2021,6.5,7962,8518,556
37093,NC,Hoke,,2007,5.5,18146,19198,1052
37093,NC,Hoke,,2008,5.7,18649,19778,1129
37093,NC,Hoke,,2009,8.4,19212,20965,1753
37093,NC,Hoke,,2010,10,16777,18649,1872
37093,NC,Hoke,,2011,10.9,17429,19560,2131
37093,NC,Hoke,,2012,10.9,17822,20011,2189
37093,NC,Hoke,,2013,9.6,17883,19778,1895
37093,NC,Hoke,,2014,8.1,17811,19384,1573
37093,NC,Hoke,,2015,7.8,18251,19803,1552
37093,NC,Hoke,,2016,6.6,18545,19855,1310
37093,NC,Hoke,,2017,5.8,18502,19635,1133
37093,NC,Hoke,,2018,5.1,18814,19826,1012
37093,NC,Hoke,,2019,4.9,18999,19974,975
37093,NC,Hoke,,2020,8.3,17863,19476,1613
37093,NC,Hoke,,2021,6.4,18568,19848,1280
37095,NC,Hyde,,2007,6.1,2535,2701,166
37095,NC,Hyde,,2008,7,2498,2686,188
37095,NC,Hyde,,2009,9.1,2407,2649,242
37095,NC,Hyde,,2010,11,1996,2242,246
37095,NC,Hyde,,2011,13.4,1841,2127,286
37095,NC,Hyde,,2012,13.8,1856,2152,296
37095,NC,Hyde,,2013,11.3,1919,2164,245
37095,NC,Hyde,,2014,8.9,2001,2197,196
37095,NC,Hyde,,2015,9,1948,2141,193
37095,NC,Hyde,,2016,9.5,1904,2103,199
37095,NC,Hyde,,2017,8.4,1896,2070,174
37095,NC,Hyde,,2018,8.3,1822,1986,164
37095,NC,Hyde,,2019,8.5,1744,1905,161
37095,NC,Hyde,,2020,10.1,1572,1748,176
37095,NC,Hyde,,2021,6.5,1652,1767,115
37097,NC,Iredell,,2007,5,76150,80127,3977
37097,NC,Iredell,,2008,6.4,74098,79170,5072
37097,NC,Iredell,,2009,13.3,69159,79729,10570
37097,NC,Iredell,,2010,12.8,68868,78940,10072
37097,NC,Iredell,,2011,11.4,69966,78947,8981
37097,NC,Iredell,,2012,10.2,71826,79950,8124
37097,NC,Iredell,,2013,8.1,73084,79556,6472
37097,NC,Iredell,,2014,6.1,75063,79951,4888
37097,NC,Iredell,,2015,5.4,77644,82099,4455
37097,NC,Iredell,,2016,4.8,80244,84300,4056
37097,NC,Iredell,,2017,4.3,81647,85272,3625
37097,NC,Iredell,,2018,3.7,83431,86622,3191
37097,NC,Iredell,,2019,3.6,85823,89008,3185
37097,NC,Iredell,,2020,7.1,81501,87687,6186
37097,NC,Iredell,,2021,4.6,85477,89608,4131
37099,NC,Jackson,,2007,4,21067,21940,873
37099,NC,Jackson,,2008,5.1,19978,21044,1066
37099,NC,Jackson,,2009,9.3,18937,20880,1943
37099,NC,Jackson,,2010,10.8,16502,18503,2001
37099,NC,Jackson,,2011,11.2,16147,18176,2029
37099,NC,Jackson,,2012,10.8,16258,18234,1976
37099,NC,Jackson,,2013,8.6,16875,18456,1581
37099,NC,Jackson,,2014,6.5,17172,18364,1192
37099,NC,Jackson,,2015,6,17335,18445,1110
37099,NC,Jackson,,2016,5.4,17751,18773,1022
37099,NC,Jackson,,2017,4.8,17897,18795,898
37099,NC,Jackson,,2018,4.2,18460,19278,818
37099,NC,Jackson,,2019,4.1,18968,19778,810
37099,NC,Jackson,,2020,7.4,17750,19162,1412
37099,NC,Jackson,,2021,4.5,18611,19488,877
37101,NC,Johnston,,2007,4.4,71967,75311,3344
37101,NC,Johnston,,2008,5.7,73650,78100,4450
37101,NC,Johnston,,2009,10.4,71013,79213,8200
37101,NC,Johnston,,2010,9.8,73951,82006,8055
37101,NC,Johnston,,2011,9.5,75033,82890,7857
37101,NC,Johnston,,2012,8.6,76949,84222,7273
37101,NC,Johnston,,2013,6.9,78785,84615,5830
37101,NC,Johnston,,2014,5.5,81147,85890,4743
37101,NC,Johnston,,2015,5.2,83524,88074,4550
37101,NC,Johnston,,2016,4.7,87026,91306,4280
37101,NC,Johnston,,2017,4.2,89198,93067,3869
37101,NC,Johnston,,2018,3.7,92477,96031,3554
37101,NC,Johnston,,2019,3.6,95569,99162,3593
37101,NC,Johnston,,2020,6.1,91691,97630,5939
37101,NC,Johnston,,2021,4.2,97527,101800,4273
37103,NC,Jones,,2007,4.8,4603,4836,233
37103,NC,Jones,,2008,6.4,4412,4716,304
37103,NC,Jones,,2009,11.2,4141,4664,523
37103,NC,Jones,,2010,11.1,4103,4615,512
37103,NC,Jones,,2011,10.6,4118,4607,489
37103,NC,Jones,,2012,10.2,4159,4629,470
37103,NC,Jones,,2013,8.2,4174,4547,373
37103,NC,Jones,,2014,6.5,4199,4489,290
37103,NC,Jones,,2015,5.7,4284,4543,259
37103,NC,Jones,,2016,5.3,4263,4501,238
37103,NC,Jones,,2017,4.4,4152,4345,193
37103,NC,Jones,,2018,4.3,4136,4320,184
37103,NC,Jones,,2019,3.8,4114,4278,164
37103,NC,Jones,,2020,5.5,3827,4051,224
37103,NC,Jones,,2021,4.2,3979,4155,176
37105,NC,Lee,,2007,6.1,24959,26583,1624
37105,NC,Lee,,2008,7.6,23945,25906,1961
37105,NC,Lee,,2009,14.8,22439,26331,3892
37105,NC,Lee,,2010,12.6,23749,27188,3439
37105,NC,Lee,,2011,12.3,24003,27373,3370
37105,NC,Lee,,2012,11.6,24159,27342,3183
37105,NC,Lee,,2013,9.9,23532,26107,2575
37105,NC,Lee,,2014,7.9,23020,25006,1986
37105,NC,Lee,,2015,7.1,24201,26059,1858
37105,NC,Lee,,2016,5.9,24611,26150,1539
37105,NC,Lee,,2017,5.1,24857,26199,1342
37105,NC,Lee,,2018,4.4,24975,26132,1157
37105,NC,Lee,,2019,4.4,24796,25938,1142
37105,NC,Lee,,2020,7.8,23192,25149,1957
37105,NC,Lee,,2021,5.4,23956,25322,1366
37107,NC,Lenoir,,2007,5.7,26446,28046,1600
37107,NC,Lenoir,,2008,7.2,25161,27118,1957
37107,NC,Lenoir,,2009,12.3,23877,27241,3364
37107,NC,Lenoir,,2010,11.7,23802,26968,3166
37107,NC,Lenoir,,2011,10.9,24729,27747,3018
37107,NC,Lenoir,,2012,10,25852,28740,2888
37107,NC,Lenoir,,2013,8.4,26133,28544,2411
37107,NC,Lenoir,,2014,6.9,25915,27848,1933
37107,NC,Lenoir,,2015,6.3,25973,27710,1737
37107,NC,Lenoir,,2016,5.9,25947,27566,1619
37107,NC,Lenoir,,2017,4.5,26385,27615,1230
37107,NC,Lenoir,,2018,4,26384,27477,1093
37107,NC,Lenoir,,2019,3.7,26733,27764,1031
37107,NC,Lenoir,,2020,6,25135,26729,1594
37107,NC,Lenoir,,2021,5,25558,26890,1332
37109,NC,Lincoln,,2007,5.3,37796,39920,2124
37109,NC,Lincoln,,2008,7.3,36641,39507,2866
37109,NC,Lincoln,,2009,14.4,33910,39633,5723
37109,NC,Lincoln,,2010,12.6,35064,40121,5057
37109,NC,Lincoln,,2011,11.2,35545,40014,4469
37109,NC,Lincoln,,2012,9.8,36321,40285,3964
37109,NC,Lincoln,,2013,8,36739,39944,3205
37109,NC,Lincoln,,2014,6,37271,39640,2369
37109,NC,Lincoln,,2015,5.4,38396,40572,2176
37109,NC,Lincoln,,2016,4.7,39033,40966,1933
37109,NC,Lincoln,,2017,4,39652,41318,1666
37109,NC,Lincoln,,2018,3.5,40563,42041,1478
37109,NC,Lincoln,,2019,3.5,42104,43625,1521
37109,NC,Lincoln,,2020,6.3,40040,42749,2709
37109,NC,Lincoln,,2021,4.1,42039,43823,1784
37111,NC,McDowell,,2007,6,20233,21530,1297
37111,NC,McDowell,,2008,8.2,19170,20887,1717
37111,NC,McDowell,,2009,15.9,17428,20719,3291
37111,NC,McDowell,,2010,13.2,17952,20680,2728
37111,NC,McDowell,,2011,12.4,18146,20703,2557
37111,NC,McDowell,,2012,11.1,18478,20782,2304
37111,NC,McDowell,,2013,8.7,18672,20459,1787
37111,NC,McDowell,,2014,6.2,19506,20803,1297
37111,NC,McDowell,,2015,5.4,20085,21239,1154
37111,NC,McDowell,,2016,4.8,19943,20950,1007
37111,NC,McDowell,,2017,4.1,19837,20675,838
37111,NC,McDowell,,2018,3.4,20102,20819,717
37111,NC,McDowell,,2019,3.8,19939,20717,778
37111,NC,McDowell,,2020,6.8,18581,19929,1348
37111,NC,McDowell,,2021,4.5,19006,19903,897
37113,NC,Macon,,2007,4.4,15954,16692,738
37113,NC,Macon,,2008,6,15378,16353,975
37113,NC,Macon,,2009,11.5,14228,16077,1849
37113,NC,Macon,,2010,11.4,13745,15514,1769
37113,NC,Macon,,2011,11.3,13804,15566,1762
37113,NC,Macon,,2012,10.9,13924,15623,1699
37113,NC,Macon,,2013,8.9,13871,15229,1358
37113,NC,Macon,,2014,6.4,14071,15035,964
37113,NC,Macon,,2015,6.1,14183,15104,921
37113,NC,Macon,,2016,5.4,14353,15171,818
37113,NC,Macon,,2017,4.6,14317,15015,698
37113,NC,Macon,,2018,4,14536,15141,605
37113,NC,Macon,,2019,3.8,14918,15514,596
37113,NC,Macon,,2020,6.5,13993,14970,977
37113,NC,Macon,,2021,4.2,14641,15285,644
37115,NC,Madison,,2007,4.3,9436,9857,421
37115,NC,Madison,,2008,5.7,9487,10058,571
37115,NC,Madison,,2009,9.8,9013,9994,981
37115,NC,Madison,,2010,10.3,8456,9425,969
37115,NC,Madison,,2011,10.3,8513,9487,974
37115,NC,Madison,,2012,10,8615,9572,957
37115,NC,Madison,,2013,8,8747,9504,757
37115,NC,Madison,,2014,6,8829,9397,568
37115,NC,Madison,,2015,5.6,8928,9459,531
37115,NC,Madison,,2016,4.9,9200,9671,471
37115,NC,Madison,,2017,4.3,9408,9826,418
37115,NC,Madison,,2018,3.7,9562,9928,366
37115,NC,Madison,,2019,3.6,9660,10020,360
37115,NC,Madison,,2020,6.7,8675,9298,623
37115,NC,Madison,,2021,4.3,9212,9623,411
37117,NC,Martin,,2007,5.7,11379,12070,691
37117,NC,Martin,,2008,6.5,11165,11939,774
37117,NC,Martin,,2009,11.1,10644,11974,1330
37117,NC,Martin,,2010,12.6,9189,10519,1330
37117,NC,Martin,,2011,12.5,9366,10698,1332
37117,NC,Martin,,2012,12.3,9234,10528,1294
37117,NC,Martin,,2013,10.2,9087,10116,1029
37117,NC,Martin,,2014,7.6,9129,9879,750
37117,NC,Martin,,2015,7.6,8968,9705,737
37117,NC,Martin,,2016,6.8,9122,9784,662
37117,NC,Martin,,2017,5.6,8922,9452,530
37117,NC,Martin,,2018,5,8695,9157,462
37117,NC,Martin,,2019,4.9,8541,8982,441
37117,NC,Martin,,2020,6.7,8047,8623,576
37117,NC,Martin,,2021,5.5,8140,8617,477
37119,NC,Mecklenburg,,2007,4.9,435790,458257,22467
37119,NC,Mecklenburg,,2008,6,440764,468852,28088
37119,NC,Mecklenburg,,2009,11,418194,470015,51821
37119,NC,Mecklenburg,,2010,10.6,451042,504346,53304
37119,NC,Mecklenburg,,2011,9.9,465317,516486,51169
37119,NC,Mecklenburg,,2012,9,484538,532231,47693
37119,NC,Mecklenburg,,2013,7.3,498854,538164,39310
37119,NC,Mecklenburg,,2014,5.8,516183,548084,31901
37119,NC,Mecklenburg,,2015,5.3,534833,564683,29850
37119,NC,Mecklenburg,,2016,4.7,554067,581630,27563
37119,NC,Mecklenburg,,2017,4.3,566533,592050,25517
37119,NC,Mecklenburg,,2018,3.8,579347,602435,23088
37119,NC,Mecklenburg,,2019,3.6,593752,616052,22300
37119,NC,Mecklenburg,,2020,7.5,561076,606285,45209
37119,NC,Mecklenburg,,2021,4.9,588559,618847,30288
37121,NC,Mitchell,,2007,7.7,6818,7385,567
37121,NC,Mitchell,,2008,8.1,6542,7118,576
37121,NC,Mitchell,,2009,13,6315,7255,940
37121,NC,Mitchell,,2010,12.3,5993,6831,838
37121,NC,Mitchell,,2011,11.9,5970,6774,804
37121,NC,Mitchell,,2012,12.5,5871,6711,840
37121,NC,Mitchell,,2013,10.8,5961,6679,718
37121,NC,Mitchell,,2014,7.5,6042,6533,491
37121,NC,Mitchell,,2015,6.8,5877,6303,426
37121,NC,Mitchell,,2016,6.1,5791,6169,378
37121,NC,Mitchell,,2017,5.2,5698,6011,313
37121,NC,Mitchell,,2018,4.5,5672,5942,270
37121,NC,Mitchell,,2019,4.5,5743,6013,270
37121,NC,Mitchell,,2020,7.5,5311,5744,433
37121,NC,Mitchell,,2021,5.1,5623,5928,305
37123,NC,Montgomery,,2007,6.8,11164,11981,817
37123,NC,Montgomery,,2008,8.2,10418,11350,932
37123,NC,Montgomery,,2009,14,9609,11179,1570
37123,NC,Montgomery,,2010,12.2,10081,11483,1402
37123,NC,Montgomery,,2011,11.8,10203,11565,1362
37123,NC,Montgomery,,2012,10.8,10393,11656,1263
37123,NC,Montgomery,,2013,8.1,10757,11699,942
37123,NC,Montgomery,,2014,6.2,10760,11471,711
37123,NC,Montgomery,,2015,5.6,10960,11613,653
37123,NC,Montgomery,,2016,5.2,11061,11664,603
37123,NC,Montgomery,,2017,4.6,11057,11585,528
37123,NC,Montgomery,,2018,4.1,10909,11370,461
37123,NC,Montgomery,,2019,3.9,11031,11479,448
37123,NC,Montgomery,,2020,6.5,10264,10973,709
37123,NC,Montgomery,,2021,4.7,10499,11014,515
37125,NC,Moore,,2007,4.9,35474,37314,1840
37125,NC,Moore,,2008,6.1,34272,36517,2245
37125,NC,Moore,,2009,10.6,32727,36599,3872
37125,NC,Moore,,2010,10,32810,36460,3650
37125,NC,Moore,,2011,9.5,33725,37277,3552
37125,NC,Moore,,2012,9,34388,37789,3401
37125,NC,Moore,,2013,7.6,35104,37972,2868
37125,NC,Moore,,2014,5.9,35914,38184,2270
37125,NC,Moore,,2015,5.7,36059,38251,2192
37125,NC,Moore,,2016,5,37411,39389,1978
37125,NC,Moore,,2017,4.5,37545,39306,1761
37125,NC,Moore,,2018,3.9,38928,40500,1572
37125,NC,Moore,,2019,3.8,40190,41780,1590
37125,NC,Moore,,2020,7.1,36751,39542,2791
37125,NC,Moore,,2021,4.6,38325,40161,1836
37127,NC,Nash,,2007,5.7,43885,46555,2670
37127,NC,Nash,,2008,7.4,43578,47077,3499
37127,NC,Nash,,2009,12.6,41828,47839,6011
37127,NC,Nash,,2010,12.4,41699,47616,5917
37127,NC,Nash,,2011,12.5,41286,47164,5878
37127,NC,Nash,,2012,11.8,41042,46530,5488
37127,NC,Nash,,2013,10.1,40816,45378,4562
37127,NC,Nash,,2014,7.7,40795,44217,3422
37127,NC,Nash,,2015,7.2,40658,43809,3151
37127,NC,Nash,,2016,6.6,40909,43792,2883
37127,NC,Nash,,2017,6,40453,43047,2594
37127,NC,Nash,,2018,5.2,40576,42785,2209
37127,NC,Nash,,2019,4.7,40772,42802,2030
37127,NC,Nash,,2020,8,38076,41405,3329
37127,NC,Nash,,2021,6.3,39381,42040,2659
37129,NC,New Hanover,,2007,4.1,100316,104582,4266
37129,NC,New Hanover,,2008,5.2,100365,105861,5496
37129,NC,New Hanover,,2009,9.7,95406,105613,10207
37129,NC,New Hanover,,2010,9.6,97615,107987,10372
37129,NC,New Hanover,,2011,9.5,97757,108073,10316
37129,NC,New Hanover,,2012,8.8,100052,109761,9709
37129,NC,New Hanover,,2013,7.3,101673,109725,8052
37129,NC,New Hanover,,2014,5.7,104191,110542,6351
37129,NC,New Hanover,,2015,5.3,107283,113266,5983
37129,NC,New Hanover,,2016,4.7,110226,115690,5464
37129,NC,New Hanover,,2017,4.1,112848,117713,4865
37129,NC,New Hanover,,2018,3.9,114909,119528,4619
37129,NC,New Hanover,,2019,3.6,117493,121836,4343
37129,NC,New Hanover,,2020,7,109989,118291,8302
37129,NC,New Hanover,,2021,4.2,117512,122709,5197
37131,NC,Northampton,,2007,6.4,8536,9124,588
37131,NC,Northampton,,2008,7.8,8028,8705,677
37131,NC,Northampton,,2009,11.8,7688,8717,1029
37131,NC,Northampton,,2010,11.5,7727,8733,1006
37131,NC,Northampton,,2011,12.2,7615,8676,1061
37131,NC,Northampton,,2012,11.8,7390,8374,984
37131,NC,Northampton,,2013,9.7,7375,8168,793
37131,NC,Northampton,,2014,7.8,7319,7940,621
37131,NC,Northampton,,2015,7.4,7271,7856,585
37131,NC,Northampton,,2016,7.3,7225,7791,566
37131,NC,Northampton,,2017,6.2,7158,7634,476
37131,NC,Northampton,,2018,5.2,7140,7529,389
37131,NC,Northampton,,2019,5,7307,7695,388
37131,NC,Northampton,,2020,7.1,6701,7214,513
37131,NC,Northampton,,2021,6.2,6731,7178,447
37133,NC,Onslow,,2007,4.8,57173,60085,2912
37133,NC,Onslow,,2008,5.7,59670,63263,3593
37133,NC,Onslow,,2009,8.8,60483,66352,5869
37133,NC,Onslow,,2010,8.2,58387,63590,5203
37133,NC,Onslow,,2011,8.3,57804,63019,5215
37133,NC,Onslow,,2012,8.2,58859,64123,5264
37133,NC,Onslow,,2013,6.8,59787,64175,4388
37133,NC,Onslow,,2014,5.9,60243,64023,3780
37133,NC,Onslow,,2015,5.8,59974,63680,3706
37133,NC,Onslow,,2016,5.5,60018,63519,3501
37133,NC,Onslow,,2017,5.2,60298,63638,3340
37133,NC,Onslow,,2018,4.9,60323,63422,3099
37133,NC,Onslow,,2019,4.5,61077,63985,2908
37133,NC,Onslow,,2020,7.1,58361,62806,4445
37133,NC,Onslow,,2021,5.1,61732,65070,3338
37135,NC,Orange,,2007,3.5,65684,68066,2382
37135,NC,Orange,,2008,4,67186,69998,2812
37135,NC,Orange,,2009,6.7,65753,70504,4751
37135,NC,Orange,,2010,6.5,65665,70250,4585
37135,NC,Orange,,2011,6.5,65937,70542,4605
37135,NC,Orange,,2012,6.3,68085,72628,4543
37135,NC,Orange,,2013,5.2,69076,72832,3756
37135,NC,Orange,,2014,4.5,69439,72720,3281
37135,NC,Orange,,2015,4.6,69954,73308,3354
37135,NC,Orange,,2016,4.2,71532,74699,3167
37135,NC,Orange,,2017,3.8,72716,75573,2857
37135,NC,Orange,,2018,3.3,73979,76517,2538
37135,NC,Orange,,2019,3.3,76734,79350,2616
37135,NC,Orange,,2020,5.2,72369,76310,3941
37135,NC,Orange,,2021,3.5,76516,79254,2738
37137,NC,Pamlico,,2007,4.6,5358,5618,260
37137,NC,Pamlico,,2008,6,5110,5436,326
37137,NC,Pamlico,,2009,10.4,4787,5344,557
37137,NC,Pamlico,,2010,10.1,4966,5523,557
37137,NC,Pamlico,,2011,9.7,4975,5510,535
37137,NC,Pamlico,,2012,9.2,4917,5418,501
37137,NC,Pamlico,,2013,8.2,4903,5339,436
37137,NC,Pamlico,,2014,6.5,4960,5302,342
37137,NC,Pamlico,,2015,5.9,5016,5330,314
37137,NC,Pamlico,,2016,5.3,5107,5392,285
37137,NC,Pamlico,,2017,4.6,5066,5311,245
37137,NC,Pamlico,,2018,4.2,5029,5249,220
37137,NC,Pamlico,,2019,3.7,5146,5344,198
37137,NC,Pamlico,,2020,5.4,4878,5156,278
37137,NC,Pamlico,,2021,4.3,5069,5296,227
37139,NC,Pasquotank,,2007,5.4,17364,18357,993
37139,NC,Pasquotank,,2008,6.9,16787,18028,1241
37139,NC,Pasquotank,,2009,10.4,16095,17957,1862
37139,NC,Pasquotank,,2010,9.8,16739,18561,1822
37139,NC,Pasquotank,,2011,10.3,16472,18362,1890
37139,NC,Pasquotank,,2012,10.3,16402,18282,1880
37139,NC,Pasquotank,,2013,9.4,16041,17696,1655
37139,NC,Pasquotank,,2014,7.8,15916,17268,1352
37139,NC,Pasquotank,,2015,7.2,16181,17430,1249
37139,NC,Pasquotank,,2016,6.3,16252,17344,1092
37139,NC,Pasquotank,,2017,5.5,16162,17108,946
37139,NC,Pasquotank,,2018,4.8,15969,16780,811
37139,NC,Pasquotank,,2019,4.5,15903,16657,754
37139,NC,Pasquotank,,2020,7.1,14941,16085,1144
37139,NC,Pasquotank,,2021,5.4,15397,16273,876
37141,NC,Pender,,2007,4.6,22580,23662,1082
37141,NC,Pender,,2008,6.1,22993,24480,1487
37141,NC,Pender,,2009,11.4,22019,24855,2836
37141,NC,Pender,,2010,11.3,21756,24538,2782
37141,NC,Pender,,2011,11.3,21949,24756,2807
37141,NC,Pender,,2012,10.7,22419,25101,2682
37141,NC,Pender,,2013,8.8,22861,25062,2201
37141,NC,Pender,,2014,6.9,23562,25304,1742
37141,NC,Pender,,2015,6,24423,25989,1566
37141,NC,Pender,,2016,5.3,25350,26769,1419
37141,NC,Pender,,2017,4.6,26298,27574,1276
37141,NC,Pender,,2018,4.2,26682,27857,1175
37141,NC,Pender,,2019,3.9,27410,28528,1118
37141,NC,Pender,,2020,6.3,26077,27830,1753
37141,NC,Pender,,2021,4.2,27841,29066,1225
37143,NC,Perquimans,,2007,5.6,5057,5358,301
37143,NC,Perquimans,,2008,6.8,4959,5321,362
37143,NC,Perquimans,,2009,11,4658,5235,577
37143,NC,Perquimans,,2010,10.5,4790,5354,564
37143,NC,Perquimans,,2011,11,4747,5332,585
37143,NC,Perquimans,,2012,10.7,4745,5312,567
37143,NC,Perquimans,,2013,9.3,4743,5230,487
37143,NC,Perquimans,,2014,7.6,4713,5099,386
37143,NC,Perquimans,,2015,7,4787,5150,363
37143,NC,Perquimans,,2016,6.4,4758,5086,328
37143,NC,Perquimans,,2017,5.6,4779,5065,286
37143,NC,Perquimans,,2018,4.9,4712,4954,242
37143,NC,Perquimans,,2019,4.9,4693,4934,241
37143,NC,Perquimans,,2020,6.6,4417,4729,312
37143,NC,Perquimans,,2021,5.3,4568,4824,256
37145,NC,Person,,2007,7.3,17583,18960,1377
37145,NC,Person,,2008,7.3,17708,19096,1388
37145,NC,Person,,2009,11.8,17092,19380,2288
37145,NC,Person,,2010,12.3,16466,18774,2308
37145,NC,Person,,2011,11.9,16436,18662,2226
37145,NC,Person,,2012,11.3,16464,18561,2097
37145,NC,Person,,2013,9.8,16515,18310,1795
37145,NC,Person,,2014,7.5,16582,17933,1351
37145,NC,Person,,2015,6.7,16665,17864,1199
37145,NC,Person,,2016,5.5,16993,17980,987
37145,NC,Person,,2017,4.7,16940,17768,828
37145,NC,Person,,2018,4.2,17149,17904,755
37145,NC,Person,,2019,4.1,17482,18237,755
37145,NC,Person,,2020,7,16597,17853,1256
37145,NC,Person,,2021,5,17515,18428,913
37147,NC,Pitt,,2007,5.5,74957,79309,4352
37147,NC,Pitt,,2008,6.5,76059,81320,5261
37147,NC,Pitt,,2009,10.5,74349,83068,8719
37147,NC,Pitt,,2010,10.1,77553,86234,8681
37147,NC,Pitt,,2011,10.1,77504,86228,8724
37147,NC,Pitt,,2012,9.3,80207,88465,8258
37147,NC,Pitt,,2013,7.8,81135,88034,6899
37147,NC,Pitt,,2014,6.3,82000,87471,5471
37147,NC,Pitt,,2015,6,82352,87592,5240
37147,NC,Pitt,,2016,5.6,83032,87935,4903
37147,NC,Pitt,,2017,4.9,83743,88029,4286
37147,NC,Pitt,,2018,4.3,84456,88288,3832
37147,NC,Pitt,,2019,4.2,85148,88857,3709
37147,NC,Pitt,,2020,6.6,80018,85632,5614
37147,NC,Pitt,,2021,5,82839,87237,4398
37149,NC,Polk,,2007,3.7,9364,9723,359
37149,NC,Polk,,2008,4.8,9112,9575,463
37149,NC,Polk,,2009,9.5,8625,9529,904
37149,NC,Polk,,2010,10,7730,8593,863
37149,NC,Polk,,2011,9.3,7699,8490,791
37149,NC,Polk,,2012,8.7,7686,8417,731
37149,NC,Polk,,2013,6.4,8126,8686,560
37149,NC,Polk,,2014,5.2,7971,8408,437
37149,NC,Polk,,2015,5,8217,8653,436
37149,NC,Polk,,2016,4.6,8389,8798,409
37149,NC,Polk,,2017,4.2,8425,8791,366
37149,NC,Polk,,2018,3.8,8485,8824,339
37149,NC,Polk,,2019,3.7,8697,9031,334
37149,NC,Polk,,2020,6,8192,8719,527
37149,NC,Polk,,2021,4.7,8607,9029,422
37151,NC,Randolph,,2007,5.1,70711,74495,3784
37151,NC,Randolph,,2008,6.4,70565,75365,4800
37151,NC,Randolph,,2009,11.7,66201,74985,8784
37151,NC,Randolph,,2010,11.9,61384,69669,8285
37151,NC,Randolph,,2011,10.9,61522,69084,7562
37151,NC,Randolph,,2012,10.2,62045,69079,7034
37151,NC,Randolph,,2013,8.4,62344,68069,5725
37151,NC,Randolph,,2014,6.4,62396,66632,4236
37151,NC,Randolph,,2015,5.6,62820,66574,3754
37151,NC,Randolph,,2016,4.9,63396,66681,3285
37151,NC,Randolph,,2017,4.4,62804,65678,2874
37151,NC,Randolph,,2018,3.8,62663,65157,2494
37151,NC,Randolph,,2019,3.7,63074,65518,2444
37151,NC,Randolph,,2020,7.1,58373,62845,4472
37151,NC,Randolph,,2021,4.7,60655,63631,2976
37153,NC,Richmond,,2007,8,19140,20812,1672
37153,NC,Richmond,,2008,9.3,18325,20196,1871
37153,NC,Richmond,,2009,14.6,17252,20194,2942
37153,NC,Richmond,,2010,14.7,16192,18987,2795
37153,NC,Richmond,,2011,14.6,15700,18382,2682
37153,NC,Richmond,,2012,13.7,15625,18104,2479
37153,NC,Richmond,,2013,11.4,15451,17446,1995
37153,NC,Richmond,,2014,8.7,15450,16922,1472
37153,NC,Richmond,,2015,7.8,15582,16905,1323
37153,NC,Richmond,,2016,6.9,15579,16739,1160
37153,NC,Richmond,,2017,6,15484,16475,991
37153,NC,Richmond,,2018,5.5,15413,16316,903
37153,NC,Richmond,,2019,5.1,15687,16536,849
37153,NC,Richmond,,2020,8.9,14727,16160,1433
37153,NC,Richmond,,2021,7.3,15059,16248,1189
37155,NC,Robeson,,2007,6.7,53299,57102,3803
37155,NC,Robeson,,2008,8,51685,56158,4473
37155,NC,Robeson,,2009,12.4,49426,56425,6999
37155,NC,Robeson,,2010,13.6,46706,54029,7323
37155,NC,Robeson,,2011,14.2,46111,53753,7642
37155,NC,Robeson,,2012,13.6,46099,53328,7229
37155,NC,Robeson,,2013,11.5,46133,52139,6006
37155,NC,Robeson,,2014,9.2,46378,51074,4696
37155,NC,Robeson,,2015,8.4,46709,50978,4269
37155,NC,Robeson,,2016,8,46394,50401,4007
37155,NC,Robeson,,2017,6.5,46252,49475,3223
37155,NC,Robeson,,2018,5.9,46101,49014,2913
37155,NC,Robeson,,2019,5.2,47249,49865,2616
37155,NC,Robeson,,2020,8.6,44128,48256,4128
37155,NC,Robeson,,2021,7.6,44504,48147,3643
37157,NC,Rockingham,,2007,6.7,41796,44779,2983
37157,NC,Rockingham,,2008,7.5,41340,44691,3351
37157,NC,Rockingham,,2009,13.2,38507,44363,5856
37157,NC,Rockingham,,2010,13.1,38557,44359,5802
37157,NC,Rockingham,,2011,12.3,38417,43798,5381
37157,NC,Rockingham,,2012,11.5,38417,43424,5007
37157,NC,Rockingham,,2013,9.4,38236,42210,3974
37157,NC,Rockingham,,2014,7.3,38116,41103,2987
37157,NC,Rockingham,,2015,6.5,38388,41074,2686
37157,NC,Rockingham,,2016,5.7,38423,40727,2304
37157,NC,Rockingham,,2017,5.2,37913,39989,2076
37157,NC,Rockingham,,2018,4.6,37711,39547,1836
37157,NC,Rockingham,,2019,4.3,38011,39735,1724
37157,NC,Rockingham,,2020,8.1,35071,38146,3075
37157,NC,Rockingham,,2021,5.5,36458,38593,2135
37159,NC,Rowan,,2007,6.5,66188,70793,4605
37159,NC,Rowan,,2008,6.8,65471,70252,4781
37159,NC,Rowan,,2009,13.2,61862,71304,9442
37159,NC,Rowan,,2010,13.9,55548,64538,8990
37159,NC,Rowan,,2011,12.4,55898,63842,7944
37159,NC,Rowan,,2012,11.1,56768,63882,7114
37159,NC,Rowan,,2013,9,57235,62906,5671
37159,NC,Rowan,,2014,6.9,58148,62426,4278
37159,NC,Rowan,,2015,6,59235,63026,3791
37159,NC,Rowan,,2016,5.6,60466,64035,3569
37159,NC,Rowan,,2017,4.7,60827,63830,3003
37159,NC,Rowan,,2018,4.1,61473,64071,2598
37159,NC,Rowan,,2019,4,62431,65031,2600
37159,NC,Rowan,,2020,7.7,58194,63077,4883
37159,NC,Rowan,,2021,5,61070,64309,3239
37161,NC,Rutherford,,2007,6.9,28334,30445,2111
37161,NC,Rutherford,,2008,8.1,27385,29789,2404
37161,NC,Rutherford,,2009,16.9,23812,28669,4857
37161,NC,Rutherford,,2010,16.6,22574,27059,4485
37161,NC,Rutherford,,2011,14.6,22748,26623,3875
37161,NC,Rutherford,,2012,13.5,23385,27038,3653
37161,NC,Rutherford,,2013,10.9,23137,25961,2824
37161,NC,Rutherford,,2014,8.3,23323,25436,2113
37161,NC,Rutherford,,2015,7.7,23097,25016,1919
37161,NC,Rutherford,,2016,6.7,23078,24733,1655
37161,NC,Rutherford,,2017,6.1,22771,24243,1472
37161,NC,Rutherford,,2018,5.2,23182,24445,1263
37161,NC,Rutherford,,2019,4.8,23855,25059,1204
37161,NC,Rutherford,,2020,9,21603,23751,2148
37161,NC,Rutherford,,2021,6.5,22494,24050,1556
37163,NC,Sampson,,2007,4.3,31693,33116,1423
37163,NC,Sampson,,2008,5.4,30749,32497,1748
37163,NC,Sampson,,2009,9.2,28674,31567,2893
37163,NC,Sampson,,2010,9.6,26834,29675,2841
37163,NC,Sampson,,2011,9.8,26932,29863,2931
37163,NC,Sampson,,2012,9.6,27095,29958,2863
37163,NC,Sampson,,2013,7.9,27381,29714,2333
37163,NC,Sampson,,2014,6.3,27775,29636,1861
37163,NC,Sampson,,2015,5.8,27786,29511,1725
37163,NC,Sampson,,2016,5.5,27817,29423,1606
37163,NC,Sampson,,2017,4.8,27606,28986,1380
37163,NC,Sampson,,2018,4.1,27693,28869,1176
37163,NC,Sampson,,2019,3.7,28085,29174,1089
37163,NC,Sampson,,2020,5.7,25999,27558,1559
37163,NC,Sampson,,2021,4.5,26567,27818,1251
37165,NC,Scotland,,2007,10.8,13049,14623,1574
37165,NC,Scotland,,2008,11,12416,13950,1534
37165,NC,Scotland,,2009,17.5,11517,13961,2444
37165,NC,Scotland,,2010,17.5,10842,13135,2293
37165,NC,Scotland,,2011,18,10594,12922,2328
37165,NC,Scotland,,2012,17.5,10387,12596,2209
37165,NC,Scotland,,2013,14.7,10448,12242,1794
37165,NC,Scotland,,2014,11.6,10581,11973,1392
37165,NC,Scotland,,2015,10.5,10600,11841,1241
37165,NC,Scotland,,2016,9.1,10540,11601,1061
37165,NC,Scotland,,2017,7.7,10469,11340,871
37165,NC,Scotland,,2018,7.4,10476,11317,841
37165,NC,Scotland,,2019,6.5,10671,11409,738
37165,NC,Scotland,,2020,11.7,9722,11008,1286
37165,NC,Scotland,,2021,9.5,10041,11096,1055
37167,NC,Stanly,,2007,5.3,29173,30792,1619
37167,NC,Stanly,,2008,6.5,28236,30211,1975
37167,NC,Stanly,,2009,12.6,26732,30570,3838
37167,NC,Stanly,,2010,13.1,25356,29162,3806
37167,NC,Stanly,,2011,11.8,25578,28985,3407
37167,NC,Stanly,,2012,10.2,26050,29003,2953
37167,NC,Stanly,,2013,7.9,26610,28907,2297
37167,NC,Stanly,,2014,5.9,26855,28530,1675
37167,NC,Stanly,,2015,5.3,27255,28767,1512
37167,NC,Stanly,,2016,4.6,27841,29195,1354
37167,NC,Stanly,,2017,4.1,28135,29347,1212
37167,NC,Stanly,,2018,3.6,28372,29445,1073
37167,NC,Stanly,,2019,3.6,29004,30102,1098
37167,NC,Stanly,,2020,6.1,27112,28880,1768
37167,NC,Stanly,,2021,4.4,28141,29425,1284
37169,NC,Stokes,,2007,4.7,22751,23883,1132
37169,NC,Stokes,,2008,5.9,22769,24185,1416
37169,NC,Stokes,,2009,11.1,21100,23722,2622
37169,NC,Stokes,,2010,11.3,20343,22929,2586
37169,NC,Stokes,,2011,10.4,20272,22631,2359
37169,NC,Stokes,,2012,9.5,20433,22586,2153
37169,NC,Stokes,,2013,7.6,20524,22222,1698
37169,NC,Stokes,,2014,5.9,20503,21784,1281
37169,NC,Stokes,,2015,5.4,20614,21782,1168
37169,NC,Stokes,,2016,4.8,20762,21805,1043
37169,NC,Stokes,,2017,4.2,20426,21330,904
37169,NC,Stokes,,2018,3.7,20494,21281,787
37169,NC,Stokes,,2019,3.5,20740,21500,760
37169,NC,Stokes,,2020,6.2,19248,20523,1275
37169,NC,Stokes,,2021,4.2,20112,20998,886
37171,NC,Surry,,2007,5.8,33243,35273,2030
37171,NC,Surry,,2008,7.8,31602,34275,2673
37171,NC,Surry,,2009,13,29655,34077,4422
37171,NC,Surry,,2010,11.9,30438,34544,4106
37171,NC,Surry,,2011,10.8,30342,34013,3671
37171,NC,Surry,,2012,9.9,30594,33943,3349
37171,NC,Surry,,2013,8.1,30636,33339,2703
37171,NC,Surry,,2014,6,31034,33006,1972
37171,NC,Surry,,2015,5.4,31513,33295,1782
37171,NC,Surry,,2016,4.8,31820,33418,1598
37171,NC,Surry,,2017,4.2,31747,33130,1383
37171,NC,Surry,,2018,3.6,32357,33554,1197
37171,NC,Surry,,2019,3.6,32502,33707,1205
37171,NC,Surry,,2020,6.7,29615,31730,2115
37171,NC,Surry,,2021,4.4,30618,32011,1393
37173,NC,Swain,,2007,6.8,6829,7327,498
37173,NC,Swain,,2008,7.9,6415,6967,552
37173,NC,Swain,,2009,12.5,6007,6865,858
37173,NC,Swain,,2010,14.6,5371,6290,919
37173,NC,Swain,,2011,15.6,5500,6519,1019
37173,NC,Swain,,2012,15,5596,6587,991
37173,NC,Swain,,2013,12.1,5807,6607,800
37173,NC,Swain,,2014,8.7,5915,6482,567
37173,NC,Swain,,2015,7.6,6254,6767,513
37173,NC,Swain,,2016,6.1,6663,7096,433
37173,NC,Swain,,2017,5.1,6405,6747,342
37173,NC,Swain,,2018,4.4,6525,6822,297
37173,NC,Swain,,2019,3.9,6708,6980,272
37173,NC,Swain,,2020,8.3,6188,6745,557
37173,NC,Swain,,2021,4.5,6525,6833,308
37175,NC,Transylvania,,2007,4,12856,13391,535
37175,NC,Transylvania,,2008,5.1,12709,13398,689
37175,NC,Transylvania,,2009,9.7,12052,13346,1294
37175,NC,Transylvania,,2010,9.7,12517,13856,1339
37175,NC,Transylvania,,2011,9.4,12196,13462,1266
37175,NC,Transylvania,,2012,8.9,12360,13568,1208
37175,NC,Transylvania,,2013,7.2,12458,13427,969
37175,NC,Transylvania,,2014,5.7,12588,13345,757
37175,NC,Transylvania,,2015,5.4,12806,13533,727
37175,NC,Transylvania,,2016,4.9,13237,13915,678
37175,NC,Transylvania,,2017,4.3,13409,14013,604
37175,NC,Transylvania,,2018,3.8,13545,14084,539
37175,NC,Transylvania,,2019,3.6,14042,14573,531
37175,NC,Transylvania,,2020,6,12938,13757,819
37175,NC,Transylvania,,2021,4.1,13524,14101,577
37177,NC,Tyrrell,,2007,6.1,2087,2223,136
37177,NC,Tyrrell,,2008,7.1,2056,2214,158
37177,NC,Tyrrell,,2009,11.3,1975,2227,252
37177,NC,Tyrrell,,2010,14.7,1421,1665,244
37177,NC,Tyrrell,,2011,14.9,1397,1642,245
37177,NC,Tyrrell,,2012,13.9,1376,1599,223
37177,NC,Tyrrell,,2013,12.6,1366,1563,197
37177,NC,Tyrrell,,2014,9.7,1402,1552,150
37177,NC,Tyrrell,,2015,9.4,1400,1545,145
37177,NC,Tyrrell,,2016,8.5,1396,1525,129
37177,NC,Tyrrell,,2017,7.7,1361,1474,113
37177,NC,Tyrrell,,2018,6.3,1364,1456,92
37177,NC,Tyrrell,,2019,5.9,1328,1411,83
37177,NC,Tyrrell,,2020,9.1,1122,1234,112
37177,NC,Tyrrell,,2021,7,1193,1283,90
37179,NC,Union,,2007,4.3,87999,91931,3932
37179,NC,Union,,2008,5.5,90687,95972,5285
37179,NC,Union,,2009,10.4,86204,96241,10037
37179,NC,Union,,2010,9.9,91462,101531,10069
37179,NC,Union,,2011,9.1,93573,102947,9374
37179,NC,Union,,2012,8,96627,105081,8454
37179,NC,Union,,2013,6.4,99180,105927,6747
37179,NC,Union,,2014,5.1,103296,108842,5546
37179,NC,Union,,2015,4.8,106848,112222,5374
37179,NC,Union,,2016,4.4,110320,115411,5091
37179,NC,Union,,2017,4,112714,117423,4709
37179,NC,Union,,2018,3.5,115634,119890,4256
37179,NC,Union,,2019,3.5,118712,122955,4243
37179,NC,Union,,2020,5.8,112507,119383,6876
37179,NC,Union,,2021,3.9,118088,122890,4802
37181,NC,Vance,,2007,7.2,18309,19723,1414
37181,NC,Vance,,2008,8.9,17865,19605,1740
37181,NC,Vance,,2009,14.2,16788,19574,2786
37181,NC,Vance,,2010,14,16412,19080,2668
37181,NC,Vance,,2011,14.9,15952,18742,2790
37181,NC,Vance,,2012,13.8,16081,18665,2584
37181,NC,Vance,,2013,11.2,16114,18140,2026
37181,NC,Vance,,2014,9.1,16405,18043,1638
37181,NC,Vance,,2015,8.5,16496,18022,1526
37181,NC,Vance,,2016,7.2,16663,17949,1286
37181,NC,Vance,,2017,6.2,16542,17638,1096
37181,NC,Vance,,2018,5.9,16165,17175,1010
37181,NC,Vance,,2019,5.7,16259,17237,978
37181,NC,Vance,,2020,9.8,14921,16542,1621
37181,NC,Vance,,2021,7.9,15401,16724,1323
37183,NC,Wake,,2007,3.8,425915,442662,16747
37183,NC,Wake,,2008,4.6,436760,457854,21094
37183,NC,Wake,,2009,8.6,422898,462756,39858
37183,NC,Wake,,2010,8.2,442867,482446,39579
37183,NC,Wake,,2011,7.8,451953,490446,38493
37183,NC,Wake,,2012,7.3,469451,506466,37015
37183,NC,Wake,,2013,5.8,482605,512481,29876
37183,NC,Wake,,2014,4.8,498730,523736,25006
37183,NC,Wake,,2015,4.7,513915,539009,25094
37183,NC,Wake,,2016,4.3,531092,554963,23871
37183,NC,Wake,,2017,3.9,543121,565217,22096
37183,NC,Wake,,2018,3.5,557244,577250,20006
37183,NC,Wake,,2019,3.4,567415,587185,19770
37183,NC,Wake,,2020,6.2,536715,572430,35715
37183,NC,Wake,,2021,4,571029,594675,23646
37185,NC,Warren,,2007,6.7,7306,7832,526
37185,NC,Warren,,2008,8.4,7141,7798,657
37185,NC,Warren,,2009,13.7,6889,7984,1095
37185,NC,Warren,,2010,13.6,6546,7575,1029
37185,NC,Warren,,2011,13.9,6610,7680,1070
37185,NC,Warren,,2012,12.7,6675,7650,975
37185,NC,Warren,,2013,10.6,6529,7307,778
37185,NC,Warren,,2014,8.6,6591,7215,624
37185,NC,Warren,,2015,8.2,6612,7202,590
37185,NC,Warren,,2016,7.3,6600,7120,520
37185,NC,Warren,,2017,6.9,6268,6729,461
37185,NC,Warren,,2018,6.1,6076,6468,392
37185,NC,Warren,,2019,5.6,6154,6519,365
37185,NC,Warren,,2020,9.5,5721,6322,601
37185,NC,Warren,,2021,7.7,5941,6437,496
37187,NC,Washington,,2007,7,5995,6444,449
37187,NC,Washington,,2008,7.7,5697,6172,475
37187,NC,Washington,,2009,12.3,5519,6290,771
37187,NC,Washington,,2010,14.1,4904,5711,807
37187,NC,Washington,,2011,16.9,4169,5017,848
37187,NC,Washington,,2012,15.7,4149,4922,773
37187,NC,Washington,,2013,12.1,4660,5303,643
37187,NC,Washington,,2014,9.4,4564,5035,471
37187,NC,Washington,,2015,8.6,4534,4960,426
37187,NC,Washington,,2016,7.4,4490,4850,360
37187,NC,Washington,,2017,6.6,4392,4702,310
37187,NC,Washington,,2018,6,4280,4554,274
37187,NC,Washington,,2019,5.7,4181,4432,251
37187,NC,Washington,,2020,7.9,3914,4249,335
37187,NC,Washington,,2021,6.9,3977,4273,296
37189,NC,Watauga,,2007,3.7,23890,24800,910
37189,NC,Watauga,,2008,4.8,21992,23089,1097
37189,NC,Watauga,,2009,8.3,21299,23227,1928
37189,NC,Watauga,,2010,7.8,24894,26990,2096
37189,NC,Watauga,,2011,7.9,25010,27147,2137
37189,NC,Watauga,,2012,7.6,25213,27276,2063
37189,NC,Watauga,,2013,6.2,25339,27019,1680
37189,NC,Watauga,,2014,5,25683,27043,1360
37189,NC,Watauga,,2015,4.8,26056,27365,1309
37189,NC,Watauga,,2016,4.5,26608,27861,1253
37189,NC,Watauga,,2017,4.1,27018,28163,1145
37189,NC,Watauga,,2018,3.6,27484,28498,1014
37189,NC,Watauga,,2019,3.4,28244,29244,1000
37189,NC,Watauga,,2020,6.1,25442,27087,1645
37189,NC,Watauga,,2021,3.7,27356,28395,1039
37191,NC,Wayne,,2007,4.9,50316,52896,2580
37191,NC,Wayne,,2008,5.8,50627,53725,3098
37191,NC,Wayne,,2009,9.1,49423,54394,4971
37191,NC,Wayne,,2010,9.1,50031,55030,4999
37191,NC,Wayne,,2011,9,50194,55181,4987
37191,NC,Wayne,,2012,8.7,50996,55842,4846
37191,NC,Wayne,,2013,7.5,50734,54876,4142
37191,NC,Wayne,,2014,6.2,50510,53861,3351
37191,NC,Wayne,,2015,6,50458,53672,3214
37191,NC,Wayne,,2016,5.8,50274,53390,3116
37191,NC,Wayne,,2017,5,49994,52644,2650
37191,NC,Wayne,,2018,4.4,49569,51835,2266
37191,NC,Wayne,,2019,4.1,49392,51478,2086
37191,NC,Wayne,,2020,6.2,46620,49707,3087
37191,NC,Wayne,,2021,5,47916,50451,2535
37193,NC,Wilkes,,2007,5.9,29642,31485,1843
37193,NC,Wilkes,,2008,7.5,27990,30264,2274
37193,NC,Wilkes,,2009,13.2,26451,30481,4030
37193,NC,Wilkes,,2010,13.3,27037,31185,4148
37193,NC,Wilkes,,2011,11.8,27583,31260,3677
37193,NC,Wilkes,,2012,10.6,27577,30856,3279
37193,NC,Wilkes,,2013,8.7,27393,30000,2607
37193,NC,Wilkes,,2014,6.4,27643,29541,1898
37193,NC,Wilkes,,2015,5.6,27937,29597,1660
37193,NC,Wilkes,,2016,4.8,28665,30109,1444
37193,NC,Wilkes,,2017,4.3,29179,30477,1298
37193,NC,Wilkes,,2018,3.8,28593,29728,1135
37193,NC,Wilkes,,2019,4,27964,29115,1151
37193,NC,Wilkes,,2020,6.6,25654,27476,1822
37193,NC,Wilkes,,2021,4.7,25885,27164,1279
37195,NC,Wilson,,2007,6.8,38149,40921,2772
37195,NC,Wilson,,2008,7.7,36996,40096,3100
37195,NC,Wilson,,2009,13.2,34792,40074,5282
37195,NC,Wilson,,2010,13.8,33079,38356,5277
37195,NC,Wilson,,2011,13.9,33114,38457,5343
37195,NC,Wilson,,2012,13.3,33547,38694,5147
37195,NC,Wilson,,2013,11.4,33805,38163,4358
37195,NC,Wilson,,2014,9.2,34120,37589,3469
37195,NC,Wilson,,2015,9.4,33251,36697,3446
37195,NC,Wilson,,2016,8.2,33408,36377,2969
37195,NC,Wilson,,2017,7.2,32894,35457,2563
37195,NC,Wilson,,2018,6.3,32614,34789,2175
37195,NC,Wilson,,2019,5.7,32741,34705,1964
37195,NC,Wilson,,2020,8.6,30693,33578,2885
37195,NC,Wilson,,2021,6.7,31183,33434,2251
37197,NC,Yadkin,,2007,4.6,18260,19145,885
37197,NC,Yadkin,,2008,5.6,18311,19404,1093
37197,NC,Yadkin,,2009,10.9,16867,18921,2054
37197,NC,Yadkin,,2010,10.9,16282,18267,1985
37197,NC,Yadkin,,2011,10.3,16201,18067,1866
37197,NC,Yadkin,,2012,9.4,16414,18121,1707
37197,NC,Yadkin,,2013,7.5,16567,17916,1349
37197,NC,Yadkin,,2014,5.5,16564,17529,965
37197,NC,Yadkin,,2015,4.9,16608,17471,863
37197,NC,Yadkin,,2016,4.4,16786,17557,771
37197,NC,Yadkin,,2017,3.9,16755,17443,688
37197,NC,Yadkin,,2018,3.4,16779,17375,596
37197,NC,Yadkin,,2019,3.4,16983,17580,597
37197,NC,Yadkin,,2020,6.9,15687,16849,1162
37197,NC,Yadkin,,2021,4.2,16362,17084,722
37199,NC,Yancey,,2007,6.3,7605,8113,508
37199,NC,Yancey,,2008,7.6,7198,7794,596
37199,NC,Yancey,,2009,12.5,6967,7958,991
37199,NC,Yancey,,2010,11.7,6917,7837,920
37199,NC,Yancey,,2011,11.3,7019,7916,897
37199,NC,Yancey,,2012,10.9,7166,8046,880
37199,NC,Yancey,,2013,9.3,7094,7821,727
37199,NC,Yancey,,2014,6.6,6998,7489,491
37199,NC,Yancey,,2015,5.8,6976,7408,432
37199,NC,Yancey,,2016,5.2,7070,7455,385
37199,NC,Yancey,,2017,4.6,6987,7321,334
37199,NC,Yancey,,2018,3.7,7833,8130,297
37199,NC,Yancey,,2019,3.7,8061,8369,308
37199,NC,Yancey,,2020,6.4,7410,7920,510
37199,NC,Yancey,,2021,4.3,7649,7992,343
38000,ND,North Dakota,,2007,3,356434,367564,11130
38000,ND,North Dakota,,2008,3.1,360446,371843,11397
38000,ND,North Dakota,,2009,3.9,355736,370364,14628
38000,ND,North Dakota,,2010,3.7,365041,379062,14021
38000,ND,North Dakota,,2011,3.3,374434,387383,12949
38000,ND,North Dakota,,2012,2.9,383888,395490,11602
38000,ND,North Dakota,,2013,2.9,389928,401518,11590
38000,ND,North Dakota,,2014,2.6,398783,409503,10720
38000,ND,North Dakota,,2015,2.8,399296,410764,11468
38000,ND,North Dakota,,2016,3.1,399001,411778,12777
38000,ND,North Dakota,,2017,2.6,404901,415765,10864
38000,ND,North Dakota,,2018,2.4,403002,412764,9762
38000,ND,North Dakota,,2019,2.1,406304,415169,8865
38000,ND,North Dakota,,2020,5.1,390504,411550,21046
38000,ND,North Dakota,,2021,3.7,391255,406187,14932
38001,ND,Adams,,2007,2.4,1264,1295,31
38001,ND,Adams,,2008,2.3,1233,1262,29
38001,ND,Adams,,2009,3.1,1238,1277,39
38001,ND,Adams,,2010,2.8,1170,1204,34
38001,ND,Adams,,2011,2.7,1129,1160,31
38001,ND,Adams,,2012,2.7,1075,1105,30
38001,ND,Adams,,2013,2.5,1070,1097,27
38001,ND,Adams,,2014,2.6,1071,1100,29
38001,ND,Adams,,2015,2.9,1068,1100,32
38001,ND,Adams,,2016,2.6,1102,1131,29
38001,ND,Adams,,2017,2.5,1102,1130,28
38001,ND,Adams,,2018,1.8,1063,1083,20
38001,ND,Adams,,2019,1.9,1041,1061,20
38001,ND,Adams,,2020,3.8,973,1011,38
38001,ND,Adams,,2021,3.4,934,967,33
38003,ND,Barnes,,2007,3,5852,6035,183
38003,ND,Barnes,,2008,2.8,6110,6289,179
38003,ND,Barnes,,2009,4.1,6017,6275,258
38003,ND,Barnes,,2010,4.4,5927,6198,271
38003,ND,Barnes,,2011,3.8,5797,6026,229
38003,ND,Barnes,,2012,3.3,5531,5719,188
38003,ND,Barnes,,2013,3.2,5467,5646,179
38003,ND,Barnes,,2014,3,5365,5533,168
38003,ND,Barnes,,2015,3.2,5420,5600,180
38003,ND,Barnes,,2016,3.2,5430,5609,179
38003,ND,Barnes,,2017,2.8,5338,5489,151
38003,ND,Barnes,,2018,2.4,5198,5328,130
38003,ND,Barnes,,2019,2.7,5122,5265,143
38003,ND,Barnes,,2020,3.9,5010,5211,201
38003,ND,Barnes,,2021,3.1,5111,5273,162
38005,ND,Benson,,2007,6.4,2475,2644,169
38005,ND,Benson,,2008,6.2,2478,2643,165
38005,ND,Benson,,2009,5.8,2489,2641,152
38005,ND,Benson,,2010,5.3,2765,2919,154
38005,ND,Benson,,2011,5.8,2748,2918,170
38005,ND,Benson,,2012,6.7,2569,2753,184
38005,ND,Benson,,2013,7.5,2328,2518,190
38005,ND,Benson,,2014,6.3,2326,2483,157
38005,ND,Benson,,2015,4.6,2347,2460,113
38005,ND,Benson,,2016,4,2332,2429,97
38005,ND,Benson,,2017,3.6,2333,2420,87
38005,ND,Benson,,2018,3.5,2257,2340,83
38005,ND,Benson,,2019,3.8,2236,2324,88
38005,ND,Benson,,2020,6.8,2163,2321,158
38005,ND,Benson,,2021,5,2186,2300,114
38007,ND,Billings,,2007,2.4,495,507,12
38007,ND,Billings,,2008,2.1,515,526,11
38007,ND,Billings,,2009,2.3,519,531,12
38007,ND,Billings,,2010,3.1,413,426,13
38007,ND,Billings,,2011,3.7,422,438,16
38007,ND,Billings,,2012,3.2,456,471,15
38007,ND,Billings,,2013,2.8,456,469,13
38007,ND,Billings,,2014,2.9,472,486,14
38007,ND,Billings,,2015,3,450,464,14
38007,ND,Billings,,2016,3,424,437,13
38007,ND,Billings,,2017,2.9,432,445,13
38007,ND,Billings,,2018,2.5,421,432,11
38007,ND,Billings,,2019,2.2,436,446,10
38007,ND,Billings,,2020,3.6,423,439,16
38007,ND,Billings,,2021,2.9,431,444,13
38009,ND,Bottineau,,2007,3.5,3306,3425,119
38009,ND,Bottineau,,2008,3.2,3496,3610,114
38009,ND,Bottineau,,2009,3.7,3523,3657,134
38009,ND,Bottineau,,2010,3.9,3271,3403,132
38009,ND,Bottineau,,2011,3.6,3301,3425,124
38009,ND,Bottineau,,2012,3.2,3279,3389,110
38009,ND,Bottineau,,2013,3.8,3098,3222,124
38009,ND,Bottineau,,2014,3.3,3113,3220,107
38009,ND,Bottineau,,2015,4.4,3075,3216,141
38009,ND,Bottineau,,2016,4.7,3072,3222,150
38009,ND,Bottineau,,2017,3.3,3046,3150,104
38009,ND,Bottineau,,2018,3,2948,3040,92
38009,ND,Bottineau,,2019,3,2914,3004,90
38009,ND,Bottineau,,2020,5.4,2825,2985,160
38009,ND,Bottineau,,2021,4.8,2834,2976,142
38011,ND,Bowman,,2007,1.9,1730,1764,34
38011,ND,Bowman,,2008,2.1,1705,1741,36
38011,ND,Bowman,,2009,2.9,1696,1746,50
38011,ND,Bowman,,2010,2.5,1730,1775,45
38011,ND,Bowman,,2011,2.1,1832,1871,39
38011,ND,Bowman,,2012,1.8,1874,1908,34
38011,ND,Bowman,,2013,2,1936,1975,39
38011,ND,Bowman,,2014,1.8,1840,1873,33
38011,ND,Bowman,,2015,1.8,1813,1847,34
38011,ND,Bowman,,2016,2.2,1792,1832,40
38011,ND,Bowman,,2017,1.7,1746,1777,31
38011,ND,Bowman,,2018,1.7,1640,1668,28
38011,ND,Bowman,,2019,1.5,1716,1742,26
38011,ND,Bowman,,2020,3.4,1580,1635,55
38011,ND,Bowman,,2021,2.5,1542,1581,39
38013,ND,Burke,,2007,2.5,992,1017,25
38013,ND,Burke,,2008,2.4,1037,1062,25
38013,ND,Burke,,2009,3.1,1073,1107,34
38013,ND,Burke,,2010,2.7,1102,1133,31
38013,ND,Burke,,2011,2.3,1204,1232,28
38013,ND,Burke,,2012,1.9,1342,1368,26
38013,ND,Burke,,2013,2.2,1342,1372,30
38013,ND,Burke,,2014,2.5,1251,1283,32
38013,ND,Burke,,2015,3.3,1133,1172,39
38013,ND,Burke,,2016,4.5,1091,1143,52
38013,ND,Burke,,2017,3.1,1071,1105,34
38013,ND,Burke,,2018,2.1,1067,1090,23
38013,ND,Burke,,2019,2,1060,1082,22
38013,ND,Burke,,2020,5.3,984,1039,55
38013,ND,Burke,,2021,4.3,1001,1046,45
38015,ND,Burleigh,,2007,2.6,46069,47286,1217
38015,ND,Burleigh,,2008,2.7,46241,47525,1284
38015,ND,Burleigh,,2009,3.4,46164,47788,1624
38015,ND,Burleigh,,2010,3.5,44784,46427,1643
38015,ND,Burleigh,,2011,3.1,45124,46584,1460
38015,ND,Burleigh,,2012,2.7,45084,46335,1251
38015,ND,Burleigh,,2013,2.5,45644,46801,1157
38015,ND,Burleigh,,2014,2.4,45789,46912,1123
38015,ND,Burleigh,,2015,2.4,47414,48573,1159
38015,ND,Burleigh,,2016,2.6,49212,50517,1305
38015,ND,Burleigh,,2017,2.4,49873,51110,1237
38015,ND,Burleigh,,2018,2.4,49074,50278,1204
38015,ND,Burleigh,,2019,2.2,49491,50590,1099
38015,ND,Burleigh,,2020,4.3,49088,51298,2210
38015,ND,Burleigh,,2021,3.1,50080,51696,1616
38017,ND,Cass,,2007,2.5,85607,87785,2178
38017,ND,Cass,,2008,2.6,86787,89135,2348
38017,ND,Cass,,2009,3.9,84783,88255,3472
38017,ND,Cass,,2010,3.5,85913,88997,3084
38017,ND,Cass,,2011,3.1,86532,89339,2807
38017,ND,Cass,,2012,2.8,86578,89079,2501
38017,ND,Cass,,2013,2.7,87915,90391,2476
38017,ND,Cass,,2014,2.4,89562,91738,2176
38017,ND,Cass,,2015,2.2,92497,94623,2126
38017,ND,Cass,,2016,2.2,97756,99994,2238
38017,ND,Cass,,2017,2.1,101011,103174,2163
38017,ND,Cass,,2018,2.1,101921,104079,2158
38017,ND,Cass,,2019,1.8,103482,105410,1928
38017,ND,Cass,,2020,4.4,101632,106255,4623
38017,ND,Cass,,2021,2.9,104116,107219,3103
38019,ND,Cavalier,,2007,3,2033,2095,62
38019,ND,Cavalier,,2008,3,1980,2042,62
38019,ND,Cavalier,,2009,3.3,1923,1988,65
38019,ND,Cavalier,,2010,3,2197,2265,68
38019,ND,Cavalier,,2011,2.9,2177,2242,65
38019,ND,Cavalier,,2012,3,2071,2136,65
38019,ND,Cavalier,,2013,3.3,1986,2053,67
38019,ND,Cavalier,,2014,2.8,1971,2028,57
38019,ND,Cavalier,,2015,2.8,1988,2045,57
38019,ND,Cavalier,,2016,2.7,2055,2111,56
38019,ND,Cavalier,,2017,2.6,2027,2082,55
38019,ND,Cavalier,,2018,2.4,1960,2008,48
38019,ND,Cavalier,,2019,2.5,1871,1919,48
38019,ND,Cavalier,,2020,3.4,1849,1915,66
38019,ND,Cavalier,,2021,3.1,1812,1870,58
38021,ND,Dickey,,2007,2.6,2873,2950,77
38021,ND,Dickey,,2008,2.9,2839,2925,86
38021,ND,Dickey,,2009,5,2644,2783,139
38021,ND,Dickey,,2010,3.2,2771,2862,91
38021,ND,Dickey,,2011,2.8,2736,2815,79
38021,ND,Dickey,,2012,2.6,2623,2693,70
38021,ND,Dickey,,2013,2.3,2570,2631,61
38021,ND,Dickey,,2014,2,2508,2558,50
38021,ND,Dickey,,2015,1.9,2485,2532,47
38021,ND,Dickey,,2016,1.9,2492,2541,49
38021,ND,Dickey,,2017,1.7,2496,2540,44
38021,ND,Dickey,,2018,1.6,2400,2440,40
38021,ND,Dickey,,2019,1.7,2304,2344,40
38021,ND,Dickey,,2020,3.3,2240,2316,76
38021,ND,Dickey,,2021,2.7,2204,2265,61
38023,ND,Divide,,2007,3.2,872,901,29
38023,ND,Divide,,2008,3.1,862,890,28
38023,ND,Divide,,2009,3.5,852,883,31
38023,ND,Divide,,2010,2,1358,1386,28
38023,ND,Divide,,2011,1.7,1548,1575,27
38023,ND,Divide,,2012,1.5,1752,1778,26
38023,ND,Divide,,2013,1.4,1729,1753,24
38023,ND,Divide,,2014,1.5,1825,1852,27
38023,ND,Divide,,2015,1.8,1768,1801,33
38023,ND,Divide,,2016,2.6,1636,1680,44
38023,ND,Divide,,2017,1.6,1578,1604,26
38023,ND,Divide,,2018,1.2,1537,1555,18
38023,ND,Divide,,2019,1.3,1461,1480,19
38023,ND,Divide,,2020,3.2,1399,1445,46
38023,ND,Divide,,2021,2.4,1399,1434,35
38025,ND,Dunn,,2007,3.7,1629,1692,63
38025,ND,Dunn,,2008,3.1,1702,1757,55
38025,ND,Dunn,,2009,4,1716,1788,72
38025,ND,Dunn,,2010,3.1,2233,2305,72
38025,ND,Dunn,,2011,2,2862,2920,58
38025,ND,Dunn,,2012,1.5,3605,3659,54
38025,ND,Dunn,,2013,1.4,4003,4060,57
38025,ND,Dunn,,2014,1.2,4196,4248,52
38025,ND,Dunn,,2015,2,3908,3987,79
38025,ND,Dunn,,2016,3.1,3139,3241,102
38025,ND,Dunn,,2017,2.1,3136,3204,68
38025,ND,Dunn,,2018,1.5,3056,3102,46
38025,ND,Dunn,,2019,1.5,3229,3277,48
38025,ND,Dunn,,2020,4.6,3016,3162,146
38025,ND,Dunn,,2021,3.3,2994,3096,102
38027,ND,Eddy,,2007,5.3,1225,1294,69
38027,ND,Eddy,,2008,5.4,1182,1250,68
38027,ND,Eddy,,2009,5,1129,1189,60
38027,ND,Eddy,,2010,4.7,1239,1300,61
38027,ND,Eddy,,2011,4.7,1208,1268,60
38027,ND,Eddy,,2012,4.9,1181,1242,61
38027,ND,Eddy,,2013,6,1181,1256,75
38027,ND,Eddy,,2014,5.4,1206,1275,69
38027,ND,Eddy,,2015,4.8,1200,1260,60
38027,ND,Eddy,,2016,4.3,1221,1276,55
38027,ND,Eddy,,2017,4.7,1226,1286,60
38027,ND,Eddy,,2018,4.6,1203,1261,58
38027,ND,Eddy,,2019,3.9,1188,1236,48
38027,ND,Eddy,,2020,4.6,1150,1206,56
38027,ND,Eddy,,2021,4,1141,1188,47
38029,ND,Emmons,,2007,5,1618,1704,86
38029,ND,Emmons,,2008,4.7,1608,1688,80
38029,ND,Emmons,,2009,6.4,1575,1683,108
38029,ND,Emmons,,2010,6.7,1705,1828,123
38029,ND,Emmons,,2011,5.8,1661,1764,103
38029,ND,Emmons,,2012,5.1,1552,1636,84
38029,ND,Emmons,,2013,5.3,1489,1572,83
38029,ND,Emmons,,2014,5.5,1457,1541,84
38029,ND,Emmons,,2015,4.9,1463,1539,76
38029,ND,Emmons,,2016,4.4,1512,1581,69
38029,ND,Emmons,,2017,4,1507,1569,62
38029,ND,Emmons,,2018,4.4,1438,1504,66
38029,ND,Emmons,,2019,3.7,1402,1456,54
38029,ND,Emmons,,2020,4.8,1422,1494,72
38029,ND,Emmons,,2021,4.6,1421,1490,69
38031,ND,Foster,,2007,3.3,1646,1702,56
38031,ND,Foster,,2008,2.9,1721,1773,52
38031,ND,Foster,,2009,3.5,1677,1737,60
38031,ND,Foster,,2010,3.4,1745,1806,61
38031,ND,Foster,,2011,3.1,1707,1761,54
38031,ND,Foster,,2012,3,1624,1674,50
38031,ND,Foster,,2013,3.4,1560,1615,55
38031,ND,Foster,,2014,3,1565,1613,48
38031,ND,Foster,,2015,2.9,1570,1617,47
38031,ND,Foster,,2016,3,1632,1682,50
38031,ND,Foster,,2017,2.4,1637,1678,41
38031,ND,Foster,,2018,2.4,1581,1620,39
38031,ND,Foster,,2019,2.5,1501,1539,38
38031,ND,Foster,,2020,3.5,1508,1562,54
38031,ND,Foster,,2021,2.8,1468,1510,42
38033,ND,Golden Valley,,2007,2.6,854,877,23
38033,ND,Golden Valley,,2008,2.6,847,870,23
38033,ND,Golden Valley,,2009,3.2,866,895,29
38033,ND,Golden Valley,,2010,2.6,958,984,26
38033,ND,Golden Valley,,2011,2.5,955,979,24
38033,ND,Golden Valley,,2012,2.4,953,976,23
38033,ND,Golden Valley,,2013,2.2,940,961,21
38033,ND,Golden Valley,,2014,2.1,945,965,20
38033,ND,Golden Valley,,2015,2.3,948,970,22
38033,ND,Golden Valley,,2016,2.7,943,969,26
38033,ND,Golden Valley,,2017,2,926,945,19
38033,ND,Golden Valley,,2018,1.8,885,901,16
38033,ND,Golden Valley,,2019,1.6,839,853,14
38033,ND,Golden Valley,,2020,3.1,838,865,27
38033,ND,Golden Valley,,2021,2.7,815,838,23
38035,ND,Grand Forks,,2007,2.8,38324,39420,1096
38035,ND,Grand Forks,,2008,2.9,37896,39036,1140
38035,ND,Grand Forks,,2009,3.8,36638,38081,1443
38035,ND,Grand Forks,,2010,3.4,36648,37939,1291
38035,ND,Grand Forks,,2011,3.5,36274,37608,1334
38035,ND,Grand Forks,,2012,3.2,35877,37080,1203
38035,ND,Grand Forks,,2013,3,35675,36788,1113
38035,ND,Grand Forks,,2014,2.7,35566,36560,994
38035,ND,Grand Forks,,2015,2.4,36307,37216,909
38035,ND,Grand Forks,,2016,2.4,37818,38733,915
38035,ND,Grand Forks,,2017,2.2,38594,39456,862
38035,ND,Grand Forks,,2018,2,37794,38582,788
38035,ND,Grand Forks,,2019,1.9,37357,38062,705
38035,ND,Grand Forks,,2020,4.6,35591,37296,1705
38035,ND,Grand Forks,,2021,3.2,35926,37114,1188
38037,ND,Grant,,2007,3.4,1159,1200,41
38037,ND,Grant,,2008,4,1154,1202,48
38037,ND,Grant,,2009,4.1,1158,1207,49
38037,ND,Grant,,2010,3.6,1374,1426,52
38037,ND,Grant,,2011,3.5,1341,1389,48
38037,ND,Grant,,2012,3,1254,1293,39
38037,ND,Grant,,2013,2.9,1224,1261,37
38037,ND,Grant,,2014,2.7,1247,1282,35
38037,ND,Grant,,2015,3.1,1268,1309,41
38037,ND,Grant,,2016,3,1255,1294,39
38037,ND,Grant,,2017,2.9,1257,1295,38
38037,ND,Grant,,2018,2.4,1198,1228,30
38037,ND,Grant,,2019,2,1175,1199,24
38037,ND,Grant,,2020,2.7,1169,1202,33
38037,ND,Grant,,2021,2.7,1200,1233,33
38039,ND,Griggs,,2007,2.5,1281,1314,33
38039,ND,Griggs,,2008,2.4,1248,1279,31
38039,ND,Griggs,,2009,3.3,1249,1291,42
38039,ND,Griggs,,2010,2.9,1285,1323,38
38039,ND,Griggs,,2011,2.9,1227,1263,36
38039,ND,Griggs,,2012,2.5,1186,1217,31
38039,ND,Griggs,,2013,2.4,1161,1189,28
38039,ND,Griggs,,2014,2.3,1145,1172,27
38039,ND,Griggs,,2015,2.4,1119,1146,27
38039,ND,Griggs,,2016,2.9,1124,1157,33
38039,ND,Griggs,,2017,2.8,1105,1137,32
38039,ND,Griggs,,2018,2.1,1049,1071,22
38039,ND,Griggs,,2019,2.2,1019,1042,23
38039,ND,Griggs,,2020,3,996,1027,31
38039,ND,Griggs,,2021,2.8,997,1026,29
38041,ND,Hettinger,,2007,3.9,1111,1156,45
38041,ND,Hettinger,,2008,3.4,1086,1124,38
38041,ND,Hettinger,,2009,3.6,1141,1183,42
38041,ND,Hettinger,,2010,3,1438,1483,45
38041,ND,Hettinger,,2011,2.8,1443,1484,41
38041,ND,Hettinger,,2012,2.6,1409,1446,37
38041,ND,Hettinger,,2013,2.7,1424,1463,39
38041,ND,Hettinger,,2014,2,1490,1521,31
38041,ND,Hettinger,,2015,2.5,1504,1543,39
38041,ND,Hettinger,,2016,3,1490,1536,46
38041,ND,Hettinger,,2017,1.9,1465,1493,28
38041,ND,Hettinger,,2018,1.9,1399,1426,27
38041,ND,Hettinger,,2019,1.7,1379,1403,24
38041,ND,Hettinger,,2020,4,1342,1398,56
38041,ND,Hettinger,,2021,3.2,1347,1392,45
38043,ND,Kidder,,2007,4.7,1168,1226,58
38043,ND,Kidder,,2008,4,1195,1245,50
38043,ND,Kidder,,2009,4.6,1159,1215,56
38043,ND,Kidder,,2010,5.2,1337,1410,73
38043,ND,Kidder,,2011,5,1283,1351,68
38043,ND,Kidder,,2012,4.9,1194,1255,61
38043,ND,Kidder,,2013,4.7,1183,1241,58
38043,ND,Kidder,,2014,3.8,1216,1264,48
38043,ND,Kidder,,2015,3.7,1283,1332,49
38043,ND,Kidder,,2016,3.8,1321,1373,52
38043,ND,Kidder,,2017,3.6,1331,1380,49
38043,ND,Kidder,,2018,4,1265,1318,53
38043,ND,Kidder,,2019,3.6,1240,1286,46
38043,ND,Kidder,,2020,5.1,1235,1301,66
38043,ND,Kidder,,2021,5.2,1251,1319,68
38045,ND,LaMoure,,2007,3.1,2122,2189,67
38045,ND,LaMoure,,2008,3.2,2172,2244,72
38045,ND,LaMoure,,2009,4,2188,2280,92
38045,ND,LaMoure,,2010,3.5,2399,2485,86
38045,ND,LaMoure,,2011,2.9,2322,2391,69
38045,ND,LaMoure,,2012,2.4,2210,2265,55
38045,ND,LaMoure,,2013,2.3,2162,2212,50
38045,ND,LaMoure,,2014,2.4,2180,2233,53
38045,ND,LaMoure,,2015,2.5,2197,2253,56
38045,ND,LaMoure,,2016,2.4,2255,2310,55
38045,ND,LaMoure,,2017,1.9,2254,2297,43
38045,ND,LaMoure,,2018,1.8,2116,2154,38
38045,ND,LaMoure,,2019,1.9,2052,2091,39
38045,ND,LaMoure,,2020,2.7,2016,2071,55
38045,ND,LaMoure,,2021,2.3,1997,2043,46
38047,ND,Logan,,2007,3.4,897,929,32
38047,ND,Logan,,2008,3.5,894,926,32
38047,ND,Logan,,2009,3.4,915,947,32
38047,ND,Logan,,2010,3.5,967,1002,35
38047,ND,Logan,,2011,3,946,975,29
38047,ND,Logan,,2012,2.9,877,903,26
38047,ND,Logan,,2013,3.1,880,908,28
38047,ND,Logan,,2014,2.9,891,918,27
38047,ND,Logan,,2015,2.9,914,941,27
38047,ND,Logan,,2016,3.4,924,957,33
38047,ND,Logan,,2017,2.5,933,957,24
38047,ND,Logan,,2018,2.2,890,910,20
38047,ND,Logan,,2019,2.1,856,874,18
38047,ND,Logan,,2020,3.2,836,864,28
38047,ND,Logan,,2021,3,837,863,26
38049,ND,McHenry,,2007,4.8,2595,2727,132
38049,ND,McHenry,,2008,5,2602,2738,136
38049,ND,McHenry,,2009,4.9,2556,2688,132
38049,ND,McHenry,,2010,4.7,3133,3288,155
38049,ND,McHenry,,2011,4.4,3166,3313,147
38049,ND,McHenry,,2012,4.1,3128,3262,134
38049,ND,McHenry,,2013,4.1,3119,3253,134
38049,ND,McHenry,,2014,4.1,3131,3264,133
38049,ND,McHenry,,2015,4.2,3117,3254,137
38049,ND,McHenry,,2016,4.9,3204,3369,165
38049,ND,McHenry,,2017,4.2,3191,3332,141
38049,ND,McHenry,,2018,3.6,3056,3171,115
38049,ND,McHenry,,2019,3.2,3013,3112,99
38049,ND,McHenry,,2020,5.4,2953,3122,169
38049,ND,McHenry,,2021,4.3,2999,3135,136
38051,ND,McIntosh,,2007,2.7,1383,1422,39
38051,ND,McIntosh,,2008,2.8,1357,1396,39
38051,ND,McIntosh,,2009,3.7,1298,1348,50
38051,ND,McIntosh,,2010,4.3,1287,1345,58
38051,ND,McIntosh,,2011,3.6,1258,1305,47
38051,ND,McIntosh,,2012,3.1,1202,1240,38
38051,ND,McIntosh,,2013,3,1199,1236,37
38051,ND,McIntosh,,2014,2.9,1196,1232,36
38051,ND,McIntosh,,2015,3.2,1195,1234,39
38051,ND,McIntosh,,2016,3.1,1200,1238,38
38051,ND,McIntosh,,2017,2.6,1208,1240,32
38051,ND,McIntosh,,2018,2.4,1136,1164,28
38051,ND,McIntosh,,2019,2.8,1091,1122,31
38051,ND,McIntosh,,2020,3.3,1066,1102,36
38051,ND,McIntosh,,2021,3.5,1055,1093,38
38053,ND,McKenzie,,2007,3,2843,2930,87
38053,ND,McKenzie,,2008,2.3,3046,3119,73
38053,ND,McKenzie,,2009,3.1,2834,2925,91
38053,ND,McKenzie,,2010,2.1,3517,3594,77
38053,ND,McKenzie,,2011,1.7,4527,4606,79
38053,ND,McKenzie,,2012,1.5,5976,6064,88
38053,ND,McKenzie,,2013,1.5,7362,7473,111
38053,ND,McKenzie,,2014,1.5,8955,9089,134
38053,ND,McKenzie,,2015,2.5,8905,9132,227
38053,ND,McKenzie,,2016,3.8,7631,7930,299
38053,ND,McKenzie,,2017,2.5,8052,8256,204
38053,ND,McKenzie,,2018,1.5,9090,9232,142
38053,ND,McKenzie,,2019,1.4,10466,10619,153
38053,ND,McKenzie,,2020,7.6,8811,9537,726
38053,ND,McKenzie,,2021,5.5,8144,8620,476
38055,ND,McLean,,2007,4.5,4517,4728,211
38055,ND,McLean,,2008,4.4,4630,4843,213
38055,ND,McLean,,2009,4.5,4751,4975,224
38055,ND,McLean,,2010,5,4857,5110,253
38055,ND,McLean,,2011,4.6,4737,4963,226
38055,ND,McLean,,2012,4.2,4525,4724,199
38055,ND,McLean,,2013,4.2,4570,4769,199
38055,ND,McLean,,2014,3.9,4643,4831,188
38055,ND,McLean,,2015,3.7,4701,4884,183
38055,ND,McLean,,2016,3.5,4882,5058,176
38055,ND,McLean,,2017,3.1,4914,5073,159
38055,ND,McLean,,2018,3,4685,4831,146
38055,ND,McLean,,2019,2.8,4647,4783,136
38055,ND,McLean,,2020,4.5,4632,4850,218
38055,ND,McLean,,2021,3.7,4525,4698,173
38057,ND,Mercer,,2007,4,4564,4756,192
38057,ND,Mercer,,2008,4.5,4634,4850,216
38057,ND,Mercer,,2009,4.1,4941,5151,210
38057,ND,Mercer,,2010,5.1,4109,4332,223
38057,ND,Mercer,,2011,5.2,3910,4125,215
38057,ND,Mercer,,2012,5.1,3804,4008,204
38057,ND,Mercer,,2013,4.6,3933,4122,189
38057,ND,Mercer,,2014,3.9,3943,4101,158
38057,ND,Mercer,,2015,4.2,4095,4275,180
38057,ND,Mercer,,2016,4.4,4439,4643,204
38057,ND,Mercer,,2017,4,4318,4497,179
38057,ND,Mercer,,2018,3.8,3849,4003,154
38057,ND,Mercer,,2019,3.7,3546,3683,137
38057,ND,Mercer,,2020,5.7,3443,3653,210
38057,ND,Mercer,,2021,4.7,3498,3670,172
38059,ND,Morton,,2007,3.3,14543,15033,490
38059,ND,Morton,,2008,3.4,14524,15034,510
38059,ND,Morton,,2009,4.2,14408,15032,624
38059,ND,Morton,,2010,4.5,15305,16021,716
38059,ND,Morton,,2011,3.9,15168,15779,611
38059,ND,Morton,,2012,3.4,14881,15410,529
38059,ND,Morton,,2013,3.3,15085,15598,513
38059,ND,Morton,,2014,3.2,15270,15775,505
38059,ND,Morton,,2015,3.1,15639,16137,498
38059,ND,Morton,,2016,3.3,16212,16758,546
38059,ND,Morton,,2017,3.1,16321,16837,516
38059,ND,Morton,,2018,3,16114,16607,493
38059,ND,Morton,,2019,2.7,16273,16719,446
38059,ND,Morton,,2020,5,16112,16964,852
38059,ND,Morton,,2021,3.8,16409,17062,653
38061,ND,Mountrail,,2007,5.6,2806,2971,165
38061,ND,Mountrail,,2008,4.1,2873,2995,122
38061,ND,Mountrail,,2009,3.8,3582,3723,141
38061,ND,Mountrail,,2010,2.6,5381,5523,142
38061,ND,Mountrail,,2011,2.1,6347,6482,135
38061,ND,Mountrail,,2012,1.6,7257,7372,115
38061,ND,Mountrail,,2013,1.5,7795,7916,121
38061,ND,Mountrail,,2014,1.2,8846,8957,111
38061,ND,Mountrail,,2015,2,7920,8079,159
38061,ND,Mountrail,,2016,3,6904,7117,213
38061,ND,Mountrail,,2017,2,6950,7094,144
38061,ND,Mountrail,,2018,1.4,7105,7208,103
38061,ND,Mountrail,,2019,1.2,7438,7532,94
38061,ND,Mountrail,,2020,5.2,6579,6941,362
38061,ND,Mountrail,,2021,3.5,6259,6486,227
38063,ND,Nelson,,2007,4,1578,1643,65
38063,ND,Nelson,,2008,3.2,1680,1736,56
38063,ND,Nelson,,2009,3.9,1656,1724,68
38063,ND,Nelson,,2010,4,1627,1694,67
38063,ND,Nelson,,2011,4.2,1589,1659,70
38063,ND,Nelson,,2012,4,1476,1537,61
38063,ND,Nelson,,2013,4.3,1471,1537,66
38063,ND,Nelson,,2014,3.7,1460,1516,56
38063,ND,Nelson,,2015,3.7,1449,1505,56
38063,ND,Nelson,,2016,3.4,1479,1531,52
38063,ND,Nelson,,2017,3.1,1461,1507,46
38063,ND,Nelson,,2018,3,1391,1434,43
38063,ND,Nelson,,2019,2.8,1369,1409,40
38063,ND,Nelson,,2020,4.5,1340,1403,63
38063,ND,Nelson,,2021,3.7,1343,1395,52
38065,ND,Oliver,,2007,4.1,1085,1131,46
38065,ND,Oliver,,2008,4.4,1100,1151,51
38065,ND,Oliver,,2009,3.8,1238,1287,49
38065,ND,Oliver,,2010,5.6,876,928,52
38065,ND,Oliver,,2011,5.9,866,920,54
38065,ND,Oliver,,2012,6.4,827,884,57
38065,ND,Oliver,,2013,6.1,828,882,54
38065,ND,Oliver,,2014,6.2,816,870,54
38065,ND,Oliver,,2015,5.9,824,876,52
38065,ND,Oliver,,2016,5.5,847,896,49
38065,ND,Oliver,,2017,4.1,886,924,38
38065,ND,Oliver,,2018,3.7,859,892,33
38065,ND,Oliver,,2019,3.4,855,885,30
38065,ND,Oliver,,2020,5.1,830,875,45
38065,ND,Oliver,,2021,3.8,840,873,33
38067,ND,Pembina,,2007,5.4,3804,4022,218
38067,ND,Pembina,,2008,5.1,3746,3946,200
38067,ND,Pembina,,2009,5.6,3704,3925,221
38067,ND,Pembina,,2010,6.2,3778,4029,251
38067,ND,Pembina,,2011,6.7,3652,3913,261
38067,ND,Pembina,,2012,6.1,3455,3681,226
38067,ND,Pembina,,2013,6,3369,3585,216
38067,ND,Pembina,,2014,5.5,3364,3559,195
38067,ND,Pembina,,2015,5.3,3389,3580,191
38067,ND,Pembina,,2016,5,3469,3652,183
38067,ND,Pembina,,2017,4.2,3415,3563,148
38067,ND,Pembina,,2018,3.6,3303,3427,124
38067,ND,Pembina,,2019,3.1,3274,3377,103
38067,ND,Pembina,,2020,5.6,3215,3405,190
38067,ND,Pembina,,2021,4.8,3166,3327,161
38069,ND,Pierce,,2007,4.3,1830,1913,83
38069,ND,Pierce,,2008,4.2,1855,1937,82
38069,ND,Pierce,,2009,5,1808,1904,96
38069,ND,Pierce,,2010,5.2,1896,2000,104
38069,ND,Pierce,,2011,4.6,1840,1929,89
38069,ND,Pierce,,2012,4.1,1786,1863,77
38069,ND,Pierce,,2013,4.2,1733,1809,76
38069,ND,Pierce,,2014,4.1,1710,1784,74
38069,ND,Pierce,,2015,4.2,1747,1824,77
38069,ND,Pierce,,2016,4,1819,1894,75
38069,ND,Pierce,,2017,3.1,1845,1905,60
38069,ND,Pierce,,2018,2.9,1750,1803,53
38069,ND,Pierce,,2019,2.9,1692,1742,50
38069,ND,Pierce,,2020,4.3,1642,1715,73
38069,ND,Pierce,,2021,3.4,1624,1681,57
38071,ND,Ramsey,,2007,3.8,5668,5894,226
38071,ND,Ramsey,,2008,3.7,5638,5852,214
38071,ND,Ramsey,,2009,4,5487,5717,230
38071,ND,Ramsey,,2010,3.7,5827,6053,226
38071,ND,Ramsey,,2011,3.7,5830,6053,223
38071,ND,Ramsey,,2012,4,5561,5790,229
38071,ND,Ramsey,,2013,3.7,5473,5686,213
38071,ND,Ramsey,,2014,3.5,5413,5608,195
38071,ND,Ramsey,,2015,3.4,5453,5645,192
38071,ND,Ramsey,,2016,2.9,5958,6133,175
38071,ND,Ramsey,,2017,2.7,5776,5935,159
38071,ND,Ramsey,,2018,2.6,5605,5754,149
38071,ND,Ramsey,,2019,2.6,5583,5734,151
38071,ND,Ramsey,,2020,4.4,5499,5754,255
38071,ND,Ramsey,,2021,3.3,5543,5730,187
38073,ND,Ransom,,2007,3,2971,3064,93
38073,ND,Ransom,,2008,3.5,2992,3100,108
38073,ND,Ransom,,2009,7.6,2729,2954,225
38073,ND,Ransom,,2010,4.5,2732,2861,129
38073,ND,Ransom,,2011,3.4,2772,2871,99
38073,ND,Ransom,,2012,2.9,2703,2783,80
38073,ND,Ransom,,2013,2.9,2657,2735,78
38073,ND,Ransom,,2014,2.8,2625,2700,75
38073,ND,Ransom,,2015,2.5,2686,2754,68
38073,ND,Ransom,,2016,2.3,2769,2833,64
38073,ND,Ransom,,2017,1.9,2795,2850,55
38073,ND,Ransom,,2018,1.7,2830,2880,50
38073,ND,Ransom,,2019,1.6,2819,2864,45
38073,ND,Ransom,,2020,4,2782,2898,116
38073,ND,Ransom,,2021,2.6,2627,2696,69
38075,ND,Renville,,2007,2.9,1254,1292,38
38075,ND,Renville,,2008,2.5,1234,1266,32
38075,ND,Renville,,2009,3.8,1201,1248,47
38075,ND,Renville,,2010,2.7,1422,1462,40
38075,ND,Renville,,2011,2.7,1403,1442,39
38075,ND,Renville,,2012,2.2,1406,1437,31
38075,ND,Renville,,2013,2.4,1354,1388,34
38075,ND,Renville,,2014,2.6,1355,1391,36
38075,ND,Renville,,2015,3.3,1283,1327,44
38075,ND,Renville,,2016,3.9,1255,1306,51
38075,ND,Renville,,2017,2.6,1253,1286,33
38075,ND,Renville,,2018,2.2,1213,1240,27
38075,ND,Renville,,2019,2.2,1201,1228,27
38075,ND,Renville,,2020,4.9,1174,1235,61
38075,ND,Renville,,2021,3.4,1160,1201,41
38077,ND,Richland,,2007,3.2,8712,9003,291
38077,ND,Richland,,2008,3.8,8645,8985,340
38077,ND,Richland,,2009,4.9,8285,8714,429
38077,ND,Richland,,2010,3.8,8736,9077,341
38077,ND,Richland,,2011,3.7,8528,8853,325
38077,ND,Richland,,2012,3.5,8215,8512,297
38077,ND,Richland,,2013,3.3,8197,8481,284
38077,ND,Richland,,2014,3,8170,8420,250
38077,ND,Richland,,2015,2.7,8298,8531,233
38077,ND,Richland,,2016,2.7,8640,8884,244
38077,ND,Richland,,2017,2.4,8710,8921,211
38077,ND,Richland,,2018,2.4,8658,8868,210
38077,ND,Richland,,2019,2.1,8589,8774,185
38077,ND,Richland,,2020,3.8,8325,8656,331
38077,ND,Richland,,2021,2.7,8431,8669,238
38079,ND,Rolette,,2007,8.8,4699,5153,454
38079,ND,Rolette,,2008,9.3,4549,5016,467
38079,ND,Rolette,,2009,11,4409,4956,547
38079,ND,Rolette,,2010,10.7,4728,5295,567
38079,ND,Rolette,,2011,10.6,4582,5126,544
38079,ND,Rolette,,2012,10.1,4473,4978,505
38079,ND,Rolette,,2013,12.3,4243,4837,594
38079,ND,Rolette,,2014,11.2,4199,4730,531
38079,ND,Rolette,,2015,10.3,4349,4850,501
38079,ND,Rolette,,2016,10.8,4437,4977,540
38079,ND,Rolette,,2017,10.2,4380,4880,500
38079,ND,Rolette,,2018,8.6,4329,4737,408
38079,ND,Rolette,,2019,7.4,4317,4662,345
38079,ND,Rolette,,2020,13.5,4154,4804,650
38079,ND,Rolette,,2021,10.6,4271,4780,509
38081,ND,Sargent,,2007,3.5,2149,2228,79
38081,ND,Sargent,,2008,4.5,2134,2235,101
38081,ND,Sargent,,2009,10.2,1801,2005,204
38081,ND,Sargent,,2010,4.2,1963,2050,87
38081,ND,Sargent,,2011,2.9,2042,2104,62
38081,ND,Sargent,,2012,2.5,2081,2135,54
38081,ND,Sargent,,2013,2.5,2062,2115,53
38081,ND,Sargent,,2014,2.2,2094,2141,47
38081,ND,Sargent,,2015,1.8,2197,2238,41
38081,ND,Sargent,,2016,1.9,2282,2327,45
38081,ND,Sargent,,2017,2,2364,2412,48
38081,ND,Sargent,,2018,1.7,2552,2596,44
38081,ND,Sargent,,2019,1.6,2681,2725,44
38081,ND,Sargent,,2020,4.2,2694,2813,119
38081,ND,Sargent,,2021,2.7,2322,2386,64
38083,ND,Sheridan,,2007,4.9,604,635,31
38083,ND,Sheridan,,2008,4,620,646,26
38083,ND,Sheridan,,2009,5,629,662,33
38083,ND,Sheridan,,2010,3.8,781,812,31
38083,ND,Sheridan,,2011,3.9,766,797,31
38083,ND,Sheridan,,2012,3.5,707,733,26
38083,ND,Sheridan,,2013,3.9,681,709,28
38083,ND,Sheridan,,2014,4.9,682,717,35
38083,ND,Sheridan,,2015,5,684,720,36
38083,ND,Sheridan,,2016,5.6,693,734,41
38083,ND,Sheridan,,2017,4.4,709,742,33
38083,ND,Sheridan,,2018,4.2,668,697,29
38083,ND,Sheridan,,2019,4,656,683,27
38083,ND,Sheridan,,2020,5.9,643,683,40
38083,ND,Sheridan,,2021,5.3,626,661,35
38085,ND,Sioux,,2007,6.2,1213,1293,80
38085,ND,Sioux,,2008,5.1,1241,1308,67
38085,ND,Sioux,,2009,4.8,1230,1292,62
38085,ND,Sioux,,2010,5,1244,1309,65
38085,ND,Sioux,,2011,5.2,1255,1324,69
38085,ND,Sioux,,2012,4.9,1234,1298,64
38085,ND,Sioux,,2013,4.6,1240,1300,60
38085,ND,Sioux,,2014,4.6,1227,1286,59
38085,ND,Sioux,,2015,4.4,1227,1283,56
38085,ND,Sioux,,2016,4.4,1277,1336,59
38085,ND,Sioux,,2017,3.7,1260,1308,48
38085,ND,Sioux,,2018,3.7,1219,1266,47
38085,ND,Sioux,,2019,3.4,1182,1224,42
38085,ND,Sioux,,2020,4,1152,1200,48
38085,ND,Sioux,,2021,3.5,1170,1213,43
38087,ND,Slope,,2007,1.6,620,630,10
38087,ND,Slope,,2008,1.3,753,763,10
38087,ND,Slope,,2009,2,553,564,11
38087,ND,Slope,,2010,2.1,460,470,10
38087,ND,Slope,,2011,2,482,492,10
38087,ND,Slope,,2012,2.1,515,526,11
38087,ND,Slope,,2013,2.1,506,517,11
38087,ND,Slope,,2014,2,496,506,10
38087,ND,Slope,,2015,2.6,449,461,12
38087,ND,Slope,,2016,2.5,424,435,11
38087,ND,Slope,,2017,1.9,424,432,8
38087,ND,Slope,,2018,2,398,406,8
38087,ND,Slope,,2019,2,390,398,8
38087,ND,Slope,,2020,3,383,395,12
38087,ND,Slope,,2021,2.8,346,356,10
38089,ND,Stark,,2007,2.4,13626,13961,335
38089,ND,Stark,,2008,2.3,14021,14349,328
38089,ND,Stark,,2009,3,14040,14481,441
38089,ND,Stark,,2010,2.7,14180,14576,396
38089,ND,Stark,,2011,2.1,15688,16027,339
38089,ND,Stark,,2012,1.7,17846,18163,317
38089,ND,Stark,,2013,1.7,18931,19255,324
38089,ND,Stark,,2014,1.6,20757,21091,334
38089,ND,Stark,,2015,2.7,19583,20128,545
38089,ND,Stark,,2016,3.9,17341,18048,707
38089,ND,Stark,,2017,2.7,17719,18205,486
38089,ND,Stark,,2018,2.2,18179,18586,407
38089,ND,Stark,,2019,1.8,18709,19056,347
38089,ND,Stark,,2020,7.2,17132,18471,1339
38089,ND,Stark,,2021,4.7,16695,17518,823
38091,ND,Steele,,2007,2.2,1095,1120,25
38091,ND,Steele,,2008,2.1,1147,1172,25
38091,ND,Steele,,2009,2.8,1091,1122,31
38091,ND,Steele,,2010,2.7,1073,1103,30
38091,ND,Steele,,2011,2.5,1083,1111,28
38091,ND,Steele,,2012,2.6,1016,1043,27
38091,ND,Steele,,2013,2.4,1005,1030,25
38091,ND,Steele,,2014,2.2,995,1017,22
38091,ND,Steele,,2015,2.3,1031,1055,24
38091,ND,Steele,,2016,2.1,1049,1072,23
38091,ND,Steele,,2017,1.7,1052,1070,18
38091,ND,Steele,,2018,1.9,1001,1020,19
38091,ND,Steele,,2019,1.8,979,997,18
38091,ND,Steele,,2020,2.9,935,963,28
38091,ND,Steele,,2021,3,904,932,28
38093,ND,Stutsman,,2007,2.8,11558,11887,329
38093,ND,Stutsman,,2008,2.8,11441,11776,335
38093,ND,Stutsman,,2009,3.4,11536,11940,404
38093,ND,Stutsman,,2010,4.1,10826,11284,458
38093,ND,Stutsman,,2011,3.7,10409,10805,396
38093,ND,Stutsman,,2012,3.3,10021,10362,341
38093,ND,Stutsman,,2013,3.1,10059,10382,323
38093,ND,Stutsman,,2014,2.7,10038,10317,279
38093,ND,Stutsman,,2015,2.6,10350,10624,274
38093,ND,Stutsman,,2016,2.5,10782,11055,273
38093,ND,Stutsman,,2017,2.3,10832,11091,259
38093,ND,Stutsman,,2018,2.3,10505,10748,243
38093,ND,Stutsman,,2019,2.1,10324,10541,217
38093,ND,Stutsman,,2020,3.5,10209,10575,366
38093,ND,Stutsman,,2021,3,10077,10389,312
38095,ND,Towner,,2007,3.8,1101,1145,44
38095,ND,Towner,,2008,3.1,1077,1112,35
38095,ND,Towner,,2009,3,1050,1082,32
38095,ND,Towner,,2010,2.6,1362,1399,37
38095,ND,Towner,,2011,2.9,1306,1345,39
38095,ND,Towner,,2012,3.2,1212,1252,40
38095,ND,Towner,,2013,3.8,1154,1200,46
38095,ND,Towner,,2014,3.4,1179,1221,42
38095,ND,Towner,,2015,2.7,1199,1232,33
38095,ND,Towner,,2016,2.2,1299,1328,29
38095,ND,Towner,,2017,2.5,1229,1260,31
38095,ND,Towner,,2018,2.3,1181,1209,28
38095,ND,Towner,,2019,2.5,1131,1160,29
38095,ND,Towner,,2020,2.8,1126,1159,33
38095,ND,Towner,,2021,3.3,1101,1138,37
38097,ND,Traill,,2007,3.2,4103,4240,137
38097,ND,Traill,,2008,3.2,4042,4176,134
38097,ND,Traill,,2009,3.8,3889,4043,154
38097,ND,Traill,,2010,3.6,4405,4571,166
38097,ND,Traill,,2011,3.5,4430,4592,162
38097,ND,Traill,,2012,3,4368,4504,136
38097,ND,Traill,,2013,2.9,4322,4450,128
38097,ND,Traill,,2014,2.6,4295,4408,113
38097,ND,Traill,,2015,2.8,4290,4415,125
38097,ND,Traill,,2016,2.8,4461,4589,128
38097,ND,Traill,,2017,2.4,4533,4646,113
38097,ND,Traill,,2018,2.4,4413,4521,108
38097,ND,Traill,,2019,2.3,4368,4473,105
38097,ND,Traill,,2020,3.6,4322,4483,161
38097,ND,Traill,,2021,3,4304,4439,135
38099,ND,Walsh,,2007,4.1,5502,5737,235
38099,ND,Walsh,,2008,4.2,5455,5696,241
38099,ND,Walsh,,2009,4.7,5355,5617,262
38099,ND,Walsh,,2010,5,5921,6232,311
38099,ND,Walsh,,2011,4.8,5657,5945,288
38099,ND,Walsh,,2012,4.7,5364,5628,264
38099,ND,Walsh,,2013,4.9,5287,5561,274
38099,ND,Walsh,,2014,4.5,5258,5508,250
38099,ND,Walsh,,2015,4.2,5302,5534,232
38099,ND,Walsh,,2016,3.8,5435,5649,214
38099,ND,Walsh,,2017,3.3,5463,5652,189
38099,ND,Walsh,,2018,2.9,5227,5381,154
38099,ND,Walsh,,2019,2.9,5086,5239,153
38099,ND,Walsh,,2020,4.5,4953,5187,234
38099,ND,Walsh,,2021,4.6,5032,5274,242
38101,ND,Ward,,2007,2.9,28515,29368,853
38101,ND,Ward,,2008,2.9,28931,29785,854
38101,ND,Ward,,2009,3.5,28917,29975,1058
38101,ND,Ward,,2010,3.4,30518,31588,1070
38101,ND,Ward,,2011,3.1,31394,32390,996
38101,ND,Ward,,2012,2.5,32902,33758,856
38101,ND,Ward,,2013,2.7,33178,34096,918
38101,ND,Ward,,2014,2.6,33265,34144,879
38101,ND,Ward,,2015,3.2,32926,34012,1086
38101,ND,Ward,,2016,4.1,32086,33466,1380
38101,ND,Ward,,2017,3.2,31874,32935,1061
38101,ND,Ward,,2018,2.6,31611,32455,844
38101,ND,Ward,,2019,2.2,31649,32372,723
38101,ND,Ward,,2020,6,30237,32163,1926
38101,ND,Ward,,2021,4.3,30452,31812,1360
38103,ND,Wells,,2007,4.5,2038,2133,95
38103,ND,Wells,,2008,4.3,2026,2116,90
38103,ND,Wells,,2009,5,1945,2048,103
38103,ND,Wells,,2010,3.9,2241,2333,92
38103,ND,Wells,,2011,4.2,2206,2303,97
38103,ND,Wells,,2012,3.8,2129,2213,84
38103,ND,Wells,,2013,4.3,2094,2188,94
38103,ND,Wells,,2014,4.3,2075,2168,93
38103,ND,Wells,,2015,4,2069,2155,86
38103,ND,Wells,,2016,3.8,2101,2185,84
38103,ND,Wells,,2017,3.2,2099,2169,70
38103,ND,Wells,,2018,2.8,1965,2022,57
38103,ND,Wells,,2019,2.8,1866,1919,53
38103,ND,Wells,,2020,4.3,1835,1918,83
38103,ND,Wells,,2021,4.2,1816,1896,80
38105,ND,Williams,,2007,1.8,12857,13098,241
38105,ND,Williams,,2008,1.7,14471,14715,244
38105,ND,Williams,,2009,2.4,14480,14835,355
38105,ND,Williams,,2010,2.1,14129,14439,310
38105,ND,Williams,,2011,1.4,19767,20040,273
38105,ND,Williams,,2012,1.1,26668,26956,288
38105,ND,Williams,,2013,1.2,28593,28948,355
38105,ND,Williams,,2014,1.2,31132,31500,368
38105,ND,Williams,,2015,2.4,27801,28478,677
38105,ND,Williams,,2016,4.4,21599,22585,986
38105,ND,Williams,,2017,2.5,22450,23024,574
38105,ND,Williams,,2018,1.8,23748,24189,441
38105,ND,Williams,,2019,1.6,24741,25155,414
38105,ND,Williams,,2020,9.7,21042,23314,2272
38105,ND,Williams,,2021,6.7,19473,20877,1404
39000,OH,Ohio,,2007,5.6,5679258,6017203,337945
39000,OH,Ohio,,2008,6.6,5609101,6002468,393367
39000,OH,Ohio,,2009,10.2,5304803,5904847,600044
39000,OH,Ohio,,2010,10.3,5267304,5871473,604169
39000,OH,Ohio,,2011,8.8,5263728,5773480,509752
39000,OH,Ohio,,2012,7.4,5290392,5712475,422083
39000,OH,Ohio,,2013,7.5,5281459,5706777,425318
39000,OH,Ohio,,2014,5.8,5381787,5713176,331389
39000,OH,Ohio,,2015,5,5427850,5710776,282926
39000,OH,Ohio,,2016,5,5464097,5754480,290383
39000,OH,Ohio,,2017,5,5529479,5818975,289496
39000,OH,Ohio,,2018,4.5,5553767,5815549,261782
39000,OH,Ohio,,2019,4.2,5626326,5871248,244922
39000,OH,Ohio,,2020,8.2,5263034,5734179,471145
39000,OH,Ohio,,2021,5.1,5441879,5736882,295003
39001,OH,Adams,,2007,7.7,12596,13648,1052
39001,OH,Adams,,2008,9.4,12055,13310,1255
39001,OH,Adams,,2009,14.6,11101,13005,1904
39001,OH,Adams,,2010,16,9998,11899,1901
39001,OH,Adams,,2011,14.3,9845,11489,1644
39001,OH,Adams,,2012,12.5,9421,10773,1352
39001,OH,Adams,,2013,12.7,9329,10684,1355
39001,OH,Adams,,2014,9.2,9574,10542,968
39001,OH,Adams,,2015,7.9,9870,10722,852
39001,OH,Adams,,2016,7.6,10156,10987,831
39001,OH,Adams,,2017,7.2,10175,10960,785
39001,OH,Adams,,2018,7,10180,10950,770
39001,OH,Adams,,2019,6.9,10136,10884,748
39001,OH,Adams,,2020,9.3,9850,10860,1010
39001,OH,Adams,,2021,6.3,10275,10967,692
39003,OH,Allen,,2007,6.3,49320,52648,3328
39003,OH,Allen,,2008,7.5,48211,52109,3898
39003,OH,Allen,,2009,11.3,45481,51265,5784
39003,OH,Allen,,2010,10.7,46498,52085,5587
39003,OH,Allen,,2011,9.5,45984,50812,4828
39003,OH,Allen,,2012,7.7,46117,49967,3850
39003,OH,Allen,,2013,7.8,45572,49437,3865
39003,OH,Allen,,2014,5.8,45671,48478,2807
39003,OH,Allen,,2015,4.9,45647,47999,2352
39003,OH,Allen,,2016,5,46006,48450,2444
39003,OH,Allen,,2017,5,46443,48876,2433
39003,OH,Allen,,2018,4.5,45984,48129,2145
39003,OH,Allen,,2019,4.1,46274,48240,1966
39003,OH,Allen,,2020,8.6,43690,47786,4096
39003,OH,Allen,,2021,5.7,44818,47538,2720
39005,OH,Ashland,,2007,6,26187,27860,1673
39005,OH,Ashland,,2008,7.6,25366,27439,2073
39005,OH,Ashland,,2009,12.5,23782,27176,3394
39005,OH,Ashland,,2010,11.9,23489,26666,3177
39005,OH,Ashland,,2011,9.9,23497,26067,2570
39005,OH,Ashland,,2012,8,23760,25832,2072
39005,OH,Ashland,,2013,8.1,23448,25506,2058
39005,OH,Ashland,,2014,6,24091,25616,1525
39005,OH,Ashland,,2015,5.1,24739,26064,1325
39005,OH,Ashland,,2016,5.1,25018,26365,1347
39005,OH,Ashland,,2017,4.9,25094,26390,1296
39005,OH,Ashland,,2018,4.6,25105,26302,1197
39005,OH,Ashland,,2019,4.2,25884,27014,1130
39005,OH,Ashland,,2020,6.5,24564,26265,1701
39005,OH,Ashland,,2021,4.3,25190,26333,1143
39007,OH,Ashtabula,,2007,7,46591,50101,3510
39007,OH,Ashtabula,,2008,8.1,45446,49457,4011
39007,OH,Ashtabula,,2009,13.5,41944,48517,6573
39007,OH,Ashtabula,,2010,13,42190,48478,6288
39007,OH,Ashtabula,,2011,10.9,42292,47442,5150
39007,OH,Ashtabula,,2012,9.4,42089,46455,4366
39007,OH,Ashtabula,,2013,9.5,41634,45988,4354
39007,OH,Ashtabula,,2014,7.2,41823,45049,3226
39007,OH,Ashtabula,,2015,6,41816,44504,2688
39007,OH,Ashtabula,,2016,6.1,41673,44399,2726
39007,OH,Ashtabula,,2017,5.9,41788,44402,2614
39007,OH,Ashtabula,,2018,5.2,42299,44631,2332
39007,OH,Ashtabula,,2019,4.8,42699,44862,2163
39007,OH,Ashtabula,,2020,8.3,40010,43647,3637
39007,OH,Ashtabula,,2021,5.5,40944,43322,2378
39009,OH,Athens,,2007,6.1,28953,30839,1886
39009,OH,Athens,,2008,6.8,28955,31055,2100
39009,OH,Athens,,2009,8.8,28538,31285,2747
39009,OH,Athens,,2010,10.7,25621,28676,3055
39009,OH,Athens,,2011,9.9,25022,27780,2758
39009,OH,Athens,,2012,8.5,25250,27602,2352
39009,OH,Athens,,2013,9,25014,27486,2472
39009,OH,Athens,,2014,6.9,25780,27676,1896
39009,OH,Athens,,2015,6.3,26244,28006,1762
39009,OH,Athens,,2016,6.4,26318,28129,1811
39009,OH,Athens,,2017,6,26775,28497,1722
39009,OH,Athens,,2018,5.6,26414,27993,1579
39009,OH,Athens,,2019,5.3,26605,28095,1490
39009,OH,Athens,,2020,7.6,24334,26343,2009
39009,OH,Athens,,2021,5.6,24107,25533,1426
39011,OH,Auglaize,,2007,4.5,26138,27356,1218
39011,OH,Auglaize,,2008,5.5,25610,27106,1496
39011,OH,Auglaize,,2009,10.6,23667,26484,2817
39011,OH,Auglaize,,2010,10,22126,24596,2470
39011,OH,Auglaize,,2011,8.1,22116,24060,1944
39011,OH,Auglaize,,2012,6.2,22479,23958,1479
39011,OH,Auglaize,,2013,5.9,22537,23948,1411
39011,OH,Auglaize,,2014,4.3,23155,24202,1047
39011,OH,Auglaize,,2015,3.7,23619,24530,911
39011,OH,Auglaize,,2016,3.8,23789,24716,927
39011,OH,Auglaize,,2017,3.7,23919,24833,914
39011,OH,Auglaize,,2018,3.3,23948,24757,809
39011,OH,Auglaize,,2019,3,24384,25146,762
39011,OH,Auglaize,,2020,6.9,22818,24501,1683
39011,OH,Auglaize,,2021,3.7,23465,24365,900
39013,OH,Belmont,,2007,5.6,31260,33120,1860
39013,OH,Belmont,,2008,6.2,31509,33583,2074
39013,OH,Belmont,,2009,9.2,30759,33875,3116
39013,OH,Belmont,,2010,11.3,29717,33517,3800
39013,OH,Belmont,,2011,9.5,29125,32198,3073
39013,OH,Belmont,,2012,8.2,29129,31743,2614
39013,OH,Belmont,,2013,8.2,29315,31938,2623
39013,OH,Belmont,,2014,6.7,29766,31908,2142
39013,OH,Belmont,,2015,6.4,29255,31259,2004
39013,OH,Belmont,,2016,7.5,28798,31137,2339
39013,OH,Belmont,,2017,6.3,28600,30531,1931
39013,OH,Belmont,,2018,5.5,29013,30689,1676
39013,OH,Belmont,,2019,5.7,28500,30214,1714
39013,OH,Belmont,,2020,10.1,25610,28503,2893
39013,OH,Belmont,,2021,6.1,26187,27892,1705
39015,OH,Brown,,2007,6.5,20527,21955,1428
39015,OH,Brown,,2008,7.7,20260,21957,1697
39015,OH,Brown,,2009,12.7,19003,21775,2772
39015,OH,Brown,,2010,13.3,18337,21156,2819
39015,OH,Brown,,2011,11.8,18162,20598,2436
39015,OH,Brown,,2012,10,18141,20153,2012
39015,OH,Brown,,2013,10.1,18034,20069,2035
39015,OH,Brown,,2014,7.4,18266,19736,1470
39015,OH,Brown,,2015,6.3,18323,19554,1231
39015,OH,Brown,,2016,5.8,18429,19569,1140
39015,OH,Brown,,2017,5.7,18488,19608,1120
39015,OH,Brown,,2018,5.4,18496,19543,1047
39015,OH,Brown,,2019,5,18688,19677,989
39015,OH,Brown,,2020,8.3,17633,19237,1604
39015,OH,Brown,,2021,5.3,18331,19366,1035
39017,OH,Butler,,2007,5.1,182161,192022,9861
39017,OH,Butler,,2008,6,181221,192762,11541
39017,OH,Butler,,2009,9.6,170946,189168,18222
39017,OH,Butler,,2010,10.1,171808,191057,19249
39017,OH,Butler,,2011,9.1,171329,188430,17101
39017,OH,Butler,,2012,7.7,172291,186571,14280
39017,OH,Butler,,2013,7.5,172260,186175,13915
39017,OH,Butler,,2014,5.5,176686,187055,10369
39017,OH,Butler,,2015,4.6,179345,188071,8726
39017,OH,Butler,,2016,4.5,181562,190182,8620
39017,OH,Butler,,2017,4.4,184966,193539,8573
39017,OH,Butler,,2018,4.1,186487,194530,8043
39017,OH,Butler,,2019,3.8,189535,197058,7523
39017,OH,Butler,,2020,7.3,179442,193517,14075
39017,OH,Butler,,2021,4.5,186387,195166,8779
39019,OH,Carroll,,2007,6.2,13167,14038,871
39019,OH,Carroll,,2008,7.7,12987,14072,1085
39019,OH,Carroll,,2009,13.7,12166,14101,1935
39019,OH,Carroll,,2010,13,12519,14393,1874
39019,OH,Carroll,,2011,10.2,12638,14069,1431
39019,OH,Carroll,,2012,7.9,12704,13798,1094
39019,OH,Carroll,,2013,7.9,12612,13691,1079
39019,OH,Carroll,,2014,6.1,12773,13608,835
39019,OH,Carroll,,2015,6,12587,13394,807
39019,OH,Carroll,,2016,6.9,12562,13491,929
39019,OH,Carroll,,2017,5.8,12545,13323,778
39019,OH,Carroll,,2018,5.3,12349,13038,689
39019,OH,Carroll,,2019,5,12367,13018,651
39019,OH,Carroll,,2020,8.8,11708,12842,1134
39019,OH,Carroll,,2021,5.7,12006,12726,720
39021,OH,Champaign,,2007,5.9,19942,21198,1256
39021,OH,Champaign,,2008,7.1,19209,20666,1457
39021,OH,Champaign,,2009,11.9,17846,20259,2413
39021,OH,Champaign,,2010,11.6,17694,20007,2313
39021,OH,Champaign,,2011,9.4,17635,19469,1834
39021,OH,Champaign,,2012,7.4,17953,19382,1429
39021,OH,Champaign,,2013,6.9,18623,20001,1378
39021,OH,Champaign,,2014,5.1,18974,19984,1010
39021,OH,Champaign,,2015,4.4,19057,19939,882
39021,OH,Champaign,,2016,4.5,19055,19958,903
39021,OH,Champaign,,2017,4.1,19200,20023,823
39021,OH,Champaign,,2018,3.8,19240,20000,760
39021,OH,Champaign,,2019,3.7,19463,20220,757
39021,OH,Champaign,,2020,7.1,18366,19780,1414
39021,OH,Champaign,,2021,4.4,18560,19413,853
39023,OH,Clark,,2007,6.3,67401,71896,4495
39023,OH,Clark,,2008,6.8,66858,71712,4854
39023,OH,Clark,,2009,10.6,62985,70419,7434
39023,OH,Clark,,2010,11.1,60809,68389,7580
39023,OH,Clark,,2011,9.5,60968,67369,6401
39023,OH,Clark,,2012,7.8,60768,65897,5129
39023,OH,Clark,,2013,7.5,60952,65907,4955
39023,OH,Clark,,2014,5.8,61379,65151,3772
39023,OH,Clark,,2015,5.1,61045,64293,3248
39023,OH,Clark,,2016,5.3,60463,63827,3364
39023,OH,Clark,,2017,4.8,60940,64040,3100
39023,OH,Clark,,2018,4.6,60505,63394,2889
39023,OH,Clark,,2019,4.4,61044,63821,2777
39023,OH,Clark,,2020,8.1,57507,62600,5093
39023,OH,Clark,,2021,5.3,59135,62458,3323
39025,OH,Clermont,,2007,5.1,101426,106862,5436
39025,OH,Clermont,,2008,6,101079,107496,6417
39025,OH,Clermont,,2009,9.8,95187,105511,10324
39025,OH,Clermont,,2010,10.4,94081,105031,10950
39025,OH,Clermont,,2011,9.2,93892,103364,9472
39025,OH,Clermont,,2012,7.4,94544,102152,7608
39025,OH,Clermont,,2013,7.3,94913,102435,7522
39025,OH,Clermont,,2014,5.5,97223,102852,5629
39025,OH,Clermont,,2015,4.6,98315,103007,4692
39025,OH,Clermont,,2016,4.5,99654,104313,4659
39025,OH,Clermont,,2017,4.4,101228,105868,4640
39025,OH,Clermont,,2018,4.1,102163,106523,4360
39025,OH,Clermont,,2019,3.8,104115,108196,4081
39025,OH,Clermont,,2020,6.9,98483,105768,7285
39025,OH,Clermont,,2021,4.3,102346,106976,4630
39027,OH,Clinton,,2007,4.8,23453,24629,1176
39027,OH,Clinton,,2008,6.1,22173,23619,1446
39027,OH,Clinton,,2009,14.7,17922,21022,3100
39027,OH,Clinton,,2010,17.1,15992,19280,3288
39027,OH,Clinton,,2011,13.5,15570,17993,2423
39027,OH,Clinton,,2012,10.7,15434,17289,1855
39027,OH,Clinton,,2013,10.4,15299,17078,1779
39027,OH,Clinton,,2014,7.7,15683,16989,1306
39027,OH,Clinton,,2015,6.3,15693,16744,1051
39027,OH,Clinton,,2016,5.9,16228,17238,1010
39027,OH,Clinton,,2017,5.5,16566,17524,958
39027,OH,Clinton,,2018,5.2,16714,17638,924
39027,OH,Clinton,,2019,4.7,16990,17837,847
39027,OH,Clinton,,2020,8.4,16197,17676,1479
39027,OH,Clinton,,2021,5.5,16971,17953,982
39029,OH,Columbiana,,2007,6.2,50568,53931,3363
39029,OH,Columbiana,,2008,7.3,49489,53408,3919
39029,OH,Columbiana,,2009,13.4,45938,53027,7089
39029,OH,Columbiana,,2010,12.6,46274,52957,6683
39029,OH,Columbiana,,2011,10.1,46470,51706,5236
39029,OH,Columbiana,,2012,8.2,46723,50915,4192
39029,OH,Columbiana,,2013,8.2,46381,50530,4149
39029,OH,Columbiana,,2014,6.5,46989,50234,3245
39029,OH,Columbiana,,2015,5.9,46616,49555,2939
39029,OH,Columbiana,,2016,6.7,45310,48577,3267
39029,OH,Columbiana,,2017,5.9,45100,47950,2850
39029,OH,Columbiana,,2018,5.1,45032,47471,2439
39029,OH,Columbiana,,2019,4.9,45468,47793,2325
39029,OH,Columbiana,,2020,9.4,42612,47034,4422
39029,OH,Columbiana,,2021,5.7,43202,45832,2630
39031,OH,Coshocton,,2007,6.9,16431,17644,1213
39031,OH,Coshocton,,2008,8.7,15827,17333,1506
39031,OH,Coshocton,,2009,13.5,14743,17045,2302
39031,OH,Coshocton,,2010,12.7,15278,17497,2219
39031,OH,Coshocton,,2011,11.4,14832,16748,1916
39031,OH,Coshocton,,2012,10,14584,16212,1628
39031,OH,Coshocton,,2013,9.7,14750,16342,1592
39031,OH,Coshocton,,2014,7.5,14622,15813,1191
39031,OH,Coshocton,,2015,6.4,14883,15907,1024
39031,OH,Coshocton,,2016,7.1,13980,15054,1074
39031,OH,Coshocton,,2017,6.8,13758,14761,1003
39031,OH,Coshocton,,2018,6.2,13587,14478,891
39031,OH,Coshocton,,2019,5.9,13637,14494,857
39031,OH,Coshocton,,2020,8.9,12834,14090,1256
39031,OH,Coshocton,,2021,5.8,12968,13772,804
39033,OH,Crawford,,2007,7,20936,22515,1579
39033,OH,Crawford,,2008,8.8,20179,22121,1942
39033,OH,Crawford,,2009,14.8,18571,21791,3220
39033,OH,Crawford,,2010,12.9,18289,20992,2703
39033,OH,Crawford,,2011,11.5,18351,20738,2387
39033,OH,Crawford,,2012,9,18478,20314,1836
39033,OH,Crawford,,2013,9.1,17901,19702,1801
39033,OH,Crawford,,2014,6.7,18318,19635,1317
39033,OH,Crawford,,2015,5.9,18018,19142,1124
39033,OH,Crawford,,2016,6.1,18079,19246,1167
39033,OH,Crawford,,2017,5.7,17840,18925,1085
39033,OH,Crawford,,2018,5.2,17164,18112,948
39033,OH,Crawford,,2019,4.7,17537,18404,867
39033,OH,Crawford,,2020,9.3,16795,18526,1731
39033,OH,Crawford,,2021,5.8,17016,18066,1050
39035,OH,Cuyahoga,,2007,5.9,609626,648158,38532
39035,OH,Cuyahoga,,2008,6.4,599162,640260,41098
39035,OH,Cuyahoga,,2009,7.9,578982,628705,49723
39035,OH,Cuyahoga,,2010,8.6,586904,641986,55082
39035,OH,Cuyahoga,,2011,7.6,584368,632371,48003
39035,OH,Cuyahoga,,2012,6.8,579379,621812,42433
39035,OH,Cuyahoga,,2013,7,574381,617919,43538
39035,OH,Cuyahoga,,2014,6.3,576999,615565,38566
39035,OH,Cuyahoga,,2015,5.2,577370,609062,31692
39035,OH,Cuyahoga,,2016,5.6,578168,612160,33992
39035,OH,Cuyahoga,,2017,5.8,587517,623383,35866
39035,OH,Cuyahoga,,2018,4.9,592290,622658,30368
39035,OH,Cuyahoga,,2019,4.3,599034,625976,26942
39035,OH,Cuyahoga,,2020,10.7,533399,597091,63692
39035,OH,Cuyahoga,,2021,6.5,556610,595326,38716
39037,OH,Darke,,2007,5.6,26913,28522,1609
39037,OH,Darke,,2008,6.5,26335,28175,1840
39037,OH,Darke,,2009,11.4,24676,27836,3160
39037,OH,Darke,,2010,11.3,24037,27089,3052
39037,OH,Darke,,2011,9.2,24123,26577,2454
39037,OH,Darke,,2012,7.2,24654,26574,1920
39037,OH,Darke,,2013,7,24539,26381,1842
39037,OH,Darke,,2014,5.3,24811,26207,1396
39037,OH,Darke,,2015,4.3,25168,26302,1134
39037,OH,Darke,,2016,4.1,25380,26477,1097
39037,OH,Darke,,2017,4.2,25333,26440,1107
39037,OH,Darke,,2018,3.9,24977,25985,1008
39037,OH,Darke,,2019,3.7,25035,25997,962
39037,OH,Darke,,2020,6.7,23923,25651,1728
39037,OH,Darke,,2021,3.9,24679,25684,1005
39039,OH,Defiance,,2007,5.6,19765,20948,1183
39039,OH,Defiance,,2008,7.6,19254,20836,1582
39039,OH,Defiance,,2009,14.1,17490,20361,2871
39039,OH,Defiance,,2010,12.2,17560,19999,2439
39039,OH,Defiance,,2011,9.6,17343,19190,1847
39039,OH,Defiance,,2012,7.7,17542,18996,1454
39039,OH,Defiance,,2013,7.5,17510,18926,1416
39039,OH,Defiance,,2014,5.5,17961,19004,1043
39039,OH,Defiance,,2015,5,17806,18736,930
39039,OH,Defiance,,2016,5,17536,18453,917
39039,OH,Defiance,,2017,4.8,17608,18505,897
39039,OH,Defiance,,2018,4.4,17485,18290,805
39039,OH,Defiance,,2019,4.3,17413,18193,780
39039,OH,Defiance,,2020,8.2,16274,17726,1452
39039,OH,Defiance,,2021,4.7,16739,17564,825
39041,OH,Delaware,,2007,4,87466,91113,3647
39041,OH,Delaware,,2008,4.7,88582,92961,4379
39041,OH,Delaware,,2009,7,85323,91789,6466
39041,OH,Delaware,,2010,7.3,87512,94360,6848
39041,OH,Delaware,,2011,6.2,89026,94934,5908
39041,OH,Delaware,,2012,5.2,91025,95998,4973
39041,OH,Delaware,,2013,5.3,92813,98027,5214
39041,OH,Delaware,,2014,4.1,96531,100665,4134
39041,OH,Delaware,,2015,3.6,99005,102670,3665
39041,OH,Delaware,,2016,3.6,101438,105264,3826
39041,OH,Delaware,,2017,3.5,103922,107744,3822
39041,OH,Delaware,,2018,3.4,105848,109553,3705
39041,OH,Delaware,,2019,3.2,109437,113034,3597
39041,OH,Delaware,,2020,5.4,106072,112091,6019
39041,OH,Delaware,,2021,3.6,110501,114622,4121
39043,OH,Erie,,2007,6.1,40386,42991,2605
39043,OH,Erie,,2008,7.4,39867,43054,3187
39043,OH,Erie,,2009,11.8,37526,42526,5000
39043,OH,Erie,,2010,11.3,35677,40234,4557
39043,OH,Erie,,2011,9.5,35929,39703,3774
39043,OH,Erie,,2012,8,35554,38645,3091
39043,OH,Erie,,2013,8.1,35408,38526,3118
39043,OH,Erie,,2014,6.4,35106,37512,2406
39043,OH,Erie,,2015,5.6,35388,37487,2099
39043,OH,Erie,,2016,5.5,35494,37574,2080
39043,OH,Erie,,2017,6.1,36009,38352,2343
39043,OH,Erie,,2018,5.6,35970,38090,2120
39043,OH,Erie,,2019,5,35782,37654,1872
39043,OH,Erie,,2020,10.4,32666,36454,3788
39043,OH,Erie,,2021,6.3,34918,37279,2361
39045,OH,Fairfield,,2007,5,72248,76071,3823
39045,OH,Fairfield,,2008,5.8,71781,76204,4423
39045,OH,Fairfield,,2009,8.7,68341,74866,6525
39045,OH,Fairfield,,2010,9.3,67510,74397,6887
39045,OH,Fairfield,,2011,8.1,67835,73783,5948
39045,OH,Fairfield,,2012,6.6,68486,73353,4867
39045,OH,Fairfield,,2013,6.6,69090,73998,4908
39045,OH,Fairfield,,2014,5.2,70977,74858,3881
39045,OH,Fairfield,,2015,4.4,71819,75125,3306
39045,OH,Fairfield,,2016,4.3,72940,76253,3313
39045,OH,Fairfield,,2017,4.3,74228,77538,3310
39045,OH,Fairfield,,2018,4.1,74393,77539,3146
39045,OH,Fairfield,,2019,3.8,76176,79158,2982
39045,OH,Fairfield,,2020,6.6,73344,78558,5214
39045,OH,Fairfield,,2021,4.3,76349,79813,3464
39047,OH,Fayette,,2007,4.8,16199,17020,821
39047,OH,Fayette,,2008,5.8,16110,17101,991
39047,OH,Fayette,,2009,11.2,14871,16746,1875
39047,OH,Fayette,,2010,13.1,12966,14926,1960
39047,OH,Fayette,,2011,10.5,12823,14326,1503
39047,OH,Fayette,,2012,8.3,12950,14118,1168
39047,OH,Fayette,,2013,7.6,13270,14369,1099
39047,OH,Fayette,,2014,6,13324,14173,849
39047,OH,Fayette,,2015,5,13367,14069,702
39047,OH,Fayette,,2016,4.5,13896,14545,649
39047,OH,Fayette,,2017,4.2,13854,14465,611
39047,OH,Fayette,,2018,4.1,13581,14164,583
39047,OH,Fayette,,2019,3.9,13441,13989,548
39047,OH,Fayette,,2020,7.4,12909,13938,1029
39047,OH,Fayette,,2021,4.8,13091,13748,657
39049,OH,Franklin,,2007,4.7,597043,626677,29634
39049,OH,Franklin,,2008,5.6,595188,630495,35307
39049,OH,Franklin,,2009,8.5,571242,624088,52846
39049,OH,Franklin,,2010,8.9,571892,627864,55972
39049,OH,Franklin,,2011,7.8,577243,625753,48510
39049,OH,Franklin,,2012,6.4,589946,630411,40465
39049,OH,Franklin,,2013,6.4,597401,638429,41028
39049,OH,Franklin,,2014,4.9,617574,649140,31566
39049,OH,Franklin,,2015,4.1,630764,657983,27219
39049,OH,Franklin,,2016,4.1,641672,669446,27774
39049,OH,Franklin,,2017,4.1,658718,686535,27817
39049,OH,Franklin,,2018,3.8,666488,692900,26412
39049,OH,Franklin,,2019,3.6,678059,703159,25100
39049,OH,Franklin,,2020,7.5,647092,699903,52811
39049,OH,Franklin,,2021,5,673958,709058,35100
39051,OH,Fulton,,2007,6.3,21981,23465,1484
39051,OH,Fulton,,2008,8.3,21484,23419,1935
39051,OH,Fulton,,2009,13.9,19229,22338,3109
39051,OH,Fulton,,2010,11.9,20430,23178,2748
39051,OH,Fulton,,2011,9.6,20402,22571,2169
39051,OH,Fulton,,2012,7.7,20698,22431,1733
39051,OH,Fulton,,2013,7.9,20659,22435,1776
39051,OH,Fulton,,2014,5.9,21101,22423,1322
39051,OH,Fulton,,2015,4.9,21402,22512,1110
39051,OH,Fulton,,2016,4.7,21700,22766,1066
39051,OH,Fulton,,2017,4.9,21485,22592,1107
39051,OH,Fulton,,2018,4.4,21450,22433,983
39051,OH,Fulton,,2019,4.2,21686,22629,943
39051,OH,Fulton,,2020,7.9,20025,21739,1714
39051,OH,Fulton,,2021,4.7,20612,21631,1019
39053,OH,Gallia,,2007,6.2,13705,14614,909
39053,OH,Gallia,,2008,6.6,13313,14261,948
39053,OH,Gallia,,2009,9.5,12796,14141,1345
39053,OH,Gallia,,2010,11.8,11996,13606,1610
39053,OH,Gallia,,2011,11.2,11542,12996,1454
39053,OH,Gallia,,2012,9.7,11431,12652,1221
39053,OH,Gallia,,2013,9.7,11296,12504,1208
39053,OH,Gallia,,2014,7.7,11481,12439,958
39053,OH,Gallia,,2015,6.6,11444,12247,803
39053,OH,Gallia,,2016,6.9,11340,12176,836
39053,OH,Gallia,,2017,6.6,11535,12350,815
39053,OH,Gallia,,2018,6,11608,12352,744
39053,OH,Gallia,,2019,5.4,11653,12324,671
39053,OH,Gallia,,2020,8,11223,12199,976
39053,OH,Gallia,,2021,5.6,11427,12111,684
39055,OH,Geauga,,2007,4.7,48761,51191,2430
39055,OH,Geauga,,2008,5.2,48233,50855,2622
39055,OH,Geauga,,2009,6.3,49041,52312,3271
39055,OH,Geauga,,2010,6.9,46323,49770,3447
39055,OH,Geauga,,2011,6,46384,49369,2985
39055,OH,Geauga,,2012,5.4,46410,49043,2633
39055,OH,Geauga,,2013,5.8,46113,48934,2821
39055,OH,Geauga,,2014,5,46545,49017,2472
39055,OH,Geauga,,2015,4.2,46652,48701,2049
39055,OH,Geauga,,2016,4.5,46852,49049,2197
39055,OH,Geauga,,2017,4.7,47430,49774,2344
39055,OH,Geauga,,2018,4,47866,49880,2014
39055,OH,Geauga,,2019,3.6,48538,50343,1805
39055,OH,Geauga,,2020,6.8,43470,46661,3191
39055,OH,Geauga,,2021,4.1,45445,47402,1957
39057,OH,Greene,,2007,5.3,76040,80265,4225
39057,OH,Greene,,2008,6.3,76600,81732,5132
39057,OH,Greene,,2009,9.7,72265,80069,7804
39057,OH,Greene,,2010,9.6,74344,82209,7865
39057,OH,Greene,,2011,8.2,74846,81574,6728
39057,OH,Greene,,2012,6.9,75114,80663,5549
39057,OH,Greene,,2013,7,73833,79358,5525
39057,OH,Greene,,2014,5.2,75748,79935,4187
39057,OH,Greene,,2015,4.4,77086,80645,3559
39057,OH,Greene,,2016,4.4,77853,81414,3561
39057,OH,Greene,,2017,4.3,79418,82947,3529
39057,OH,Greene,,2018,4,79769,83120,3351
39057,OH,Greene,,2019,3.8,81069,84256,3187
39057,OH,Greene,,2020,6.5,77103,82426,5323
39057,OH,Greene,,2021,4.3,78872,82422,3550
39059,OH,Guernsey,,2007,6.4,18747,20037,1290
39059,OH,Guernsey,,2008,8.7,18048,19772,1724
39059,OH,Guernsey,,2009,12.2,17091,19456,2365
39059,OH,Guernsey,,2010,12.8,16472,18884,2412
39059,OH,Guernsey,,2011,10.8,16432,18421,1989
39059,OH,Guernsey,,2012,9,16602,18235,1633
39059,OH,Guernsey,,2013,8.6,16930,18533,1603
39059,OH,Guernsey,,2014,6.7,17854,19140,1286
39059,OH,Guernsey,,2015,6.3,18061,19270,1209
39059,OH,Guernsey,,2016,7.1,17613,18968,1355
39059,OH,Guernsey,,2017,6,17907,19052,1145
39059,OH,Guernsey,,2018,5.5,17810,18846,1036
39059,OH,Guernsey,,2019,5.5,17731,18763,1032
39059,OH,Guernsey,,2020,8.7,16664,18252,1588
39059,OH,Guernsey,,2021,5.6,16906,17904,998
39061,OH,Hamilton,,2007,5.1,418428,440844,22416
39061,OH,Hamilton,,2008,5.7,417423,442854,25431
39061,OH,Hamilton,,2009,9,392769,431844,39075
39061,OH,Hamilton,,2010,9.9,373434,414321,40887
39061,OH,Hamilton,,2011,8.8,370436,406356,35920
39061,OH,Hamilton,,2012,7.4,372577,402186,29609
39061,OH,Hamilton,,2013,7.3,372904,402152,29248
39061,OH,Hamilton,,2014,5.5,380542,402530,21988
39061,OH,Hamilton,,2015,4.5,384465,402777,18312
39061,OH,Hamilton,,2016,4.5,388426,406542,18116
39061,OH,Hamilton,,2017,4.4,394770,412841,18071
39061,OH,Hamilton,,2018,4.1,397694,414702,17008
39061,OH,Hamilton,,2019,3.8,403800,419902,16102
39061,OH,Hamilton,,2020,7.9,380073,412480,32407
39061,OH,Hamilton,,2021,4.9,394977,415153,20176
39063,OH,Hancock,,2007,4.5,40013,41906,1893
39063,OH,Hancock,,2008,6,38764,41226,2462
39063,OH,Hancock,,2009,10.4,35746,39902,4156
39063,OH,Hancock,,2010,9.1,36822,40514,3692
39063,OH,Hancock,,2011,7.8,36861,39966,3105
39063,OH,Hancock,,2012,6.4,37264,39807,2543
39063,OH,Hancock,,2013,6.2,37680,40172,2492
39063,OH,Hancock,,2014,4.4,38747,40551,1804
39063,OH,Hancock,,2015,3.7,39373,40887,1514
39063,OH,Hancock,,2016,3.7,40080,41625,1545
39063,OH,Hancock,,2017,3.6,40322,41831,1509
39063,OH,Hancock,,2018,3.4,40143,41558,1415
39063,OH,Hancock,,2019,3.2,40895,42245,1350
39063,OH,Hancock,,2020,6.8,38600,41424,2824
39063,OH,Hancock,,2021,4.1,39311,41002,1691
39065,OH,Hardin,,2007,6,14970,15924,954
39065,OH,Hardin,,2008,7.3,14063,15169,1106
39065,OH,Hardin,,2009,12.2,13214,15057,1843
39065,OH,Hardin,,2010,11.2,13762,15501,1739
39065,OH,Hardin,,2011,9.5,13626,15059,1433
39065,OH,Hardin,,2012,7.5,13785,14895,1110
39065,OH,Hardin,,2013,7.7,13776,14924,1148
39065,OH,Hardin,,2014,5.7,14282,15147,865
39065,OH,Hardin,,2015,4.9,13835,14544,709
39065,OH,Hardin,,2016,5,13709,14434,725
39065,OH,Hardin,,2017,4.9,13717,14429,712
39065,OH,Hardin,,2018,4.4,13472,14086,614
39065,OH,Hardin,,2019,4.2,13427,14019,592
39065,OH,Hardin,,2020,8.1,12789,13917,1128
39065,OH,Hardin,,2021,5.2,12972,13677,705
39067,OH,Harrison,,2007,6.2,7006,7472,466
39067,OH,Harrison,,2008,7.3,6867,7407,540
39067,OH,Harrison,,2009,11.6,6433,7281,848
39067,OH,Harrison,,2010,12.5,6344,7251,907
39067,OH,Harrison,,2011,10.6,6261,7005,744
39067,OH,Harrison,,2012,8.5,6381,6977,596
39067,OH,Harrison,,2013,7.9,6709,7285,576
39067,OH,Harrison,,2014,6,6928,7374,446
39067,OH,Harrison,,2015,6.4,6750,7208,458
39067,OH,Harrison,,2016,7.7,6460,6998,538
39067,OH,Harrison,,2017,6,6745,7173,428
39067,OH,Harrison,,2018,5.2,6599,6962,363
39067,OH,Harrison,,2019,5.3,6515,6879,364
39067,OH,Harrison,,2020,9.3,6061,6681,620
39067,OH,Harrison,,2021,6.2,6096,6502,406
39069,OH,Henry,,2007,6.3,15036,16049,1013
39069,OH,Henry,,2008,8.1,14564,15841,1277
39069,OH,Henry,,2009,13.5,13561,15683,2122
39069,OH,Henry,,2010,13.1,12740,14656,1916
39069,OH,Henry,,2011,10.7,12821,14356,1535
39069,OH,Henry,,2012,8.7,12890,14125,1235
39069,OH,Henry,,2013,8.8,12781,14016,1235
39069,OH,Henry,,2014,6.5,12895,13786,891
39069,OH,Henry,,2015,5.7,12826,13595,769
39069,OH,Henry,,2016,5.4,12924,13660,736
39069,OH,Henry,,2017,5.2,12894,13597,703
39069,OH,Henry,,2018,4.9,12708,13365,657
39069,OH,Henry,,2019,4.7,12662,13282,620
39069,OH,Henry,,2020,8.1,11945,12998,1053
39069,OH,Henry,,2021,5.2,12088,12745,657
39071,OH,Highland,,2007,6,20432,21726,1294
39071,OH,Highland,,2008,7.5,19275,20841,1566
39071,OH,Highland,,2009,15.5,17339,20521,3182
39071,OH,Highland,,2010,17.3,15888,19215,3327
39071,OH,Highland,,2011,13.4,15633,18056,2423
39071,OH,Highland,,2012,10.4,15781,17613,1832
39071,OH,Highland,,2013,10.5,15667,17496,1829
39071,OH,Highland,,2014,7.8,16023,17370,1347
39071,OH,Highland,,2015,6.4,15902,16995,1093
39071,OH,Highland,,2016,6.4,15913,16998,1085
39071,OH,Highland,,2017,5.9,16210,17233,1023
39071,OH,Highland,,2018,5.5,16276,17226,950
39071,OH,Highland,,2019,5.2,16316,17217,901
39071,OH,Highland,,2020,8.7,15886,17396,1510
39071,OH,Highland,,2021,5.6,16511,17499,988
39073,OH,Hocking,,2007,6.4,13417,14336,919
39073,OH,Hocking,,2008,7.7,13249,14359,1110
39073,OH,Hocking,,2009,11.3,12635,14249,1614
39073,OH,Hocking,,2010,11.7,12414,14062,1648
39073,OH,Hocking,,2011,9.9,12397,13765,1368
39073,OH,Hocking,,2012,8.3,12434,13555,1121
39073,OH,Hocking,,2013,8.1,12124,13191,1067
39073,OH,Hocking,,2014,6.5,12359,13213,854
39073,OH,Hocking,,2015,5.7,12319,13057,738
39073,OH,Hocking,,2016,5.6,12329,13063,734
39073,OH,Hocking,,2017,5.4,12436,13148,712
39073,OH,Hocking,,2018,5.1,12363,13025,662
39073,OH,Hocking,,2019,4.7,12463,13073,610
39073,OH,Hocking,,2020,7.5,11760,12713,953
39073,OH,Hocking,,2021,4.8,12255,12874,619
39075,OH,Holmes,,2007,4.1,19078,19884,806
39075,OH,Holmes,,2008,5,18619,19595,976
39075,OH,Holmes,,2009,7.9,17644,19158,1514
39075,OH,Holmes,,2010,7.7,17841,19325,1484
39075,OH,Holmes,,2011,6.3,18306,19537,1231
39075,OH,Holmes,,2012,5.1,18741,19755,1014
39075,OH,Holmes,,2013,5.2,18991,20034,1043
39075,OH,Holmes,,2014,4,19151,19953,802
39075,OH,Holmes,,2015,3.5,19975,20691,716
39075,OH,Holmes,,2016,3.6,20309,21073,764
39075,OH,Holmes,,2017,3.5,20175,20914,739
39075,OH,Holmes,,2018,3.3,20080,20756,676
39075,OH,Holmes,,2019,3,20368,21005,637
39075,OH,Holmes,,2020,3.9,20064,20880,816
39075,OH,Holmes,,2021,2.8,20808,21400,592
39077,OH,Huron,,2007,8.1,27523,29961,2438
39077,OH,Huron,,2008,9.9,26395,29300,2905
39077,OH,Huron,,2009,15.7,24199,28714,4515
39077,OH,Huron,,2010,13.2,26322,30332,4010
39077,OH,Huron,,2011,11.4,26259,29621,3362
39077,OH,Huron,,2012,9.9,26096,28959,2863
39077,OH,Huron,,2013,10.2,25718,28640,2922
39077,OH,Huron,,2014,8,25723,27957,2234
39077,OH,Huron,,2015,6.7,25869,27713,1844
39077,OH,Huron,,2016,6.6,26380,28231,1851
39077,OH,Huron,,2017,6.4,26499,28310,1811
39077,OH,Huron,,2018,5.9,26449,28097,1648
39077,OH,Huron,,2019,5.8,26582,28218,1636
39077,OH,Huron,,2020,9.5,24892,27495,2603
39077,OH,Huron,,2021,5.8,26108,27725,1617
39079,OH,Jackson,,2007,8,14763,16042,1279
39079,OH,Jackson,,2008,8.6,14082,15407,1325
39079,OH,Jackson,,2009,11.3,13655,15397,1742
39079,OH,Jackson,,2010,12.5,12529,14324,1795
39079,OH,Jackson,,2011,11.8,12280,13927,1647
39079,OH,Jackson,,2012,10.3,12308,13724,1416
39079,OH,Jackson,,2013,10.5,12168,13594,1426
39079,OH,Jackson,,2014,8.8,12090,13257,1167
39079,OH,Jackson,,2015,7.6,12100,13095,995
39079,OH,Jackson,,2016,7.9,11837,12853,1016
39079,OH,Jackson,,2017,7.1,12041,12963,922
39079,OH,Jackson,,2018,6.5,12017,12853,836
39079,OH,Jackson,,2019,6.2,12056,12858,802
39079,OH,Jackson,,2020,8.7,11975,13123,1148
39079,OH,Jackson,,2021,6.1,11894,12672,778
39081,OH,Jefferson,,2007,6.4,30184,32246,2062
39081,OH,Jefferson,,2008,7.1,30788,33155,2367
39081,OH,Jefferson,,2009,12.3,28730,32763,4033
39081,OH,Jefferson,,2010,14.5,28551,33385,4834
39081,OH,Jefferson,,2011,12,28081,31907,3826
39081,OH,Jefferson,,2012,10.8,27881,31271,3390
39081,OH,Jefferson,,2013,10.9,27255,30577,3322
39081,OH,Jefferson,,2014,8.1,27438,29866,2428
39081,OH,Jefferson,,2015,7.5,27280,29492,2212
39081,OH,Jefferson,,2016,8.4,26583,29024,2441
39081,OH,Jefferson,,2017,7.3,25922,27974,2052
39081,OH,Jefferson,,2018,6.3,26070,27813,1743
39081,OH,Jefferson,,2019,5.9,26401,28050,1649
39081,OH,Jefferson,,2020,10.1,24650,27420,2770
39081,OH,Jefferson,,2021,6.5,25475,27241,1766
39083,OH,Knox,,2007,5.4,29662,31359,1697
39083,OH,Knox,,2008,6.5,28485,30469,1984
39083,OH,Knox,,2009,9.8,27003,29942,2939
39083,OH,Knox,,2010,9.7,27958,30962,3004
39083,OH,Knox,,2011,8.7,27767,30418,2651
39083,OH,Knox,,2012,6.9,28064,30156,2092
39083,OH,Knox,,2013,6.9,28280,30368,2088
39083,OH,Knox,,2014,5.3,29553,31205,1652
39083,OH,Knox,,2015,4.7,29862,31331,1469
39083,OH,Knox,,2016,4.7,29894,31354,1460
39083,OH,Knox,,2017,4.5,30077,31492,1415
39083,OH,Knox,,2018,4.3,30172,31538,1366
39083,OH,Knox,,2019,4,30562,31836,1274
39083,OH,Knox,,2020,6.2,28987,30907,1920
39083,OH,Knox,,2021,4,29846,31102,1256
39085,OH,Lake,,2007,5.1,125912,132620,6708
39085,OH,Lake,,2008,5.5,125252,132518,7266
39085,OH,Lake,,2009,7.3,123241,132898,9657
39085,OH,Lake,,2010,8,118120,128330,10210
39085,OH,Lake,,2011,6.8,118337,127021,8684
39085,OH,Lake,,2012,6,117536,125033,7497
39085,OH,Lake,,2013,6.3,116992,124869,7877
39085,OH,Lake,,2014,5.5,117488,124386,6898
39085,OH,Lake,,2015,4.5,117946,123551,5605
39085,OH,Lake,,2016,4.9,118449,124566,6117
39085,OH,Lake,,2017,5.1,121195,127665,6470
39085,OH,Lake,,2018,4.4,122751,128368,5617
39085,OH,Lake,,2019,3.8,124827,129768,4941
39085,OH,Lake,,2020,8.5,111570,121960,10390
39085,OH,Lake,,2021,5.1,116398,122641,6243
39087,OH,Lawrence,,2007,5.3,28253,29820,1567
39087,OH,Lawrence,,2008,5.5,28018,29659,1641
39087,OH,Lawrence,,2009,8.3,26705,29114,2409
39087,OH,Lawrence,,2010,10.3,24884,27745,2861
39087,OH,Lawrence,,2011,9.5,24452,27017,2565
39087,OH,Lawrence,,2012,8.5,24266,26514,2248
39087,OH,Lawrence,,2013,8.8,23820,26106,2286
39087,OH,Lawrence,,2014,6.7,24183,25909,1726
39087,OH,Lawrence,,2015,5.9,23503,24984,1481
39087,OH,Lawrence,,2016,6.6,23223,24851,1628
39087,OH,Lawrence,,2017,5.9,22735,24167,1432
39087,OH,Lawrence,,2018,5.6,22584,23916,1332
39087,OH,Lawrence,,2019,5.2,22794,24045,1251
39087,OH,Lawrence,,2020,8.5,21626,23638,2012
39087,OH,Lawrence,,2021,5.1,22039,23226,1187
39089,OH,Licking,,2007,5.3,79775,84252,4477
39089,OH,Licking,,2008,6.3,79126,84436,5310
39089,OH,Licking,,2009,9.6,74915,82837,7922
39089,OH,Licking,,2010,9.6,79229,87674,8445
39089,OH,Licking,,2011,8.4,79337,86585,7248
39089,OH,Licking,,2012,6.8,80235,86045,5810
39089,OH,Licking,,2013,6.9,80469,86432,5963
39089,OH,Licking,,2014,5.2,82315,86874,4559
39089,OH,Licking,,2015,4.5,83310,87222,3912
39089,OH,Licking,,2016,4.4,84685,88594,3909
39089,OH,Licking,,2017,4.2,85575,89346,3771
39089,OH,Licking,,2018,4,86320,89876,3556
39089,OH,Licking,,2019,3.8,87930,91371,3441
39089,OH,Licking,,2020,6.6,84147,90081,5934
39089,OH,Licking,,2021,4.1,87636,91375,3739
39091,OH,Logan,,2007,5,24240,25512,1272
39091,OH,Logan,,2008,6.1,23965,25526,1561
39091,OH,Logan,,2009,12,21645,24588,2943
39091,OH,Logan,,2010,11.8,20614,23380,2766
39091,OH,Logan,,2011,9.7,20566,22784,2218
39091,OH,Logan,,2012,7.1,20992,22606,1614
39091,OH,Logan,,2013,6.8,21459,23031,1572
39091,OH,Logan,,2014,5,21983,23146,1163
39091,OH,Logan,,2015,4.3,22186,23172,986
39091,OH,Logan,,2016,4.2,22426,23413,987
39091,OH,Logan,,2017,4.1,22691,23653,962
39091,OH,Logan,,2018,3.7,22382,23243,861
39091,OH,Logan,,2019,3.7,22186,23033,847
39091,OH,Logan,,2020,8.2,20836,22699,1863
39091,OH,Logan,,2021,4.1,21532,22462,930
39093,OH,Lorain,,2007,6,148800,158242,9442
39093,OH,Lorain,,2008,6.6,148648,159121,10473
39093,OH,Lorain,,2009,8.7,145201,158992,13791
39093,OH,Lorain,,2010,9.2,139440,153525,14085
39093,OH,Lorain,,2011,7.8,139980,151886,11906
39093,OH,Lorain,,2012,7.1,139170,149803,10633
39093,OH,Lorain,,2013,7.4,138932,150065,11133
39093,OH,Lorain,,2014,6.5,140520,150215,9695
39093,OH,Lorain,,2015,5.6,141498,149895,8397
39093,OH,Lorain,,2016,6,143118,152264,9146
39093,OH,Lorain,,2017,6.1,146182,155628,9446
39093,OH,Lorain,,2018,5,148445,156304,7859
39093,OH,Lorain,,2019,4.4,151370,158344,6974
39093,OH,Lorain,,2020,9.9,136706,151801,15095
39093,OH,Lorain,,2021,5.8,142587,151288,8701
39095,OH,Lucas,,2007,6.8,210673,226009,15336
39095,OH,Lucas,,2008,8.4,205605,224344,18739
39095,OH,Lucas,,2009,12.4,194011,221507,27496
39095,OH,Lucas,,2010,11.6,192562,217735,25173
39095,OH,Lucas,,2011,9.9,191763,212751,20988
39095,OH,Lucas,,2012,8.3,192955,210469,17514
39095,OH,Lucas,,2013,8.7,192357,210574,18217
39095,OH,Lucas,,2014,6.4,195995,209419,13424
39095,OH,Lucas,,2015,5.4,198218,209455,11237
39095,OH,Lucas,,2016,5.2,200233,211249,11016
39095,OH,Lucas,,2017,5.9,199138,211558,12420
39095,OH,Lucas,,2018,5.2,199681,210684,11003
39095,OH,Lucas,,2019,4.7,201934,211863,9929
39095,OH,Lucas,,2020,10.3,186564,208080,21516
39095,OH,Lucas,,2021,6.2,192214,204976,12762
39097,OH,Madison,,2007,5.3,19180,20246,1066
39097,OH,Madison,,2008,6.3,19099,20383,1284
39097,OH,Madison,,2009,9.5,18287,20205,1918
39097,OH,Madison,,2010,9.1,18823,20699,1876
39097,OH,Madison,,2011,7.9,18673,20276,1603
39097,OH,Madison,,2012,6.4,18812,20094,1282
39097,OH,Madison,,2013,6.2,18959,20222,1263
39097,OH,Madison,,2014,4.7,19540,20512,972
39097,OH,Madison,,2015,4.1,19725,20563,838
39097,OH,Madison,,2016,4,19608,20417,809
39097,OH,Madison,,2017,3.9,19914,20717,803
39097,OH,Madison,,2018,3.8,19903,20688,785
39097,OH,Madison,,2019,3.5,20290,21022,732
39097,OH,Madison,,2020,6,19253,20485,1232
39097,OH,Madison,,2021,3.8,20014,20815,801
39099,OH,Mahoning,,2007,6.3,110581,117965,7384
39099,OH,Mahoning,,2008,7.2,108411,116879,8468
39099,OH,Mahoning,,2009,12.5,100893,115362,14469
39099,OH,Mahoning,,2010,11.7,101734,115263,13529
39099,OH,Mahoning,,2011,9.8,101590,112624,11034
39099,OH,Mahoning,,2012,8.3,101578,110756,9178
39099,OH,Mahoning,,2013,8.5,100150,109469,9319
39099,OH,Mahoning,,2014,6.7,100993,108255,7262
39099,OH,Mahoning,,2015,6.2,100697,107305,6608
39099,OH,Mahoning,,2016,6.4,99542,106380,6838
39099,OH,Mahoning,,2017,6.9,98488,105742,7254
39099,OH,Mahoning,,2018,5.9,98585,104748,6163
39099,OH,Mahoning,,2019,5.8,98092,104107,6015
39099,OH,Mahoning,,2020,10.2,89923,100152,10229
39099,OH,Mahoning,,2021,6.3,92395,98659,6264
39101,OH,Marion,,2007,5.5,31388,33215,1827
39101,OH,Marion,,2008,7.1,30518,32851,2333
39101,OH,Marion,,2009,11.5,27926,31540,3614
39101,OH,Marion,,2010,11,26970,30301,3331
39101,OH,Marion,,2011,9.9,26591,29501,2910
39101,OH,Marion,,2012,7.9,26611,28896,2285
39101,OH,Marion,,2013,7.9,25897,28112,2215
39101,OH,Marion,,2014,6,26263,27937,1674
39101,OH,Marion,,2015,5.2,26425,27866,1441
39101,OH,Marion,,2016,5.1,26425,27849,1424
39101,OH,Marion,,2017,5,26811,28232,1421
39101,OH,Marion,,2018,4.4,27353,28614,1261
39101,OH,Marion,,2019,4.1,27577,28748,1171
39101,OH,Marion,,2020,7.6,26098,28244,2146
39101,OH,Marion,,2021,4.7,26659,27974,1315
39103,OH,Medina,,2007,5,90417,95218,4801
39103,OH,Medina,,2008,5.5,90426,95654,5228
39103,OH,Medina,,2009,7,89394,96145,6751
39103,OH,Medina,,2010,7.5,88416,95541,7125
39103,OH,Medina,,2011,6.4,89095,95163,6068
39103,OH,Medina,,2012,5.5,88817,94011,5194
39103,OH,Medina,,2013,5.8,88883,94391,5508
39103,OH,Medina,,2014,5.1,90047,94842,4795
39103,OH,Medina,,2015,4.2,90591,94525,3934
39103,OH,Medina,,2016,4.4,91657,95889,4232
39103,OH,Medina,,2017,4.6,93717,98287,4570
39103,OH,Medina,,2018,4,95071,98994,3923
39103,OH,Medina,,2019,3.5,97148,100692,3544
39103,OH,Medina,,2020,7.7,87686,94989,7303
39103,OH,Medina,,2021,4.3,91488,95616,4128
39105,OH,Meigs,,2007,9,8506,9343,837
39105,OH,Meigs,,2008,10.2,8291,9230,939
39105,OH,Meigs,,2009,14.9,7974,9369,1395
39105,OH,Meigs,,2010,14.7,8590,10065,1475
39105,OH,Meigs,,2011,13.1,8502,9785,1283
39105,OH,Meigs,,2012,11.5,8409,9505,1096
39105,OH,Meigs,,2013,11.8,8293,9407,1114
39105,OH,Meigs,,2014,9,8379,9208,829
39105,OH,Meigs,,2015,8.3,8368,9127,759
39105,OH,Meigs,,2016,8.6,8218,8990,772
39105,OH,Meigs,,2017,8.1,8283,9016,733
39105,OH,Meigs,,2018,7.2,8361,9010,649
39105,OH,Meigs,,2019,6.9,8559,9197,638
39105,OH,Meigs,,2020,9.7,8095,8968,873
39105,OH,Meigs,,2021,6.6,8164,8744,580
39107,OH,Mercer,,2007,3.9,23818,24772,954
39107,OH,Mercer,,2008,5,23686,24930,1244
39107,OH,Mercer,,2009,8.9,22119,24293,2174
39107,OH,Mercer,,2010,8.5,20460,22358,1898
39107,OH,Mercer,,2011,6.8,20628,22122,1494
39107,OH,Mercer,,2012,5.1,21013,22144,1131
39107,OH,Mercer,,2013,5.1,21238,22380,1142
39107,OH,Mercer,,2014,3.8,21852,22717,865
39107,OH,Mercer,,2015,3.3,22312,23077,765
39107,OH,Mercer,,2016,3.3,22743,23516,773
39107,OH,Mercer,,2017,3.1,22911,23634,723
39107,OH,Mercer,,2018,2.7,23094,23745,651
39107,OH,Mercer,,2019,2.6,23004,23625,621
39107,OH,Mercer,,2020,5.4,22124,23380,1256
39107,OH,Mercer,,2021,3.1,22181,22895,714
39109,OH,Miami,,2007,5.4,52655,55687,3032
39109,OH,Miami,,2008,6.5,51557,55140,3583
39109,OH,Miami,,2009,11.8,48529,55030,6501
39109,OH,Miami,,2010,11.1,48423,54478,6055
39109,OH,Miami,,2011,9.1,48455,53318,4863
39109,OH,Miami,,2012,7.3,48540,52342,3802
39109,OH,Miami,,2013,7.2,48099,51827,3728
39109,OH,Miami,,2014,5.4,49386,52201,2815
39109,OH,Miami,,2015,4.4,50231,52568,2337
39109,OH,Miami,,2016,4.4,50887,53220,2333
39109,OH,Miami,,2017,4.2,51518,53796,2278
39109,OH,Miami,,2018,3.9,51892,53997,2105
39109,OH,Miami,,2019,3.7,52819,54860,2041
39109,OH,Miami,,2020,7,50121,53894,3773
39109,OH,Miami,,2021,4.3,51238,53518,2280
39111,OH,Monroe,,2007,8.2,5153,5613,460
39111,OH,Monroe,,2008,8.7,5264,5764,500
39111,OH,Monroe,,2009,12.7,4937,5656,719
39111,OH,Monroe,,2010,12.3,5865,6686,821
39111,OH,Monroe,,2011,9.8,5932,6579,647
39111,OH,Monroe,,2012,8.4,5951,6495,544
39111,OH,Monroe,,2013,10,5833,6480,647
39111,OH,Monroe,,2014,11,5242,5891,649
39111,OH,Monroe,,2015,10,5004,5563,559
39111,OH,Monroe,,2016,11.2,4745,5344,599
39111,OH,Monroe,,2017,8.4,4752,5187,435
39111,OH,Monroe,,2018,7.7,4811,5214,403
39111,OH,Monroe,,2019,8.3,4942,5391,449
39111,OH,Monroe,,2020,10.7,5051,5656,605
39111,OH,Monroe,,2021,7.3,4923,5312,389
39113,OH,Montgomery,,2007,6.2,256347,273316,16969
39113,OH,Montgomery,,2008,7.6,249261,269680,20419
39113,OH,Montgomery,,2009,11.6,233320,263984,30664
39113,OH,Montgomery,,2010,11.4,235489,265741,30252
39113,OH,Montgomery,,2011,9.7,234202,259391,25189
39113,OH,Montgomery,,2012,8.2,233721,254590,20869
39113,OH,Montgomery,,2013,8.3,230358,251135,20777
39113,OH,Montgomery,,2014,6.1,234391,249711,15320
39113,OH,Montgomery,,2015,5.1,237254,249904,12650
39113,OH,Montgomery,,2016,5,238575,251039,12464
39113,OH,Montgomery,,2017,4.9,240829,253155,12326
39113,OH,Montgomery,,2018,4.5,240844,252244,11400
39113,OH,Montgomery,,2019,4.2,243116,253887,10771
39113,OH,Montgomery,,2020,8.7,229324,251066,21742
39113,OH,Montgomery,,2021,5.6,234606,248437,13831
39115,OH,Morgan,,2007,9.4,5258,5801,543
39115,OH,Morgan,,2008,10.4,5257,5865,608
39115,OH,Morgan,,2009,14.6,5121,5995,874
39115,OH,Morgan,,2010,13.4,5957,6876,919
39115,OH,Morgan,,2011,11.3,6000,6768,768
39115,OH,Morgan,,2012,9.9,6038,6702,664
39115,OH,Morgan,,2013,10.1,6014,6687,673
39115,OH,Morgan,,2014,7.8,6163,6684,521
39115,OH,Morgan,,2015,7.4,6232,6728,496
39115,OH,Morgan,,2016,8.3,6214,6780,566
39115,OH,Morgan,,2017,6.8,6281,6736,455
39115,OH,Morgan,,2018,6,6342,6745,403
39115,OH,Morgan,,2019,6.5,6342,6784,442
39115,OH,Morgan,,2020,9.2,6065,6682,617
39115,OH,Morgan,,2021,6.2,6334,6756,422
39117,OH,Morrow,,2007,5.9,17084,18146,1062
39117,OH,Morrow,,2008,7.2,16835,18133,1298
39117,OH,Morrow,,2009,11.2,15947,17957,2010
39117,OH,Morrow,,2010,11.5,15352,17338,1986
39117,OH,Morrow,,2011,10.1,15361,17091,1730
39117,OH,Morrow,,2012,8.1,15530,16904,1374
39117,OH,Morrow,,2013,8,15532,16886,1354
39117,OH,Morrow,,2014,5.9,15842,16844,1002
39117,OH,Morrow,,2015,5.1,15888,16741,853
39117,OH,Morrow,,2016,5.1,15978,16834,856
39117,OH,Morrow,,2017,4.9,16001,16831,830
39117,OH,Morrow,,2018,4.6,15969,16739,770
39117,OH,Morrow,,2019,4.2,16266,16973,707
39117,OH,Morrow,,2020,7.2,15504,16706,1202
39117,OH,Morrow,,2021,4.5,16149,16911,762
39119,OH,Muskingum,,2007,7.8,36321,39391,3070
39119,OH,Muskingum,,2008,8.8,35360,38758,3398
39119,OH,Muskingum,,2009,12.6,33721,38599,4878
39119,OH,Muskingum,,2010,12.6,36461,41717,5256
39119,OH,Muskingum,,2011,10.9,36712,41192,4480
39119,OH,Muskingum,,2012,9.2,36680,40377,3697
39119,OH,Muskingum,,2013,9.1,36291,39928,3637
39119,OH,Muskingum,,2014,7.1,36643,39446,2803
39119,OH,Muskingum,,2015,6.3,36495,38940,2445
39119,OH,Muskingum,,2016,6.1,37474,39897,2423
39119,OH,Muskingum,,2017,5.7,37750,40012,2262
39119,OH,Muskingum,,2018,5.3,37646,39746,2100
39119,OH,Muskingum,,2019,4.9,38050,40025,1975
39119,OH,Muskingum,,2020,7.8,37072,40198,3126
39119,OH,Muskingum,,2021,5.1,38273,40348,2075
39121,OH,Noble,,2007,7.4,5438,5874,436
39121,OH,Noble,,2008,8.7,5379,5889,510
39121,OH,Noble,,2009,14.5,5005,5855,850
39121,OH,Noble,,2010,16,4392,5230,838
39121,OH,Noble,,2011,13.3,4311,4974,663
39121,OH,Noble,,2012,11,4256,4781,525
39121,OH,Noble,,2013,9.6,4777,5285,508
39121,OH,Noble,,2014,7.6,4707,5095,388
39121,OH,Noble,,2015,7.4,4624,4991,367
39121,OH,Noble,,2016,8.8,4481,4913,432
39121,OH,Noble,,2017,7.2,4449,4794,345
39121,OH,Noble,,2018,6.7,4474,4793,319
39121,OH,Noble,,2019,7,4427,4759,332
39121,OH,Noble,,2020,9.7,4186,4636,450
39121,OH,Noble,,2021,6.8,4314,4628,314
39123,OH,Ottawa,,2007,7.2,20340,21927,1587
39123,OH,Ottawa,,2008,8.9,19789,21730,1941
39123,OH,Ottawa,,2009,14.3,17798,20759,2961
39123,OH,Ottawa,,2010,12.4,19906,22711,2805
39123,OH,Ottawa,,2011,11,19934,22410,2476
39123,OH,Ottawa,,2012,9.5,19910,22004,2094
39123,OH,Ottawa,,2013,9.7,19828,21952,2124
39123,OH,Ottawa,,2014,7.6,19902,21548,1646
39123,OH,Ottawa,,2015,6.7,19691,21101,1410
39123,OH,Ottawa,,2016,6.5,19744,21118,1374
39123,OH,Ottawa,,2017,6.7,19898,21329,1431
39123,OH,Ottawa,,2018,6.3,19873,21205,1332
39123,OH,Ottawa,,2019,5.7,19991,21204,1213
39123,OH,Ottawa,,2020,9.1,18690,20566,1876
39123,OH,Ottawa,,2021,6.1,19371,20630,1259
39125,OH,Paulding,,2007,5,10498,11051,553
39125,OH,Paulding,,2008,7.2,10102,10889,787
39125,OH,Paulding,,2009,13.8,8968,10409,1441
39125,OH,Paulding,,2010,12.6,8487,9710,1223
39125,OH,Paulding,,2011,9.7,8512,9430,918
39125,OH,Paulding,,2012,7.7,8508,9217,709
39125,OH,Paulding,,2013,7.6,8328,9016,688
39125,OH,Paulding,,2014,5.5,8539,9036,497
39125,OH,Paulding,,2015,4.8,8501,8934,433
39125,OH,Paulding,,2016,4.6,8498,8910,412
39125,OH,Paulding,,2017,4.4,8543,8937,394
39125,OH,Paulding,,2018,4.1,8438,8795,357
39125,OH,Paulding,,2019,3.9,8365,8701,336
39125,OH,Paulding,,2020,7.5,8033,8681,648
39125,OH,Paulding,,2021,4.3,8227,8600,373
39127,OH,Perry,,2007,7.4,15352,16571,1219
39127,OH,Perry,,2008,8.6,15107,16534,1427
39127,OH,Perry,,2009,13.4,14499,16751,2252
39127,OH,Perry,,2010,13.4,14431,16670,2239
39127,OH,Perry,,2011,11.6,14485,16378,1893
39127,OH,Perry,,2012,9.8,14521,16094,1573
39127,OH,Perry,,2013,9.6,14520,16056,1536
39127,OH,Perry,,2014,7.4,14687,15856,1169
39127,OH,Perry,,2015,6.6,14832,15880,1048
39127,OH,Perry,,2016,6.4,14929,15954,1025
39127,OH,Perry,,2017,6,15018,15984,966
39127,OH,Perry,,2018,5.6,14943,15833,890
39127,OH,Perry,,2019,5.3,15168,16010,842
39127,OH,Perry,,2020,8.5,14447,15786,1339
39127,OH,Perry,,2021,5.6,15034,15922,888
39129,OH,Pickaway,,2007,6.1,23213,24719,1506
39129,OH,Pickaway,,2008,7.2,23230,25036,1806
39129,OH,Pickaway,,2009,11.1,21963,24705,2742
39129,OH,Pickaway,,2010,10.6,23366,26143,2777
39129,OH,Pickaway,,2011,9.2,23442,25809,2367
39129,OH,Pickaway,,2012,7.4,23794,25705,1911
39129,OH,Pickaway,,2013,7.3,23771,25642,1871
39129,OH,Pickaway,,2014,5.7,24406,25868,1462
39129,OH,Pickaway,,2015,4.8,24585,25828,1243
39129,OH,Pickaway,,2016,4.9,25028,26309,1281
39129,OH,Pickaway,,2017,4.6,25208,26437,1229
39129,OH,Pickaway,,2018,4.3,25162,26292,1130
39129,OH,Pickaway,,2019,4,25633,26711,1078
39129,OH,Pickaway,,2020,6.8,24464,26263,1799
39129,OH,Pickaway,,2021,4.5,25460,26648,1188
39131,OH,Pike,,2007,9.5,9958,11005,1047
39131,OH,Pike,,2008,10.3,9833,10961,1128
39131,OH,Pike,,2009,15.3,9380,11072,1692
39131,OH,Pike,,2010,14.8,9881,11604,1723
39131,OH,Pike,,2011,15.2,9332,11001,1669
39131,OH,Pike,,2012,13,9194,10571,1377
39131,OH,Pike,,2013,12.2,9446,10758,1312
39131,OH,Pike,,2014,9.1,9575,10529,954
39131,OH,Pike,,2015,7.4,9734,10511,777
39131,OH,Pike,,2016,7.6,10031,10851,820
39131,OH,Pike,,2017,7,10160,10920,760
39131,OH,Pike,,2018,6.5,10214,10922,708
39131,OH,Pike,,2019,6.2,10210,10889,679
39131,OH,Pike,,2020,9.4,9837,10857,1020
39131,OH,Pike,,2021,6.3,10225,10912,687
39133,OH,Portage,,2007,5.3,87918,92879,4961
39133,OH,Portage,,2008,6.3,87763,93712,5949
39133,OH,Portage,,2009,10.1,82700,92038,9338
39133,OH,Portage,,2010,10.4,81455,90869,9414
39133,OH,Portage,,2011,8.9,81246,89145,7899
39133,OH,Portage,,2012,7.3,81596,88000,6404
39133,OH,Portage,,2013,7.7,80915,87651,6736
39133,OH,Portage,,2014,5.9,81956,87056,5100
39133,OH,Portage,,2015,4.9,82825,87111,4286
39133,OH,Portage,,2016,5.1,83048,87472,4424
39133,OH,Portage,,2017,5,83542,87961,4419
39133,OH,Portage,,2018,4.6,83413,87390,3977
39133,OH,Portage,,2019,4.3,84259,88013,3754
39133,OH,Portage,,2020,7.3,79156,85380,6224
39133,OH,Portage,,2021,4.7,80765,84767,4002
39135,OH,Preble,,2007,5.8,20584,21850,1266
39135,OH,Preble,,2008,7,20098,21616,1518
39135,OH,Preble,,2009,12.3,18786,21415,2629
39135,OH,Preble,,2010,11,19941,22415,2474
39135,OH,Preble,,2011,9.5,19596,21665,2069
39135,OH,Preble,,2012,7.7,19824,21484,1660
39135,OH,Preble,,2013,7.5,19690,21292,1602
39135,OH,Preble,,2014,5.7,19981,21189,1208
39135,OH,Preble,,2015,4.9,20028,21054,1026
39135,OH,Preble,,2016,4.8,20090,21103,1013
39135,OH,Preble,,2017,4.4,20358,21306,948
39135,OH,Preble,,2018,4.1,20408,21272,864
39135,OH,Preble,,2019,3.8,20521,21330,809
39135,OH,Preble,,2020,6.8,19589,21014,1425
39135,OH,Preble,,2021,4.1,20677,21552,875
39137,OH,Putnam,,2007,4.8,17531,18416,885
39137,OH,Putnam,,2008,5.9,17521,18611,1090
39137,OH,Putnam,,2009,10.7,16252,18192,1940
39137,OH,Putnam,,2010,9.3,17552,19362,1810
39137,OH,Putnam,,2011,7.4,17772,19198,1426
39137,OH,Putnam,,2012,5.8,17710,18800,1090
39137,OH,Putnam,,2013,6,17676,18804,1128
39137,OH,Putnam,,2014,4.5,17847,18696,849
39137,OH,Putnam,,2015,3.9,17990,18724,734
39137,OH,Putnam,,2016,3.7,18275,18975,700
39137,OH,Putnam,,2017,3.5,18319,18991,672
39137,OH,Putnam,,2018,3.3,18130,18756,626
39137,OH,Putnam,,2019,3.1,18387,18980,593
39137,OH,Putnam,,2020,5.6,17493,18530,1037
39137,OH,Putnam,,2021,3.4,18240,18877,637
39139,OH,Richland,,2007,6.5,58954,63057,4103
39139,OH,Richland,,2008,7.5,58178,62920,4742
39139,OH,Richland,,2009,12.9,53576,61506,7930
39139,OH,Richland,,2010,12.2,51970,59163,7193
39139,OH,Richland,,2011,10.6,51826,57968,6142
39139,OH,Richland,,2012,8.7,51019,55884,4865
39139,OH,Richland,,2013,8.6,50190,54903,4713
39139,OH,Richland,,2014,6.5,51085,54654,3569
39139,OH,Richland,,2015,5.6,50713,53744,3031
39139,OH,Richland,,2016,5.6,50633,53626,2993
39139,OH,Richland,,2017,5.4,50600,53515,2915
39139,OH,Richland,,2018,4.9,50498,53098,2600
39139,OH,Richland,,2019,4.6,50401,52812,2411
39139,OH,Richland,,2020,9,47026,51670,4644
39139,OH,Richland,,2021,5.6,48658,51520,2862
39141,OH,Ross,,2007,6.9,32876,35319,2443
39141,OH,Ross,,2008,8,32188,35005,2817
39141,OH,Ross,,2009,12.2,30611,34853,4242
39141,OH,Ross,,2010,12,30052,34133,4081
39141,OH,Ross,,2011,9.9,30817,34216,3399
39141,OH,Ross,,2012,8.4,31195,34054,2859
39141,OH,Ross,,2013,8.7,30579,33481,2902
39141,OH,Ross,,2014,6.4,31592,33749,2157
39141,OH,Ross,,2015,5.4,31996,33827,1831
39141,OH,Ross,,2016,5.6,32087,33973,1886
39141,OH,Ross,,2017,5.1,32651,34412,1761
39141,OH,Ross,,2018,4.5,33388,34968,1580
39141,OH,Ross,,2019,4.2,34074,35583,1509
39141,OH,Ross,,2020,8,32371,35186,2815
39141,OH,Ross,,2021,4.8,33475,35174,1699
39143,OH,Sandusky,,2007,6.1,32116,34203,2087
39143,OH,Sandusky,,2008,7.3,31166,33621,2455
39143,OH,Sandusky,,2009,12.2,28933,32938,4005
39143,OH,Sandusky,,2010,10.8,29663,33253,3590
39143,OH,Sandusky,,2011,9.1,29644,32627,2983
39143,OH,Sandusky,,2012,7.5,29386,31773,2387
39143,OH,Sandusky,,2013,7.5,29160,31540,2380
39143,OH,Sandusky,,2014,5.7,29577,31374,1797
39143,OH,Sandusky,,2015,4.9,29929,31461,1532
39143,OH,Sandusky,,2016,4.8,29669,31149,1480
39143,OH,Sandusky,,2017,4.7,30011,31498,1487
39143,OH,Sandusky,,2018,4.5,29632,31032,1400
39143,OH,Sandusky,,2019,4.3,29492,30830,1338
39143,OH,Sandusky,,2020,8.1,27548,29980,2432
39143,OH,Sandusky,,2021,5.2,28788,30368,1580
39145,OH,Scioto,,2007,7.5,30112,32540,2428
39145,OH,Scioto,,2008,8.5,30052,32830,2778
39145,OH,Scioto,,2009,12.5,28582,32665,4083
39145,OH,Scioto,,2010,13.4,28294,32655,4361
39145,OH,Scioto,,2011,12.5,27769,31738,3969
39145,OH,Scioto,,2012,11.3,27584,31093,3509
39145,OH,Scioto,,2013,11.9,26717,30324,3607
39145,OH,Scioto,,2014,8.8,27335,29957,2622
39145,OH,Scioto,,2015,7.7,27386,29682,2296
39145,OH,Scioto,,2016,7.8,27662,29999,2337
39145,OH,Scioto,,2017,7,27670,29767,2097
39145,OH,Scioto,,2018,6.7,27160,29115,1955
39145,OH,Scioto,,2019,6.3,27332,29173,1841
39145,OH,Scioto,,2020,8.7,26546,29082,2536
39145,OH,Scioto,,2021,6.2,27495,29306,1811
39147,OH,Seneca,,2007,5.7,29652,31457,1805
39147,OH,Seneca,,2008,7.2,28561,30762,2201
39147,OH,Seneca,,2009,12.7,26565,30439,3874
39147,OH,Seneca,,2010,12,25974,29503,3529
39147,OH,Seneca,,2011,9.6,25960,28722,2762
39147,OH,Seneca,,2012,8,25591,27802,2211
39147,OH,Seneca,,2013,7.7,25273,27393,2120
39147,OH,Seneca,,2014,5.7,25671,27233,1562
39147,OH,Seneca,,2015,4.9,25903,27233,1330
39147,OH,Seneca,,2016,4.9,25914,27259,1345
39147,OH,Seneca,,2017,4.7,26244,27545,1301
39147,OH,Seneca,,2018,4.4,26146,27348,1202
39147,OH,Seneca,,2019,4.2,26502,27656,1154
39147,OH,Seneca,,2020,8.1,24912,27108,2196
39147,OH,Seneca,,2021,4.7,25509,26771,1262
39149,OH,Shelby,,2007,4.8,27271,28653,1382
39149,OH,Shelby,,2008,6.3,26105,27854,1749
39149,OH,Shelby,,2009,13.7,22792,26421,3629
39149,OH,Shelby,,2010,12.5,21892,25007,3115
39149,OH,Shelby,,2011,9.6,21837,24168,2331
39149,OH,Shelby,,2012,7.3,22111,23846,1735
39149,OH,Shelby,,2013,6.7,22159,23745,1586
39149,OH,Shelby,,2014,5.1,22504,23713,1209
39149,OH,Shelby,,2015,4.3,23107,24157,1050
39149,OH,Shelby,,2016,4.2,23158,24167,1009
39149,OH,Shelby,,2017,4.1,23168,24165,997
39149,OH,Shelby,,2018,3.7,23194,24097,903
39149,OH,Shelby,,2019,3.6,23505,24375,870
39149,OH,Shelby,,2020,7.7,22093,23940,1847
39149,OH,Shelby,,2021,4.2,22797,23791,994
39151,OH,Stark,,2007,5.8,182223,193537,11314
39151,OH,Stark,,2008,6.9,180468,193755,13287
39151,OH,Stark,,2009,11.4,168577,190272,21695
39151,OH,Stark,,2010,11.4,170423,192248,21825
39151,OH,Stark,,2011,9.3,171099,188690,17591
39151,OH,Stark,,2012,7.5,173932,187968,14036
39151,OH,Stark,,2013,7.5,174666,188921,14255
39151,OH,Stark,,2014,5.8,177806,188754,10948
39151,OH,Stark,,2015,5.3,177206,187170,9964
39151,OH,Stark,,2016,5.5,176932,187210,10278
39151,OH,Stark,,2017,5.2,178467,188257,9790
39151,OH,Stark,,2018,4.9,177846,186994,9148
39151,OH,Stark,,2019,4.6,178726,187256,8530
39151,OH,Stark,,2020,8.1,168443,183250,14807
39151,OH,Stark,,2021,5.2,172691,182193,9502
39153,OH,Summit,,2007,5.4,283411,299648,16237
39153,OH,Summit,,2008,6.2,282208,300963,18755
39153,OH,Summit,,2009,10,263254,292502,29248
39153,OH,Summit,,2010,10.6,251986,281921,29935
39153,OH,Summit,,2011,9.1,250799,275855,25056
39153,OH,Summit,,2012,7.5,252147,272453,20306
39153,OH,Summit,,2013,7.6,250368,270976,20608
39153,OH,Summit,,2014,5.9,256847,272945,16098
39153,OH,Summit,,2015,5,258933,272635,13702
39153,OH,Summit,,2016,5.1,259430,273479,14049
39153,OH,Summit,,2017,5.1,260984,274876,13892
39153,OH,Summit,,2018,4.6,260047,272715,12668
39153,OH,Summit,,2019,4.3,262992,274825,11833
39153,OH,Summit,,2020,8.3,245734,267963,22229
39153,OH,Summit,,2021,5.4,250658,265068,14410
39155,OH,Trumbull,,2007,6.3,100405,107117,6712
39155,OH,Trumbull,,2008,7.6,98440,106548,8108
39155,OH,Trumbull,,2009,13.9,91589,106371,14782
39155,OH,Trumbull,,2010,13.3,86729,99980,13251
39155,OH,Trumbull,,2011,10.7,86802,97155,10353
39155,OH,Trumbull,,2012,9,86735,95344,8609
39155,OH,Trumbull,,2013,9.3,85671,94482,8811
39155,OH,Trumbull,,2014,7.3,86109,92842,6733
39155,OH,Trumbull,,2015,6.5,85743,91723,5980
39155,OH,Trumbull,,2016,6.8,84612,90798,6186
39155,OH,Trumbull,,2017,7.2,83189,89622,6433
39155,OH,Trumbull,,2018,6.2,82606,88065,5459
39155,OH,Trumbull,,2019,6.2,82276,87687,5411
39155,OH,Trumbull,,2020,10.4,75860,84667,8807
39155,OH,Trumbull,,2021,6.4,77977,83322,5345
39157,OH,Tuscarawas,,2007,5.4,45986,48597,2611
39157,OH,Tuscarawas,,2008,6.3,45208,48266,3058
39157,OH,Tuscarawas,,2009,11.3,41735,47057,5322
39157,OH,Tuscarawas,,2010,11.3,40939,46160,5221
39157,OH,Tuscarawas,,2011,9.3,41079,45281,4202
39157,OH,Tuscarawas,,2012,7.4,41691,45001,3310
39157,OH,Tuscarawas,,2013,7.3,41749,45020,3271
39157,OH,Tuscarawas,,2014,5.5,42918,45434,2516
39157,OH,Tuscarawas,,2015,5.4,43118,45594,2476
39157,OH,Tuscarawas,,2016,5.8,42585,45200,2615
39157,OH,Tuscarawas,,2017,5,43373,45657,2284
39157,OH,Tuscarawas,,2018,4.5,42747,44782,2035
39157,OH,Tuscarawas,,2019,4.3,43306,45275,1969
39157,OH,Tuscarawas,,2020,7.6,41095,44452,3357
39157,OH,Tuscarawas,,2021,4.6,42291,44346,2055
39159,OH,Union,,2007,4.3,24548,25663,1115
39159,OH,Union,,2008,5.3,24742,26126,1384
39159,OH,Union,,2009,8.6,23641,25859,2218
39159,OH,Union,,2010,8.4,24451,26706,2255
39159,OH,Union,,2011,7.2,24741,26653,1912
39159,OH,Union,,2012,5.8,24831,26346,1515
39159,OH,Union,,2013,5.8,25064,26611,1547
39159,OH,Union,,2014,4.5,25677,26874,1197
39159,OH,Union,,2015,3.9,26059,27111,1052
39159,OH,Union,,2016,3.8,26830,27903,1073
39159,OH,Union,,2017,3.7,27482,28546,1064
39159,OH,Union,,2018,3.5,27777,28774,997
39159,OH,Union,,2019,3.2,28680,29642,962
39159,OH,Union,,2020,5.8,27803,29513,1710
39159,OH,Union,,2021,3.5,28936,29989,1053
39161,OH,Van Wert,,2007,5.5,14832,15701,869
39161,OH,Van Wert,,2008,8.6,14213,15552,1339
39161,OH,Van Wert,,2009,14.9,12890,15146,2256
39161,OH,Van Wert,,2010,12.1,13162,14974,1812
39161,OH,Van Wert,,2011,9.3,13153,14498,1345
39161,OH,Van Wert,,2012,7.5,13090,14157,1067
39161,OH,Van Wert,,2013,6.9,13217,14202,985
39161,OH,Van Wert,,2014,4.9,13738,14443,705
39161,OH,Van Wert,,2015,4.2,13769,14373,604
39161,OH,Van Wert,,2016,4.1,13777,14361,584
39161,OH,Van Wert,,2017,3.9,14013,14583,570
39161,OH,Van Wert,,2018,3.5,13971,14479,508
39161,OH,Van Wert,,2019,3.3,14643,15140,497
39161,OH,Van Wert,,2020,7,13699,14734,1035
39161,OH,Van Wert,,2021,3.9,14016,14591,575
39163,OH,Vinton,,2007,7.9,5471,5939,468
39163,OH,Vinton,,2008,9.3,5236,5774,538
39163,OH,Vinton,,2009,13.2,4964,5720,756
39163,OH,Vinton,,2010,13.5,5021,5805,784
39163,OH,Vinton,,2011,11.9,5037,5717,680
39163,OH,Vinton,,2012,10.8,4951,5550,599
39163,OH,Vinton,,2013,10.6,4981,5573,592
39163,OH,Vinton,,2014,8,5086,5529,443
39163,OH,Vinton,,2015,6.6,5116,5479,363
39163,OH,Vinton,,2016,7.1,5088,5476,388
39163,OH,Vinton,,2017,6.8,5115,5491,376
39163,OH,Vinton,,2018,6.2,5184,5526,342
39163,OH,Vinton,,2019,5.7,5297,5615,318
39163,OH,Vinton,,2020,9.2,5083,5599,516
39163,OH,Vinton,,2021,6.2,5172,5513,341
39165,OH,Warren,,2007,4.6,103929,108960,5031
39165,OH,Warren,,2008,5.6,104056,110207,6151
39165,OH,Warren,,2009,8.9,99082,108755,9673
39165,OH,Warren,,2010,9.1,100309,110296,9987
39165,OH,Warren,,2011,7.9,100699,109330,8631
39165,OH,Warren,,2012,6.5,101993,109086,7093
39165,OH,Warren,,2013,6.4,102723,109788,7065
39165,OH,Warren,,2014,5,105721,111252,5531
39165,OH,Warren,,2015,4.2,108041,112777,4736
39165,OH,Warren,,2016,4.2,110242,115051,4809
39165,OH,Warren,,2017,4.1,112253,117057,4804
39165,OH,Warren,,2018,3.8,114238,118802,4564
39165,OH,Warren,,2019,3.5,117089,121389,4300
39165,OH,Warren,,2020,6.4,111968,119580,7612
39165,OH,Warren,,2021,4,116335,121173,4838
39167,OH,Washington,,2007,5.2,31688,33424,1736
39167,OH,Washington,,2008,5.6,31500,33355,1855
39167,OH,Washington,,2009,9.6,29682,32824,3142
39167,OH,Washington,,2010,11.4,26429,29845,3416
39167,OH,Washington,,2011,10.1,26053,28966,2913
39167,OH,Washington,,2012,8.6,25970,28429,2459
39167,OH,Washington,,2013,8.6,25915,28347,2432
39167,OH,Washington,,2014,6.4,26493,28302,1809
39167,OH,Washington,,2015,6.1,26442,28152,1710
39167,OH,Washington,,2016,7,25931,27890,1959
39167,OH,Washington,,2017,6.2,25742,27453,1711
39167,OH,Washington,,2018,5.6,25764,27293,1529
39167,OH,Washington,,2019,5.4,26159,27653,1494
39167,OH,Washington,,2020,8.6,24503,26808,2305
39167,OH,Washington,,2021,5.5,25250,26727,1477
39169,OH,Wayne,,2007,4.8,57710,60649,2939
39169,OH,Wayne,,2008,5.8,56491,59957,3466
39169,OH,Wayne,,2009,10,52125,57946,5821
39169,OH,Wayne,,2010,9.3,54612,60232,5620
39169,OH,Wayne,,2011,7.7,54508,59028,4520
39169,OH,Wayne,,2012,6.1,55467,59078,3611
39169,OH,Wayne,,2013,6.2,55600,59284,3684
39169,OH,Wayne,,2014,4.6,56913,59683,2770
39169,OH,Wayne,,2015,4,57793,60189,2396
39169,OH,Wayne,,2016,4,58995,61460,2465
39169,OH,Wayne,,2017,3.9,59600,62014,2414
39169,OH,Wayne,,2018,3.6,59201,61405,2204
39169,OH,Wayne,,2019,3.3,60558,62608,2050
39169,OH,Wayne,,2020,5.9,56754,60299,3545
39169,OH,Wayne,,2021,3.6,58061,60229,2168
39171,OH,Williams,,2007,6.1,18724,19932,1208
39171,OH,Williams,,2008,7.8,18518,20086,1568
39171,OH,Williams,,2009,15.9,16890,20074,3184
39171,OH,Williams,,2010,13.2,16988,19567,2579
39171,OH,Williams,,2011,10.7,16850,18875,2025
39171,OH,Williams,,2012,7.9,17374,18863,1489
39171,OH,Williams,,2013,7.4,17256,18643,1387
39171,OH,Williams,,2014,5.5,17806,18833,1027
39171,OH,Williams,,2015,4.5,18222,19074,852
39171,OH,Williams,,2016,4.5,18232,19100,868
39171,OH,Williams,,2017,4.4,18274,19108,834
39171,OH,Williams,,2018,3.6,18356,19045,689
39171,OH,Williams,,2019,3.3,18548,19190,642
39171,OH,Williams,,2020,7.7,17330,18782,1452
39171,OH,Williams,,2021,4.3,17672,18467,795
39173,OH,Wood,,2007,5.4,66185,69936,3751
39173,OH,Wood,,2008,6.8,64775,69535,4760
39173,OH,Wood,,2009,11.4,58103,65606,7503
39173,OH,Wood,,2010,9.9,61828,68646,6818
39173,OH,Wood,,2011,8.3,62529,68178,5649
39173,OH,Wood,,2012,6.9,63991,68703,4712
39173,OH,Wood,,2013,7,64210,69045,4835
39173,OH,Wood,,2014,5.2,65730,69341,3611
39173,OH,Wood,,2015,4.3,66796,69812,3016
39173,OH,Wood,,2016,4.2,67946,70927,2981
39173,OH,Wood,,2017,4.4,67933,71047,3114
39173,OH,Wood,,2018,4,68303,71141,2838
39173,OH,Wood,,2019,3.7,69384,72039,2655
39173,OH,Wood,,2020,7,64309,69186,4877
39173,OH,Wood,,2021,4.3,66238,69203,2965
39175,OH,Wyandot,,2007,6.5,11531,12337,806
39175,OH,Wyandot,,2008,8,10634,11558,924
39175,OH,Wyandot,,2009,14,9592,11158,1566
39175,OH,Wyandot,,2010,11.1,10837,12195,1358
39175,OH,Wyandot,,2011,9.2,10973,12085,1112
39175,OH,Wyandot,,2012,6.8,11310,12139,829
39175,OH,Wyandot,,2013,6.3,11571,12350,779
39175,OH,Wyandot,,2014,4.4,11842,12386,544
39175,OH,Wyandot,,2015,3.7,11929,12387,458
39175,OH,Wyandot,,2016,3.7,12249,12724,475
39175,OH,Wyandot,,2017,3.7,12251,12720,469
39175,OH,Wyandot,,2018,3.2,12366,12775,409
39175,OH,Wyandot,,2019,3.1,12730,13143,413
39175,OH,Wyandot,,2020,6.9,12001,12893,892
39175,OH,Wyandot,,2021,3.5,12363,12816,453
40000,OK,Oklahoma,,2007,4,1654796,1723271,68475
40000,OK,Oklahoma,,2008,3.6,1678409,1740886,62477
40000,OK,Oklahoma,,2009,6.6,1653357,1769447,116090
40000,OK,Oklahoma,,2010,6.5,1650502,1765708,115206
40000,OK,Oklahoma,,2011,5.6,1668235,1767056,98821
40000,OK,Oklahoma,,2012,5.1,1703624,1794901,91277
40000,OK,Oklahoma,,2013,5.1,1707220,1799525,92305
40000,OK,Oklahoma,,2014,4.3,1719826,1797769,77943
40000,OK,Oklahoma,,2015,4.3,1750501,1829046,78545
40000,OK,Oklahoma,,2016,4.6,1743225,1828055,84830
40000,OK,Oklahoma,,2017,4,1752733,1826272,73539
40000,OK,Oklahoma,,2018,3.3,1773125,1833020,59895
40000,OK,Oklahoma,,2019,3.1,1782686,1840199,57513
40000,OK,Oklahoma,,2020,6.2,1721525,1835861,114336
40000,OK,Oklahoma,,2021,3.8,1783080,1854234,71154
40001,OK,Adair,,2007,4.6,10356,10855,499
40001,OK,Adair,,2008,4.7,10299,10809,510
40001,OK,Adair,,2009,8.2,10281,11203,922
40001,OK,Adair,,2010,10.1,7980,8873,893
40001,OK,Adair,,2011,8.7,8038,8806,768
40001,OK,Adair,,2012,8.9,7701,8450,749
40001,OK,Adair,,2013,9.5,7459,8243,784
40001,OK,Adair,,2014,7.7,7457,8082,625
40001,OK,Adair,,2015,5.9,7673,8156,483
40001,OK,Adair,,2016,5.6,7683,8141,458
40001,OK,Adair,,2017,4.7,7808,8192,384
40001,OK,Adair,,2018,4,7815,8140,325
40001,OK,Adair,,2019,3.9,7754,8070,316
40001,OK,Adair,,2020,5.9,7771,8260,489
40001,OK,Adair,,2021,3.7,8156,8467,311
40003,OK,Alfalfa,,2007,4.3,2226,2325,99
40003,OK,Alfalfa,,2008,3,2398,2471,73
40003,OK,Alfalfa,,2009,5,2412,2538,126
40003,OK,Alfalfa,,2010,4.7,2378,2495,117
40003,OK,Alfalfa,,2011,3.9,2453,2552,99
40003,OK,Alfalfa,,2012,2.8,2827,2908,81
40003,OK,Alfalfa,,2013,3.2,2840,2933,93
40003,OK,Alfalfa,,2014,2.4,3018,3092,74
40003,OK,Alfalfa,,2015,2.9,3071,3162,91
40003,OK,Alfalfa,,2016,3.2,2870,2965,95
40003,OK,Alfalfa,,2017,2.5,2873,2947,74
40003,OK,Alfalfa,,2018,2.1,2829,2889,60
40003,OK,Alfalfa,,2019,1.9,2733,2787,54
40003,OK,Alfalfa,,2020,3.7,2645,2746,101
40003,OK,Alfalfa,,2021,2.3,2620,2683,63
40005,OK,Atoka,,2007,5.3,5591,5901,310
40005,OK,Atoka,,2008,4.4,5757,6024,267
40005,OK,Atoka,,2009,8.5,5745,6277,532
40005,OK,Atoka,,2010,9.6,4608,5099,491
40005,OK,Atoka,,2011,8.1,4585,4991,406
40005,OK,Atoka,,2012,6.6,4650,4977,327
40005,OK,Atoka,,2013,6.7,4576,4903,327
40005,OK,Atoka,,2014,5.9,4510,4795,285
40005,OK,Atoka,,2015,6.3,4548,4856,308
40005,OK,Atoka,,2016,6.4,4731,5052,321
40005,OK,Atoka,,2017,5,4907,5167,260
40005,OK,Atoka,,2018,4,4848,5049,201
40005,OK,Atoka,,2019,4.1,4694,4896,202
40005,OK,Atoka,,2020,7.2,4745,5113,368
40005,OK,Atoka,,2021,4.7,4784,5021,237
40007,OK,Beaver,,2007,2.6,2999,3079,80
40007,OK,Beaver,,2008,2,3191,3255,64
40007,OK,Beaver,,2009,3.6,3217,3337,120
40007,OK,Beaver,,2010,3.8,2779,2889,110
40007,OK,Beaver,,2011,3.4,2845,2946,101
40007,OK,Beaver,,2012,2.9,3025,3115,90
40007,OK,Beaver,,2013,3.3,2924,3023,99
40007,OK,Beaver,,2014,2.7,3015,3098,83
40007,OK,Beaver,,2015,2.6,2943,3023,80
40007,OK,Beaver,,2016,3,2798,2885,87
40007,OK,Beaver,,2017,2.4,2952,3026,74
40007,OK,Beaver,,2018,1.9,2949,3007,58
40007,OK,Beaver,,2019,1.9,2805,2860,55
40007,OK,Beaver,,2020,2.7,2501,2570,69
40007,OK,Beaver,,2021,1.7,2580,2625,45
40009,OK,Beckham,,2007,2.3,11323,11595,272
40009,OK,Beckham,,2008,2.2,12167,12443,276
40009,OK,Beckham,,2009,6,11417,12151,734
40009,OK,Beckham,,2010,5.5,9757,10330,573
40009,OK,Beckham,,2011,3.5,10916,11313,397
40009,OK,Beckham,,2012,2.9,12140,12507,367
40009,OK,Beckham,,2013,3.2,12181,12582,401
40009,OK,Beckham,,2014,2.7,12408,12755,347
40009,OK,Beckham,,2015,5,11594,12201,607
40009,OK,Beckham,,2016,6.9,10246,11011,765
40009,OK,Beckham,,2017,3.7,10842,11254,412
40009,OK,Beckham,,2018,2.5,11093,11375,282
40009,OK,Beckham,,2019,3,10126,10439,313
40009,OK,Beckham,,2020,7.7,9179,9942,763
40009,OK,Beckham,,2021,4.3,9286,9706,420
40011,OK,Blaine,,2007,4.1,4732,4934,202
40011,OK,Blaine,,2008,3.5,4806,4980,174
40011,OK,Blaine,,2009,5.8,4722,5011,289
40011,OK,Blaine,,2010,6.2,4192,4467,275
40011,OK,Blaine,,2011,5.1,4122,4342,220
40011,OK,Blaine,,2012,3.8,4194,4358,164
40011,OK,Blaine,,2013,3.9,4147,4315,168
40011,OK,Blaine,,2014,3.3,4334,4483,149
40011,OK,Blaine,,2015,3.7,4316,4484,168
40011,OK,Blaine,,2016,3.6,4232,4388,156
40011,OK,Blaine,,2017,2.6,4483,4605,122
40011,OK,Blaine,,2018,1.9,4381,4467,86
40011,OK,Blaine,,2019,1.9,4630,4720,90
40011,OK,Blaine,,2020,6.1,4110,4375,265
40011,OK,Blaine,,2021,3,4272,4402,130
40013,OK,Bryan,,2007,3.4,19945,20646,701
40013,OK,Bryan,,2008,3.3,19609,20280,671
40013,OK,Bryan,,2009,5.4,19511,20619,1108
40013,OK,Bryan,,2010,5.9,17387,18483,1096
40013,OK,Bryan,,2011,5.6,16469,17454,985
40013,OK,Bryan,,2012,5.2,16629,17542,913
40013,OK,Bryan,,2013,5.3,16774,17712,938
40013,OK,Bryan,,2014,4.7,17008,17843,835
40013,OK,Bryan,,2015,4.5,17510,18326,816
40013,OK,Bryan,,2016,4.2,18680,19490,810
40013,OK,Bryan,,2017,3.6,19571,20308,737
40013,OK,Bryan,,2018,3,20242,20878,636
40013,OK,Bryan,,2019,2.9,20744,21365,621
40013,OK,Bryan,,2020,5.2,21168,22318,1150
40013,OK,Bryan,,2021,3.3,21266,21988,722
40015,OK,Caddo,,2007,4.8,11340,11914,574
40015,OK,Caddo,,2008,3.9,11954,12439,485
40015,OK,Caddo,,2009,6.4,12135,12959,824
40015,OK,Caddo,,2010,6.7,11028,11816,788
40015,OK,Caddo,,2011,6.8,10794,11576,782
40015,OK,Caddo,,2012,5.8,10977,11653,676
40015,OK,Caddo,,2013,6.1,10670,11362,692
40015,OK,Caddo,,2014,5.2,10551,11134,583
40015,OK,Caddo,,2015,5,11231,11826,595
40015,OK,Caddo,,2016,5.1,11298,11908,610
40015,OK,Caddo,,2017,4.2,11812,12327,515
40015,OK,Caddo,,2018,3.4,11660,12074,414
40015,OK,Caddo,,2019,3.4,11373,11772,399
40015,OK,Caddo,,2020,6,11180,11894,714
40015,OK,Caddo,,2021,3.7,11566,12011,445
40017,OK,Canadian,,2007,3.7,49046,50915,1869
40017,OK,Canadian,,2008,3.3,50220,51912,1692
40017,OK,Canadian,,2009,5.7,50419,53474,3055
40017,OK,Canadian,,2010,5,57066,60041,2975
40017,OK,Canadian,,2011,4.2,58821,61377,2556
40017,OK,Canadian,,2012,3.8,60849,63242,2393
40017,OK,Canadian,,2013,4,62113,64697,2584
40017,OK,Canadian,,2014,3.4,63625,65885,2260
40017,OK,Canadian,,2015,3.5,65855,68258,2403
40017,OK,Canadian,,2016,3.8,66683,69350,2667
40017,OK,Canadian,,2017,3.3,68466,70821,2355
40017,OK,Canadian,,2018,2.7,71324,73268,1944
40017,OK,Canadian,,2019,2.7,73593,75634,2041
40017,OK,Canadian,,2020,5.9,72687,77282,4595
40017,OK,Canadian,,2021,3.2,75802,78317,2515
40019,OK,Carter,,2007,3.3,24718,25563,845
40019,OK,Carter,,2008,3.1,25868,26698,830
40019,OK,Carter,,2009,5.7,27006,28641,1635
40019,OK,Carter,,2010,6.8,19711,21156,1445
40019,OK,Carter,,2011,6.1,20262,21580,1318
40019,OK,Carter,,2012,5.4,20659,21829,1170
40019,OK,Carter,,2013,5.2,20868,22003,1135
40019,OK,Carter,,2014,4.3,21066,22011,945
40019,OK,Carter,,2015,4.4,21541,22540,999
40019,OK,Carter,,2016,5,21557,22690,1133
40019,OK,Carter,,2017,4.3,21413,22370,957
40019,OK,Carter,,2018,3.4,21305,22047,742
40019,OK,Carter,,2019,3.3,20704,21400,696
40019,OK,Carter,,2020,7.1,19729,21239,1510
40019,OK,Carter,,2021,4.4,20447,21388,941
40021,OK,Cherokee,,2007,3.9,22237,23148,911
40021,OK,Cherokee,,2008,3.6,22012,22845,833
40021,OK,Cherokee,,2009,5.5,23403,24773,1370
40021,OK,Cherokee,,2010,7.4,18001,19431,1430
40021,OK,Cherokee,,2011,6.9,17833,19164,1331
40021,OK,Cherokee,,2012,6.8,17593,18883,1290
40021,OK,Cherokee,,2013,6.8,17433,18696,1263
40021,OK,Cherokee,,2014,5.8,17427,18506,1079
40021,OK,Cherokee,,2015,5,18279,19249,970
40021,OK,Cherokee,,2016,5.3,18237,19259,1022
40021,OK,Cherokee,,2017,5.1,18109,19084,975
40021,OK,Cherokee,,2018,4.1,17980,18740,760
40021,OK,Cherokee,,2019,3.8,18012,18720,708
40021,OK,Cherokee,,2020,5.6,18401,19489,1088
40021,OK,Cherokee,,2021,4.1,19116,19939,823
40023,OK,Choctaw,,2007,5.1,6475,6826,351
40023,OK,Choctaw,,2008,4.9,6550,6888,338
40023,OK,Choctaw,,2009,7.2,6790,7318,528
40023,OK,Choctaw,,2010,8.8,5574,6109,535
40023,OK,Choctaw,,2011,8.6,5485,6000,515
40023,OK,Choctaw,,2012,8.2,5324,5799,475
40023,OK,Choctaw,,2013,8.3,5469,5961,492
40023,OK,Choctaw,,2014,8,5339,5804,465
40023,OK,Choctaw,,2015,7.5,5464,5906,442
40023,OK,Choctaw,,2016,7.4,5319,5742,423
40023,OK,Choctaw,,2017,5.8,5364,5696,332
40023,OK,Choctaw,,2018,4.8,5395,5668,273
40023,OK,Choctaw,,2019,4.6,5158,5408,250
40023,OK,Choctaw,,2020,7.6,5128,5552,424
40023,OK,Choctaw,,2021,5.2,5633,5940,307
40025,OK,Cimarron,,2007,3.7,1213,1259,46
40025,OK,Cimarron,,2008,2.9,1211,1247,36
40025,OK,Cimarron,,2009,3.9,1242,1292,50
40025,OK,Cimarron,,2010,3.4,1408,1457,49
40025,OK,Cimarron,,2011,3.2,1325,1369,44
40025,OK,Cimarron,,2012,3.1,1246,1286,40
40025,OK,Cimarron,,2013,3.2,1194,1233,39
40025,OK,Cimarron,,2014,2.7,1240,1275,35
40025,OK,Cimarron,,2015,2.2,1345,1375,30
40025,OK,Cimarron,,2016,2.4,1382,1416,34
40025,OK,Cimarron,,2017,2.3,1382,1414,32
40025,OK,Cimarron,,2018,1.8,1348,1373,25
40025,OK,Cimarron,,2019,1.7,1300,1322,22
40025,OK,Cimarron,,2020,2.1,1368,1397,29
40025,OK,Cimarron,,2021,1.8,1476,1503,27
40027,OK,Cleveland,,2007,3.6,113429,117647,4218
40027,OK,Cleveland,,2008,3.3,114971,118871,3900
40027,OK,Cleveland,,2009,5.5,113898,120515,6617
40027,OK,Cleveland,,2010,5.1,124374,131026,6652
40027,OK,Cleveland,,2011,4.3,127115,132862,5747
40027,OK,Cleveland,,2012,4,130292,135737,5445
40027,OK,Cleveland,,2013,4.1,131213,136894,5681
40027,OK,Cleveland,,2014,3.6,130898,135719,4821
40027,OK,Cleveland,,2015,3.4,133326,138083,4757
40027,OK,Cleveland,,2016,3.7,133913,139036,5123
40027,OK,Cleveland,,2017,3.3,134646,139286,4640
40027,OK,Cleveland,,2018,2.8,137134,141067,3933
40027,OK,Cleveland,,2019,2.7,139052,142910,3858
40027,OK,Cleveland,,2020,5.7,134026,142056,8030
40027,OK,Cleveland,,2021,3.2,139744,144386,4642
40029,OK,Coal,,2007,6,2343,2493,150
40029,OK,Coal,,2008,4.7,2368,2484,116
40029,OK,Coal,,2009,8.8,2411,2644,233
40029,OK,Coal,,2010,8.8,2088,2289,201
40029,OK,Coal,,2011,8,2154,2342,188
40029,OK,Coal,,2012,6.9,2193,2355,162
40029,OK,Coal,,2013,7.4,2083,2249,166
40029,OK,Coal,,2014,6.5,2147,2296,149
40029,OK,Coal,,2015,7.4,2144,2316,172
40029,OK,Coal,,2016,7.1,2153,2317,164
40029,OK,Coal,,2017,5.1,2148,2263,115
40029,OK,Coal,,2018,3.5,2203,2284,81
40029,OK,Coal,,2019,3.7,2355,2446,91
40029,OK,Coal,,2020,6.9,2117,2275,158
40029,OK,Coal,,2021,4.5,2188,2292,104
40031,OK,Comanche,,2007,4.2,42921,44806,1885
40031,OK,Comanche,,2008,3.7,44084,45757,1673
40031,OK,Comanche,,2009,5.4,45173,47737,2564
40031,OK,Comanche,,2010,5.5,48604,51446,2842
40031,OK,Comanche,,2011,5.5,47782,50541,2759
40031,OK,Comanche,,2012,5.8,47687,50600,2913
40031,OK,Comanche,,2013,5.6,47238,50042,2804
40031,OK,Comanche,,2014,4.5,47057,49280,2223
40031,OK,Comanche,,2015,4.2,47502,49607,2105
40031,OK,Comanche,,2016,4.4,47196,49391,2195
40031,OK,Comanche,,2017,4.2,46703,48737,2034
40031,OK,Comanche,,2018,3.8,46342,48152,1810
40031,OK,Comanche,,2019,3.5,46303,47971,1668
40031,OK,Comanche,,2020,6.8,44578,47820,3242
40031,OK,Comanche,,2021,4.1,45802,47741,1939
40033,OK,Cotton,,2007,2.6,3856,3958,102
40033,OK,Cotton,,2008,2.7,3778,3882,104
40033,OK,Cotton,,2009,4.6,3456,3621,165
40033,OK,Cotton,,2010,6.4,2812,3005,193
40033,OK,Cotton,,2011,5.8,2737,2905,168
40033,OK,Cotton,,2012,5.5,2715,2872,157
40033,OK,Cotton,,2013,5.5,2702,2858,156
40033,OK,Cotton,,2014,4.5,2721,2848,127
40033,OK,Cotton,,2015,4.1,2743,2859,116
40033,OK,Cotton,,2016,4.6,2753,2887,134
40033,OK,Cotton,,2017,3.8,2682,2788,106
40033,OK,Cotton,,2018,3,2644,2726,82
40033,OK,Cotton,,2019,3.1,2571,2652,81
40033,OK,Cotton,,2020,7.1,2511,2704,193
40033,OK,Cotton,,2021,4.1,2598,2708,110
40035,OK,Craig,,2007,4.5,7060,7390,330
40035,OK,Craig,,2008,3.7,7130,7402,272
40035,OK,Craig,,2009,5.8,7129,7564,435
40035,OK,Craig,,2010,6.4,6159,6583,424
40035,OK,Craig,,2011,6,5947,6327,380
40035,OK,Craig,,2012,5.5,5987,6334,347
40035,OK,Craig,,2013,6.3,5841,6234,393
40035,OK,Craig,,2014,5.3,5726,6049,323
40035,OK,Craig,,2015,4.7,5961,6256,295
40035,OK,Craig,,2016,4.7,5954,6245,291
40035,OK,Craig,,2017,4.1,5819,6069,250
40035,OK,Craig,,2018,3.3,5867,6070,203
40035,OK,Craig,,2019,3.4,5700,5899,199
40035,OK,Craig,,2020,5.5,5468,5785,317
40035,OK,Craig,,2021,3.6,5506,5714,208
40037,OK,Creek,,2007,4.2,29612,30926,1314
40037,OK,Creek,,2008,4.1,29842,31109,1267
40037,OK,Creek,,2009,8.2,28687,31245,2558
40037,OK,Creek,,2010,8.2,29118,31722,2604
40037,OK,Creek,,2011,6.6,29101,31174,2073
40037,OK,Creek,,2012,5.8,29614,31442,1828
40037,OK,Creek,,2013,5.8,29373,31193,1820
40037,OK,Creek,,2014,4.8,29458,30945,1487
40037,OK,Creek,,2015,4.8,29795,31309,1514
40037,OK,Creek,,2016,5.6,29687,31452,1765
40037,OK,Creek,,2017,4.7,29884,31367,1483
40037,OK,Creek,,2018,3.7,30210,31358,1148
40037,OK,Creek,,2019,3.5,30329,31437,1108
40037,OK,Creek,,2020,6.6,28850,30901,2051
40037,OK,Creek,,2021,4.2,29812,31131,1319
40039,OK,Custer,,2007,2.9,14055,14481,426
40039,OK,Custer,,2008,2.5,14338,14713,375
40039,OK,Custer,,2009,4.8,14675,15407,732
40039,OK,Custer,,2010,4.9,13446,14146,700
40039,OK,Custer,,2011,3.8,14569,15148,579
40039,OK,Custer,,2012,3.5,15083,15623,540
40039,OK,Custer,,2013,3.6,15434,16006,572
40039,OK,Custer,,2014,3,15425,15902,477
40039,OK,Custer,,2015,3.9,15028,15646,618
40039,OK,Custer,,2016,4.4,14514,15181,667
40039,OK,Custer,,2017,3.1,14896,15366,470
40039,OK,Custer,,2018,2.3,15253,15619,366
40039,OK,Custer,,2019,2.4,15186,15563,377
40039,OK,Custer,,2020,5.5,14197,15019,822
40039,OK,Custer,,2021,3.2,14686,15179,493
40041,OK,Delaware,,2007,4.4,17545,18359,814
40041,OK,Delaware,,2008,4,18102,18859,757
40041,OK,Delaware,,2009,6.6,18409,19720,1311
40041,OK,Delaware,,2010,7.7,15833,17149,1316
40041,OK,Delaware,,2011,6.8,16078,17255,1177
40041,OK,Delaware,,2012,6.4,15957,17046,1089
40041,OK,Delaware,,2013,6.7,15820,16957,1137
40041,OK,Delaware,,2014,5.6,16128,17089,961
40041,OK,Delaware,,2015,4.8,16618,17460,842
40041,OK,Delaware,,2016,4.7,17100,17947,847
40041,OK,Delaware,,2017,4.2,17735,18504,769
40041,OK,Delaware,,2018,3.8,17213,17889,676
40041,OK,Delaware,,2019,3.6,17409,18059,650
40041,OK,Delaware,,2020,5.4,17287,18276,989
40041,OK,Delaware,,2021,3.3,18066,18692,626
40043,OK,Dewey,,2007,3,2374,2447,73
40043,OK,Dewey,,2008,2.3,2571,2631,60
40043,OK,Dewey,,2009,4.5,2630,2753,123
40043,OK,Dewey,,2010,5,2192,2308,116
40043,OK,Dewey,,2011,3.7,2374,2465,91
40043,OK,Dewey,,2012,3.1,2300,2374,74
40043,OK,Dewey,,2013,3.4,2505,2593,88
40043,OK,Dewey,,2014,3,2330,2403,73
40043,OK,Dewey,,2015,3.5,2407,2495,88
40043,OK,Dewey,,2016,3.9,2568,2673,105
40043,OK,Dewey,,2017,2.7,2447,2515,68
40043,OK,Dewey,,2018,1.8,2709,2760,51
40043,OK,Dewey,,2019,2,2828,2886,58
40043,OK,Dewey,,2020,4.9,2545,2676,131
40043,OK,Dewey,,2021,2.7,2654,2728,74
40045,OK,Ellis,,2007,2.4,2315,2372,57
40045,OK,Ellis,,2008,2.1,2479,2532,53
40045,OK,Ellis,,2009,4.7,2356,2472,116
40045,OK,Ellis,,2010,5.1,1954,2060,106
40045,OK,Ellis,,2011,3.6,2033,2109,76
40045,OK,Ellis,,2012,2.8,2209,2272,63
40045,OK,Ellis,,2013,3,2260,2330,70
40045,OK,Ellis,,2014,2.9,2270,2338,68
40045,OK,Ellis,,2015,4,2295,2390,95
40045,OK,Ellis,,2016,3.7,2171,2254,83
40045,OK,Ellis,,2017,3,2150,2216,66
40045,OK,Ellis,,2018,2.1,2147,2193,46
40045,OK,Ellis,,2019,2.3,2078,2128,50
40045,OK,Ellis,,2020,4.6,2032,2129,97
40045,OK,Ellis,,2021,2.8,2043,2102,59
40047,OK,Garfield,,2007,2.8,29393,30253,860
40047,OK,Garfield,,2008,2.5,30668,31442,774
40047,OK,Garfield,,2009,4.5,30666,32110,1444
40047,OK,Garfield,,2010,5.3,26986,28495,1509
40047,OK,Garfield,,2011,4.2,27543,28754,1211
40047,OK,Garfield,,2012,3.9,28264,29420,1156
40047,OK,Garfield,,2013,4,28231,29405,1174
40047,OK,Garfield,,2014,3.4,28625,29646,1021
40047,OK,Garfield,,2015,3.8,28910,30065,1155
40047,OK,Garfield,,2016,4.2,27748,28969,1221
40047,OK,Garfield,,2017,3.7,26690,27702,1012
40047,OK,Garfield,,2018,2.9,26330,27118,788
40047,OK,Garfield,,2019,2.9,26217,26987,770
40047,OK,Garfield,,2020,5.5,25369,26854,1485
40047,OK,Garfield,,2021,3.4,25917,26842,925
40049,OK,Garvin,,2007,3.2,14025,14485,460
40049,OK,Garvin,,2008,2.9,14401,14831,430
40049,OK,Garvin,,2009,5.8,14316,15203,887
40049,OK,Garvin,,2010,7.2,11264,12143,879
40049,OK,Garvin,,2011,5.6,11493,12169,676
40049,OK,Garvin,,2012,4.8,11865,12467,602
40049,OK,Garvin,,2013,4.8,11837,12439,602
40049,OK,Garvin,,2014,3.9,12127,12623,496
40049,OK,Garvin,,2015,4.6,12233,12821,588
40049,OK,Garvin,,2016,5.2,12042,12697,655
40049,OK,Garvin,,2017,3.9,12088,12585,497
40049,OK,Garvin,,2018,3.1,12231,12628,397
40049,OK,Garvin,,2019,3,12162,12540,378
40049,OK,Garvin,,2020,6.3,11894,12694,800
40049,OK,Garvin,,2021,3.8,12206,12682,476
40051,OK,Grady,,2007,4.3,21759,22727,968
40051,OK,Grady,,2008,3.8,21944,22812,868
40051,OK,Grady,,2009,7.4,21553,23263,1710
40051,OK,Grady,,2010,6.2,23775,25352,1577
40051,OK,Grady,,2011,5,23940,25204,1264
40051,OK,Grady,,2012,4.6,24287,25461,1174
40051,OK,Grady,,2013,4.6,24322,25500,1178
40051,OK,Grady,,2014,3.9,24411,25394,983
40051,OK,Grady,,2015,4.4,25052,26200,1148
40051,OK,Grady,,2016,4.8,24810,26059,1249
40051,OK,Grady,,2017,3.8,24972,25968,996
40051,OK,Grady,,2018,2.9,25433,26203,770
40051,OK,Grady,,2019,2.9,25634,26413,779
40051,OK,Grady,,2020,6.2,24650,26284,1634
40051,OK,Grady,,2021,3.5,25758,26685,927
40053,OK,Grant,,2007,3.1,2456,2535,79
40053,OK,Grant,,2008,2.4,2533,2595,62
40053,OK,Grant,,2009,3.9,2589,2693,104
40053,OK,Grant,,2010,4.3,2461,2572,111
40053,OK,Grant,,2011,3.5,2450,2540,90
40053,OK,Grant,,2012,3.3,2554,2641,87
40053,OK,Grant,,2013,3.2,2573,2659,86
40053,OK,Grant,,2014,2.6,2738,2810,72
40053,OK,Grant,,2015,2.9,3195,3289,94
40053,OK,Grant,,2016,3.1,2910,3003,93
40053,OK,Grant,,2017,2.4,2809,2879,70
40053,OK,Grant,,2018,2,2673,2727,54
40053,OK,Grant,,2019,2,2599,2652,53
40053,OK,Grant,,2020,3.4,2667,2760,93
40053,OK,Grant,,2021,2.5,2655,2724,69
40055,OK,Greer,,2007,4.8,1903,1998,95
40055,OK,Greer,,2008,4.2,1947,2032,85
40055,OK,Greer,,2009,7.9,1938,2104,166
40055,OK,Greer,,2010,7.4,2026,2187,161
40055,OK,Greer,,2011,6,2008,2137,129
40055,OK,Greer,,2012,5.2,1958,2065,107
40055,OK,Greer,,2013,5.2,1892,1996,104
40055,OK,Greer,,2014,4.5,1940,2031,91
40055,OK,Greer,,2015,5.5,2047,2166,119
40055,OK,Greer,,2016,7.1,2030,2186,156
40055,OK,Greer,,2017,4.9,1949,2050,101
40055,OK,Greer,,2018,3.8,1881,1956,75
40055,OK,Greer,,2019,4,1745,1818,73
40055,OK,Greer,,2020,7.6,1725,1867,142
40055,OK,Greer,,2021,5.1,1764,1859,95
40057,OK,Harmon,,2007,3.4,1292,1337,45
40057,OK,Harmon,,2008,3.2,1287,1330,43
40057,OK,Harmon,,2009,5.6,1308,1385,77
40057,OK,Harmon,,2010,5.6,1239,1313,74
40057,OK,Harmon,,2011,5.1,1248,1315,67
40057,OK,Harmon,,2012,4.5,1345,1409,64
40057,OK,Harmon,,2013,4.2,1291,1348,57
40057,OK,Harmon,,2014,3.9,1228,1278,50
40057,OK,Harmon,,2015,3.4,1258,1302,44
40057,OK,Harmon,,2016,3.7,1244,1292,48
40057,OK,Harmon,,2017,3.6,1222,1268,46
40057,OK,Harmon,,2018,2.8,1170,1204,34
40057,OK,Harmon,,2019,2.7,1142,1174,32
40057,OK,Harmon,,2020,3.6,1126,1168,42
40057,OK,Harmon,,2021,2.5,1154,1184,30
40059,OK,Harper,,2007,2.7,1824,1875,51
40059,OK,Harper,,2008,2.2,1995,2039,44
40059,OK,Harper,,2009,4.1,1981,2065,84
40059,OK,Harper,,2010,4.3,1784,1865,81
40059,OK,Harper,,2011,3.5,1800,1866,66
40059,OK,Harper,,2012,3.1,1853,1912,59
40059,OK,Harper,,2013,3.2,1856,1918,62
40059,OK,Harper,,2014,2.7,1918,1971,53
40059,OK,Harper,,2015,3,1927,1986,59
40059,OK,Harper,,2016,3.7,1838,1908,70
40059,OK,Harper,,2017,2.9,1814,1868,54
40059,OK,Harper,,2018,2.2,1749,1789,40
40059,OK,Harper,,2019,2.7,1676,1723,47
40059,OK,Harper,,2020,3.5,1702,1763,61
40059,OK,Harper,,2021,2.5,1745,1789,44
40061,OK,Haskell,,2007,3.9,5419,5641,222
40061,OK,Haskell,,2008,3.6,5729,5943,214
40061,OK,Haskell,,2009,7.9,5705,6194,489
40061,OK,Haskell,,2010,9.4,4328,4777,449
40061,OK,Haskell,,2011,8.5,4262,4658,396
40061,OK,Haskell,,2012,8.6,4199,4595,396
40061,OK,Haskell,,2013,8.9,4064,4462,398
40061,OK,Haskell,,2014,7.2,4023,4335,312
40061,OK,Haskell,,2015,7.7,4126,4472,346
40061,OK,Haskell,,2016,8,4134,4493,359
40061,OK,Haskell,,2017,6.3,4073,4345,272
40061,OK,Haskell,,2018,4.9,3994,4200,206
40061,OK,Haskell,,2019,5,4003,4214,211
40061,OK,Haskell,,2020,8,3877,4216,339
40061,OK,Haskell,,2021,5.2,4027,4248,221
40063,OK,Hughes,,2007,5.9,4559,4846,287
40063,OK,Hughes,,2008,5.2,4812,5074,262
40063,OK,Hughes,,2009,10.4,5182,5786,604
40063,OK,Hughes,,2010,10.5,4971,5554,583
40063,OK,Hughes,,2011,8.9,4961,5447,486
40063,OK,Hughes,,2012,7.8,5296,5743,447
40063,OK,Hughes,,2013,7.8,5281,5726,445
40063,OK,Hughes,,2014,6.8,5253,5635,382
40063,OK,Hughes,,2015,7.3,5307,5725,418
40063,OK,Hughes,,2016,7,5117,5503,386
40063,OK,Hughes,,2017,5.3,5098,5383,285
40063,OK,Hughes,,2018,4,5121,5335,214
40063,OK,Hughes,,2019,4.6,5060,5303,243
40063,OK,Hughes,,2020,7.6,4892,5295,403
40063,OK,Hughes,,2021,5.2,4923,5191,268
40065,OK,Jackson,,2007,3.3,12148,12561,413
40065,OK,Jackson,,2008,3.1,11946,12323,377
40065,OK,Jackson,,2009,5.2,11648,12282,634
40065,OK,Jackson,,2010,5.7,10802,11453,651
40065,OK,Jackson,,2011,5.2,10726,11316,590
40065,OK,Jackson,,2012,5,10482,11030,548
40065,OK,Jackson,,2013,5.2,10249,10814,565
40065,OK,Jackson,,2014,4.2,10212,10655,443
40065,OK,Jackson,,2015,4,10436,10867,431
40065,OK,Jackson,,2016,4.2,10526,10991,465
40065,OK,Jackson,,2017,3.6,10418,10805,387
40065,OK,Jackson,,2018,2.9,10403,10715,312
40065,OK,Jackson,,2019,2.8,10319,10613,294
40065,OK,Jackson,,2020,4.1,10131,10567,436
40065,OK,Jackson,,2021,2.8,10481,10785,304
40067,OK,Jefferson,,2007,4.8,2237,2350,113
40067,OK,Jefferson,,2008,4.1,2294,2391,97
40067,OK,Jefferson,,2009,8.5,2335,2552,217
40067,OK,Jefferson,,2010,7.2,2483,2677,194
40067,OK,Jefferson,,2011,5.8,2496,2650,154
40067,OK,Jefferson,,2012,4.8,2469,2593,124
40067,OK,Jefferson,,2013,5.1,2446,2578,132
40067,OK,Jefferson,,2014,4.5,2466,2582,116
40067,OK,Jefferson,,2015,5.6,2527,2677,150
40067,OK,Jefferson,,2016,6.9,2518,2705,187
40067,OK,Jefferson,,2017,5.3,2354,2485,131
40067,OK,Jefferson,,2018,3.3,2491,2575,84
40067,OK,Jefferson,,2019,3.1,2407,2483,76
40067,OK,Jefferson,,2020,6.7,2384,2554,170
40067,OK,Jefferson,,2021,4,2373,2471,98
40069,OK,Johnston,,2007,4.2,4876,5088,212
40069,OK,Johnston,,2008,4.1,4946,5159,213
40069,OK,Johnston,,2009,7.7,4862,5267,405
40069,OK,Johnston,,2010,10,3364,3736,372
40069,OK,Johnston,,2011,8.2,3397,3699,302
40069,OK,Johnston,,2012,7.6,3357,3632,275
40069,OK,Johnston,,2013,7.9,3295,3578,283
40069,OK,Johnston,,2014,6.8,3381,3626,245
40069,OK,Johnston,,2015,6.4,3713,3965,252
40069,OK,Johnston,,2016,5.7,4120,4368,248
40069,OK,Johnston,,2017,3.8,4832,5021,189
40069,OK,Johnston,,2018,2.8,5033,5180,147
40069,OK,Johnston,,2019,4.1,3590,3744,154
40069,OK,Johnston,,2020,7.7,3454,3743,289
40069,OK,Johnston,,2021,4.6,3516,3684,168
40071,OK,Kay,,2007,4.1,21952,22885,933
40071,OK,Kay,,2008,3.4,23040,23842,802
40071,OK,Kay,,2009,7.7,21904,23719,1815
40071,OK,Kay,,2010,8.9,19034,20887,1853
40071,OK,Kay,,2011,7.4,19040,20559,1519
40071,OK,Kay,,2012,6.9,18811,20202,1391
40071,OK,Kay,,2013,6.7,18611,19948,1337
40071,OK,Kay,,2014,5.5,18201,19263,1062
40071,OK,Kay,,2015,5.5,18113,19175,1062
40071,OK,Kay,,2016,6.1,17761,18913,1152
40071,OK,Kay,,2017,5.1,18151,19130,979
40071,OK,Kay,,2018,4.5,17999,18842,843
40071,OK,Kay,,2019,4,17480,18216,736
40071,OK,Kay,,2020,6.7,17017,18245,1228
40071,OK,Kay,,2021,4.3,17622,18421,799
40073,OK,Kingfisher,,2007,2.6,8134,8347,213
40073,OK,Kingfisher,,2008,2.2,8316,8507,191
40073,OK,Kingfisher,,2009,4.6,7436,7791,355
40073,OK,Kingfisher,,2010,4.9,7016,7375,359
40073,OK,Kingfisher,,2011,3.7,7285,7564,279
40073,OK,Kingfisher,,2012,3.2,7422,7671,249
40073,OK,Kingfisher,,2013,3.4,7519,7780,261
40073,OK,Kingfisher,,2014,3,7724,7961,237
40073,OK,Kingfisher,,2015,3.1,8021,8275,254
40073,OK,Kingfisher,,2016,3.2,8174,8444,270
40073,OK,Kingfisher,,2017,2.6,8457,8685,228
40073,OK,Kingfisher,,2018,2,8714,8896,182
40073,OK,Kingfisher,,2019,2,8890,9067,177
40073,OK,Kingfisher,,2020,4.4,8336,8721,385
40073,OK,Kingfisher,,2021,2.6,8419,8647,228
40075,OK,Kiowa,,2007,4.3,3787,3956,169
40075,OK,Kiowa,,2008,3.6,3878,4024,146
40075,OK,Kiowa,,2009,6.4,3895,4160,265
40075,OK,Kiowa,,2010,5.8,4062,4312,250
40075,OK,Kiowa,,2011,4.9,4047,4255,208
40075,OK,Kiowa,,2012,4.6,4061,4255,194
40075,OK,Kiowa,,2013,4.7,3948,4144,196
40075,OK,Kiowa,,2014,3.9,3895,4054,159
40075,OK,Kiowa,,2015,4.5,3971,4160,189
40075,OK,Kiowa,,2016,5.1,3893,4104,211
40075,OK,Kiowa,,2017,5,3716,3911,195
40075,OK,Kiowa,,2018,4,3372,3512,140
40075,OK,Kiowa,,2019,3.5,3297,3418,121
40075,OK,Kiowa,,2020,5.1,3320,3499,179
40075,OK,Kiowa,,2021,3.3,3493,3614,121
40077,OK,Latimer,,2007,4.8,3998,4201,203
40077,OK,Latimer,,2008,4.1,4482,4676,194
40077,OK,Latimer,,2009,11,4009,4505,496
40077,OK,Latimer,,2010,9.7,4121,4562,441
40077,OK,Latimer,,2011,9.5,3994,4412,418
40077,OK,Latimer,,2012,8.2,4154,4526,372
40077,OK,Latimer,,2013,8.6,3778,4133,355
40077,OK,Latimer,,2014,7.1,3671,3953,282
40077,OK,Latimer,,2015,7.9,3550,3855,305
40077,OK,Latimer,,2016,8.3,3406,3716,310
40077,OK,Latimer,,2017,7.1,3137,3377,240
40077,OK,Latimer,,2018,5.7,3017,3201,184
40077,OK,Latimer,,2019,6,2924,3110,186
40077,OK,Latimer,,2020,10.3,2816,3138,322
40077,OK,Latimer,,2021,7.3,2861,3086,225
40079,OK,Le Flore,,2007,5.4,19995,21133,1138
40079,OK,Le Flore,,2008,5,19735,20780,1045
40079,OK,Le Flore,,2009,10.1,18799,20902,2103
40079,OK,Le Flore,,2010,9,18831,20690,1859
40079,OK,Le Flore,,2011,8.4,18338,20026,1688
40079,OK,Le Flore,,2012,8.3,18323,19991,1668
40079,OK,Le Flore,,2013,8.6,18013,19712,1699
40079,OK,Le Flore,,2014,6.6,18055,19341,1286
40079,OK,Le Flore,,2015,6.7,18285,19608,1323
40079,OK,Le Flore,,2016,6.7,18405,19720,1315
40079,OK,Le Flore,,2017,5.5,18204,19261,1057
40079,OK,Le Flore,,2018,4.4,18259,19105,846
40079,OK,Le Flore,,2019,4.5,18098,18943,845
40079,OK,Le Flore,,2020,7.1,17673,19023,1350
40079,OK,Le Flore,,2021,4.7,18340,19236,896
40081,OK,Lincoln,,2007,4.1,13317,13883,566
40081,OK,Lincoln,,2008,3.8,13264,13790,526
40081,OK,Lincoln,,2009,7.3,12899,13911,1012
40081,OK,Lincoln,,2010,6.3,14656,15636,980
40081,OK,Lincoln,,2011,5.2,14657,15458,801
40081,OK,Lincoln,,2012,4.8,14747,15493,746
40081,OK,Lincoln,,2013,5,14675,15446,771
40081,OK,Lincoln,,2014,4.4,14805,15482,677
40081,OK,Lincoln,,2015,4.6,15143,15865,722
40081,OK,Lincoln,,2016,5.1,15044,15857,813
40081,OK,Lincoln,,2017,4.1,15064,15710,646
40081,OK,Lincoln,,2018,3.4,15096,15630,534
40081,OK,Lincoln,,2019,3.4,15111,15640,529
40081,OK,Lincoln,,2020,5.7,14577,15458,881
40081,OK,Lincoln,,2021,3.5,15249,15810,561
40083,OK,Logan,,2007,3.7,16329,16962,633
40083,OK,Logan,,2008,3.5,17069,17679,610
40083,OK,Logan,,2009,5.8,17098,18155,1057
40083,OK,Logan,,2010,5.4,18711,19787,1076
40083,OK,Logan,,2011,4.6,19226,20160,934
40083,OK,Logan,,2012,4.2,19653,20523,870
40083,OK,Logan,,2013,4.4,19811,20725,914
40083,OK,Logan,,2014,3.9,20169,20982,813
40083,OK,Logan,,2015,3.7,20665,21461,796
40083,OK,Logan,,2016,3.9,20717,21559,842
40083,OK,Logan,,2017,3.5,20836,21589,753
40083,OK,Logan,,2018,2.9,21235,21874,639
40083,OK,Logan,,2019,2.7,21640,22248,608
40083,OK,Logan,,2020,5.2,21070,22227,1157
40083,OK,Logan,,2021,3.3,21997,22737,740
40085,OK,Love,,2007,3,4938,5091,153
40085,OK,Love,,2008,2.8,5149,5296,147
40085,OK,Love,,2009,5.3,5319,5618,299
40085,OK,Love,,2010,5.5,4507,4768,261
40085,OK,Love,,2011,4.8,4667,4902,235
40085,OK,Love,,2012,4.1,4883,5092,209
40085,OK,Love,,2013,4.2,5023,5245,222
40085,OK,Love,,2014,3.5,5243,5432,189
40085,OK,Love,,2015,3.5,5767,5974,207
40085,OK,Love,,2016,3,6368,6568,200
40085,OK,Love,,2017,2.8,6376,6561,185
40085,OK,Love,,2018,2.1,6278,6411,133
40085,OK,Love,,2019,2.2,6021,6154,133
40085,OK,Love,,2020,4.3,6218,6495,277
40085,OK,Love,,2021,2.6,5896,6054,158
40087,OK,McClain,,2007,3.7,14166,14710,544
40087,OK,McClain,,2008,3.5,14390,14908,518
40087,OK,McClain,,2009,5.9,14321,15212,891
40087,OK,McClain,,2010,5.4,16246,17165,919
40087,OK,McClain,,2011,4.5,16440,17213,773
40087,OK,McClain,,2012,4.1,16797,17508,711
40087,OK,McClain,,2013,4.2,17054,17809,755
40087,OK,McClain,,2014,3.6,17468,18113,645
40087,OK,McClain,,2015,3.6,18067,18746,679
40087,OK,McClain,,2016,4,18192,18944,752
40087,OK,McClain,,2017,3.3,18520,19161,641
40087,OK,McClain,,2018,2.7,18947,19466,519
40087,OK,McClain,,2019,2.6,19212,19725,513
40087,OK,McClain,,2020,5.6,18886,19999,1113
40087,OK,McClain,,2021,3.1,19754,20387,633
40089,OK,McCurtain,,2007,6.2,12962,13819,857
40089,OK,McCurtain,,2008,6.4,13173,14070,897
40089,OK,McCurtain,,2009,10.7,13231,14821,1590
40089,OK,McCurtain,,2010,11,12901,14495,1594
40089,OK,McCurtain,,2011,9.8,13245,14676,1431
40089,OK,McCurtain,,2012,9.2,13053,14380,1327
40089,OK,McCurtain,,2013,9.1,12995,14300,1305
40089,OK,McCurtain,,2014,7.8,13026,14131,1105
40089,OK,McCurtain,,2015,7.7,13575,14713,1138
40089,OK,McCurtain,,2016,6.9,13760,14780,1020
40089,OK,McCurtain,,2017,6,13808,14684,876
40089,OK,McCurtain,,2018,5.3,13343,14085,742
40089,OK,McCurtain,,2019,5.4,13575,14350,775
40089,OK,McCurtain,,2020,6.8,13932,14944,1012
40089,OK,McCurtain,,2021,4.4,14969,15662,693
40091,OK,McIntosh,,2007,5.3,8034,8480,446
40091,OK,McIntosh,,2008,4.6,8167,8561,394
40091,OK,McIntosh,,2009,8.2,8214,8944,730
40091,OK,McIntosh,,2010,10.5,6602,7378,776
40091,OK,McIntosh,,2011,10.1,6610,7355,745
40091,OK,McIntosh,,2012,9.9,6656,7385,729
40091,OK,McIntosh,,2013,9.5,6671,7375,704
40091,OK,McIntosh,,2014,8.9,6398,7024,626
40091,OK,McIntosh,,2015,8.4,6476,7072,596
40091,OK,McIntosh,,2016,8.6,6435,7042,607
40091,OK,McIntosh,,2017,7.3,6400,6905,505
40091,OK,McIntosh,,2018,5.7,6444,6831,387
40091,OK,McIntosh,,2019,5.5,6675,7067,392
40091,OK,McIntosh,,2020,8.6,6496,7105,609
40091,OK,McIntosh,,2021,6.1,6674,7106,432
40093,OK,Major,,2007,2.7,3855,3961,106
40093,OK,Major,,2008,2.2,4188,4284,96
40093,OK,Major,,2009,4.6,4145,4345,200
40093,OK,Major,,2010,4.8,3748,3938,190
40093,OK,Major,,2011,3.8,3889,4043,154
40093,OK,Major,,2012,3.4,3922,4060,138
40093,OK,Major,,2013,3.3,3992,4127,135
40093,OK,Major,,2014,2.5,4249,4358,109
40093,OK,Major,,2015,3.2,4159,4296,137
40093,OK,Major,,2016,4,3832,3991,159
40093,OK,Major,,2017,3,3886,4006,120
40093,OK,Major,,2018,2.1,3915,3997,82
40093,OK,Major,,2019,2.1,3771,3850,79
40093,OK,Major,,2020,4.8,3491,3668,177
40093,OK,Major,,2021,3.1,3565,3680,115
40095,OK,Marshall,,2007,4.2,6100,6368,268
40095,OK,Marshall,,2008,3.9,6285,6539,254
40095,OK,Marshall,,2009,8.4,6037,6588,551
40095,OK,Marshall,,2010,6.9,6051,6500,449
40095,OK,Marshall,,2011,5.7,6284,6665,381
40095,OK,Marshall,,2012,5.6,6402,6785,383
40095,OK,Marshall,,2013,5.6,6556,6945,389
40095,OK,Marshall,,2014,4.6,6607,6929,322
40095,OK,Marshall,,2015,5.3,6416,6777,361
40095,OK,Marshall,,2016,4.9,6285,6607,322
40095,OK,Marshall,,2017,4.4,6258,6547,289
40095,OK,Marshall,,2018,3.6,6479,6722,243
40095,OK,Marshall,,2019,3.3,6645,6873,228
40095,OK,Marshall,,2020,6.6,6356,6802,446
40095,OK,Marshall,,2021,3.7,6731,6987,256
40097,OK,Mayes,,2007,4.2,17461,18223,762
40097,OK,Mayes,,2008,4.1,17729,18479,750
40097,OK,Mayes,,2009,8.8,16943,18569,1626
40097,OK,Mayes,,2010,8.5,16540,18069,1529
40097,OK,Mayes,,2011,7.2,16766,18068,1302
40097,OK,Mayes,,2012,5.9,17310,18397,1087
40097,OK,Mayes,,2013,5.6,17768,18824,1056
40097,OK,Mayes,,2014,4.7,17880,18764,884
40097,OK,Mayes,,2015,4.2,18572,19389,817
40097,OK,Mayes,,2016,4.9,18464,19418,954
40097,OK,Mayes,,2017,4.5,18299,19155,856
40097,OK,Mayes,,2018,3.2,19113,19747,634
40097,OK,Mayes,,2019,3,18757,19329,572
40097,OK,Mayes,,2020,5.2,18247,19241,994
40097,OK,Mayes,,2021,3.7,18639,19364,725
40099,OK,Murray,,2007,2.8,7877,8101,224
40099,OK,Murray,,2008,2.6,8286,8503,217
40099,OK,Murray,,2009,4.3,8867,9270,403
40099,OK,Murray,,2010,5.9,5937,6312,375
40099,OK,Murray,,2011,4.7,6164,6467,303
40099,OK,Murray,,2012,4.5,6353,6651,298
40099,OK,Murray,,2013,4.9,6151,6466,315
40099,OK,Murray,,2014,4,6281,6546,265
40099,OK,Murray,,2015,4.1,6483,6762,279
40099,OK,Murray,,2016,4.4,6062,6338,276
40099,OK,Murray,,2017,3.5,6152,6376,224
40099,OK,Murray,,2018,2.8,6281,6462,181
40099,OK,Murray,,2019,2.9,6116,6296,180
40099,OK,Murray,,2020,6.3,5728,6110,382
40099,OK,Murray,,2021,3.9,5860,6097,237
40101,OK,Muskogee,,2007,5.3,27943,29521,1578
40101,OK,Muskogee,,2008,4.5,28273,29616,1343
40101,OK,Muskogee,,2009,7.8,28720,31138,2418
40101,OK,Muskogee,,2010,7.9,27450,29804,2354
40101,OK,Muskogee,,2011,7,27677,29772,2095
40101,OK,Muskogee,,2012,6.5,28023,29972,1949
40101,OK,Muskogee,,2013,6.3,27796,29658,1862
40101,OK,Muskogee,,2014,5.5,27650,29269,1619
40101,OK,Muskogee,,2015,5,28071,29552,1481
40101,OK,Muskogee,,2016,5.3,28033,29588,1555
40101,OK,Muskogee,,2017,4.8,28005,29421,1416
40101,OK,Muskogee,,2018,3.8,27988,29107,1119
40101,OK,Muskogee,,2019,3.7,28405,29490,1085
40101,OK,Muskogee,,2020,6.2,27213,28999,1786
40101,OK,Muskogee,,2021,4.3,27629,28881,1252
40103,OK,Noble,,2007,3.3,5730,5924,194
40103,OK,Noble,,2008,3.1,5562,5741,179
40103,OK,Noble,,2009,8,5454,5926,472
40103,OK,Noble,,2010,6.5,4901,5243,342
40103,OK,Noble,,2011,4.9,5066,5328,262
40103,OK,Noble,,2012,4.3,5237,5472,235
40103,OK,Noble,,2013,4.3,5233,5468,235
40103,OK,Noble,,2014,3.5,5342,5538,196
40103,OK,Noble,,2015,3.5,5442,5637,195
40103,OK,Noble,,2016,3.4,5560,5756,196
40103,OK,Noble,,2017,3.1,5559,5738,179
40103,OK,Noble,,2018,2.5,5565,5707,142
40103,OK,Noble,,2019,2.3,5516,5645,129
40103,OK,Noble,,2020,4.1,5225,5451,226
40103,OK,Noble,,2021,2.5,5423,5564,141
40105,OK,Nowata,,2007,4.8,4667,4903,236
40105,OK,Nowata,,2008,4.1,4804,5010,206
40105,OK,Nowata,,2009,9,4774,5244,470
40105,OK,Nowata,,2010,8.9,4456,4889,433
40105,OK,Nowata,,2011,7.6,4517,4886,369
40105,OK,Nowata,,2012,6.6,4570,4893,323
40105,OK,Nowata,,2013,6.6,4495,4811,316
40105,OK,Nowata,,2014,5.9,4469,4749,280
40105,OK,Nowata,,2015,5.6,4527,4794,267
40105,OK,Nowata,,2016,5.9,4404,4679,275
40105,OK,Nowata,,2017,5.1,4359,4595,236
40105,OK,Nowata,,2018,4,4418,4604,186
40105,OK,Nowata,,2019,3.3,4401,4549,148
40105,OK,Nowata,,2020,5.3,4343,4588,245
40105,OK,Nowata,,2021,3.5,4474,4637,163
40107,OK,Okfuskee,,2007,4.8,4432,4655,223
40107,OK,Okfuskee,,2008,4,4398,4581,183
40107,OK,Okfuskee,,2009,8.3,4419,4819,400
40107,OK,Okfuskee,,2010,9.4,3934,4341,407
40107,OK,Okfuskee,,2011,8.1,4041,4399,358
40107,OK,Okfuskee,,2012,7.4,4066,4391,325
40107,OK,Okfuskee,,2013,6.9,4111,4414,303
40107,OK,Okfuskee,,2014,5.8,4190,4449,259
40107,OK,Okfuskee,,2015,5.7,4278,4537,259
40107,OK,Okfuskee,,2016,5.9,4278,4545,267
40107,OK,Okfuskee,,2017,5.7,4186,4440,254
40107,OK,Okfuskee,,2018,4.5,4280,4484,204
40107,OK,Okfuskee,,2019,4.3,4387,4586,199
40107,OK,Okfuskee,,2020,6.8,4090,4388,298
40107,OK,Okfuskee,,2021,4.9,4210,4425,215
40109,OK,Oklahoma,,2007,4.3,308915,322760,13845
40109,OK,Oklahoma,,2008,3.8,310909,323063,12154
40109,OK,Oklahoma,,2009,6.3,306237,326787,20550
40109,OK,Oklahoma,,2010,5.9,332961,353861,20900
40109,OK,Oklahoma,,2011,5,338412,356348,17936
40109,OK,Oklahoma,,2012,4.6,347251,364140,16889
40109,OK,Oklahoma,,2013,4.7,350800,368083,17283
40109,OK,Oklahoma,,2014,4,354490,369434,14944
40109,OK,Oklahoma,,2015,3.8,360212,374610,14398
40109,OK,Oklahoma,,2016,4.1,359263,374767,15504
40109,OK,Oklahoma,,2017,3.8,362194,376406,14212
40109,OK,Oklahoma,,2018,3.2,368385,380478,12093
40109,OK,Oklahoma,,2019,3,372568,384056,11488
40109,OK,Oklahoma,,2020,6.5,358408,383293,24885
40109,OK,Oklahoma,,2021,4.1,373878,389697,15819
40111,OK,Okmulgee,,2007,5.4,15170,16028,858
40111,OK,Okmulgee,,2008,5,15093,15894,801
40111,OK,Okmulgee,,2009,9.3,14449,15935,1486
40111,OK,Okmulgee,,2010,9.4,15257,16839,1582
40111,OK,Okmulgee,,2011,8.6,15043,16460,1417
40111,OK,Okmulgee,,2012,7.7,15194,16459,1265
40111,OK,Okmulgee,,2013,7.3,15021,16212,1191
40111,OK,Okmulgee,,2014,6.6,14923,15972,1049
40111,OK,Okmulgee,,2015,6.5,15144,16197,1053
40111,OK,Okmulgee,,2016,6.9,15005,16123,1118
40111,OK,Okmulgee,,2017,6,14914,15863,949
40111,OK,Okmulgee,,2018,4.8,14829,15570,741
40111,OK,Okmulgee,,2019,4.7,14947,15679,732
40111,OK,Okmulgee,,2020,7.4,14185,15323,1138
40111,OK,Okmulgee,,2021,5.2,14660,15459,799
40113,OK,Osage,,2007,4.1,19302,20118,816
40113,OK,Osage,,2008,4,19228,20027,799
40113,OK,Osage,,2009,7.7,18197,19724,1527
40113,OK,Osage,,2010,7.4,19629,21202,1573
40113,OK,Osage,,2011,6.4,19822,21186,1364
40113,OK,Osage,,2012,5.7,20023,21225,1202
40113,OK,Osage,,2013,5.7,19889,21081,1192
40113,OK,Osage,,2014,5,19915,20954,1039
40113,OK,Osage,,2015,5.1,20111,21201,1090
40113,OK,Osage,,2016,5.6,19871,21040,1169
40113,OK,Osage,,2017,4.9,19658,20669,1011
40113,OK,Osage,,2018,4.1,19757,20606,849
40113,OK,Osage,,2019,3.6,19836,20577,741
40113,OK,Osage,,2020,6.6,18796,20130,1334
40113,OK,Osage,,2021,4.2,19410,20265,855
40115,OK,Ottawa,,2007,4.8,16098,16907,809
40115,OK,Ottawa,,2008,4,17053,17771,718
40115,OK,Ottawa,,2009,6.4,17522,18720,1198
40115,OK,Ottawa,,2010,7.8,13405,14533,1128
40115,OK,Ottawa,,2011,7.2,13233,14260,1027
40115,OK,Ottawa,,2012,7.6,13385,14490,1105
40115,OK,Ottawa,,2013,7.8,13008,14110,1102
40115,OK,Ottawa,,2014,6.5,12887,13786,899
40115,OK,Ottawa,,2015,5,13641,14359,718
40115,OK,Ottawa,,2016,4.9,13749,14450,701
40115,OK,Ottawa,,2017,4.1,13835,14429,594
40115,OK,Ottawa,,2018,3.3,13839,14315,476
40115,OK,Ottawa,,2019,3.2,13723,14173,450
40115,OK,Ottawa,,2020,5.8,13408,14226,818
40115,OK,Ottawa,,2021,3.2,13957,14418,461
40117,OK,Pawnee,,2007,4.4,7039,7362,323
40117,OK,Pawnee,,2008,4.3,6958,7270,312
40117,OK,Pawnee,,2009,8.8,6694,7339,645
40117,OK,Pawnee,,2010,8.8,6985,7656,671
40117,OK,Pawnee,,2011,7.4,7009,7571,562
40117,OK,Pawnee,,2012,6.4,6991,7467,476
40117,OK,Pawnee,,2013,5.9,6943,7377,434
40117,OK,Pawnee,,2014,5.1,6926,7300,374
40117,OK,Pawnee,,2015,5.7,7039,7464,425
40117,OK,Pawnee,,2016,6.4,6999,7478,479
40117,OK,Pawnee,,2017,5.1,6997,7370,373
40117,OK,Pawnee,,2018,4,7031,7322,291
40117,OK,Pawnee,,2019,3.7,7046,7320,274
40117,OK,Pawnee,,2020,6.7,6742,7223,481
40117,OK,Pawnee,,2021,4.1,6983,7283,300
40119,OK,Payne,,2007,3.6,36271,37621,1350
40119,OK,Payne,,2008,3.8,33634,34953,1319
40119,OK,Payne,,2009,6.3,33172,35392,2220
40119,OK,Payne,,2010,5.5,34808,36838,2030
40119,OK,Payne,,2011,4.7,34985,36728,1743
40119,OK,Payne,,2012,4.6,36030,37750,1720
40119,OK,Payne,,2013,4.3,35885,37496,1611
40119,OK,Payne,,2014,3.6,36984,38372,1388
40119,OK,Payne,,2015,3.4,37049,38368,1319
40119,OK,Payne,,2016,3.6,37488,38882,1394
40119,OK,Payne,,2017,3.4,37438,38748,1310
40119,OK,Payne,,2018,2.8,37445,38536,1091
40119,OK,Payne,,2019,2.7,36964,38003,1039
40119,OK,Payne,,2020,5.3,35533,37540,2007
40119,OK,Payne,,2021,3.2,36873,38102,1229
40121,OK,Pittsburg,,2007,3.7,21767,22615,848
40121,OK,Pittsburg,,2008,3.1,23053,23785,732
40121,OK,Pittsburg,,2009,6.3,22176,23679,1503
40121,OK,Pittsburg,,2010,7.8,17410,18892,1482
40121,OK,Pittsburg,,2011,7,17651,18979,1328
40121,OK,Pittsburg,,2012,6.8,17661,18948,1287
40121,OK,Pittsburg,,2013,7.1,16678,17951,1273
40121,OK,Pittsburg,,2014,5.9,16124,17141,1017
40121,OK,Pittsburg,,2015,5.6,16446,17414,968
40121,OK,Pittsburg,,2016,5.9,16561,17604,1043
40121,OK,Pittsburg,,2017,5,16804,17686,882
40121,OK,Pittsburg,,2018,3.7,17140,17800,660
40121,OK,Pittsburg,,2019,4,16438,17117,679
40121,OK,Pittsburg,,2020,7.7,15332,16610,1278
40121,OK,Pittsburg,,2021,5.2,15535,16392,857
40123,OK,Pontotoc,,2007,3.5,19282,19978,696
40123,OK,Pontotoc,,2008,3,19621,20234,613
40123,OK,Pontotoc,,2009,5.6,19710,20869,1159
40123,OK,Pontotoc,,2010,5.9,16661,17713,1052
40123,OK,Pontotoc,,2011,5.2,17140,18073,933
40123,OK,Pontotoc,,2012,4.9,17294,18190,896
40123,OK,Pontotoc,,2013,5.3,16800,17742,942
40123,OK,Pontotoc,,2014,4.2,17011,17753,742
40123,OK,Pontotoc,,2015,3.9,17524,18232,708
40123,OK,Pontotoc,,2016,3.9,17717,18442,725
40123,OK,Pontotoc,,2017,3.6,17856,18516,660
40123,OK,Pontotoc,,2018,3,18050,18601,551
40123,OK,Pontotoc,,2019,3,18323,18887,564
40123,OK,Pontotoc,,2020,5.2,18110,19111,1001
40123,OK,Pontotoc,,2021,3.3,18552,19191,639
40125,OK,Pottawatomie,,2007,4,31396,32716,1320
40125,OK,Pottawatomie,,2008,3.7,31679,32895,1216
40125,OK,Pottawatomie,,2009,6.5,31661,33857,2196
40125,OK,Pottawatomie,,2010,6.7,28886,30953,2067
40125,OK,Pottawatomie,,2011,5.7,29488,31266,1778
40125,OK,Pottawatomie,,2012,5.1,30271,31914,1643
40125,OK,Pottawatomie,,2013,5.3,30376,32074,1698
40125,OK,Pottawatomie,,2014,4.6,30633,32101,1468
40125,OK,Pottawatomie,,2015,4.4,31279,32715,1436
40125,OK,Pottawatomie,,2016,4.5,31553,33026,1473
40125,OK,Pottawatomie,,2017,3.9,31619,32906,1287
40125,OK,Pottawatomie,,2018,3.6,31313,32473,1160
40125,OK,Pottawatomie,,2019,3.4,31166,32274,1108
40125,OK,Pottawatomie,,2020,6.2,30179,32172,1993
40125,OK,Pottawatomie,,2021,3.9,31444,32707,1263
40127,OK,Pushmataha,,2007,4.8,4967,5216,249
40127,OK,Pushmataha,,2008,4.6,4992,5234,242
40127,OK,Pushmataha,,2009,8.5,5082,5556,474
40127,OK,Pushmataha,,2010,9.5,4502,4972,470
40127,OK,Pushmataha,,2011,8.3,4523,4932,409
40127,OK,Pushmataha,,2012,7,4500,4841,341
40127,OK,Pushmataha,,2013,8.7,4293,4700,407
40127,OK,Pushmataha,,2014,7.2,4350,4689,339
40127,OK,Pushmataha,,2015,7.6,4533,4906,373
40127,OK,Pushmataha,,2016,7,4523,4866,343
40127,OK,Pushmataha,,2017,5.9,4433,4710,277
40127,OK,Pushmataha,,2018,5,4255,4479,224
40127,OK,Pushmataha,,2019,4.7,4063,4263,200
40127,OK,Pushmataha,,2020,6.8,4143,4443,300
40127,OK,Pushmataha,,2021,4.2,4508,4708,200
40129,OK,Roger Mills,,2007,2.6,1817,1866,49
40129,OK,Roger Mills,,2008,2.2,1895,1938,43
40129,OK,Roger Mills,,2009,4.6,1858,1948,90
40129,OK,Roger Mills,,2010,4.4,1717,1796,79
40129,OK,Roger Mills,,2011,3.1,1841,1899,58
40129,OK,Roger Mills,,2012,2.8,2040,2098,58
40129,OK,Roger Mills,,2013,3.1,1819,1877,58
40129,OK,Roger Mills,,2014,2.7,1747,1796,49
40129,OK,Roger Mills,,2015,4.1,1761,1837,76
40129,OK,Roger Mills,,2016,5,1719,1809,90
40129,OK,Roger Mills,,2017,3.1,1818,1876,58
40129,OK,Roger Mills,,2018,2.3,1828,1871,43
40129,OK,Roger Mills,,2019,2.8,1796,1848,52
40129,OK,Roger Mills,,2020,5.1,1682,1773,91
40129,OK,Roger Mills,,2021,2.9,1750,1802,52
40131,OK,Rogers,,2007,3.7,38336,39805,1469
40131,OK,Rogers,,2008,3.4,38769,40118,1349
40131,OK,Rogers,,2009,7.1,37640,40526,2886
40131,OK,Rogers,,2010,6.6,40460,43313,2853
40131,OK,Rogers,,2011,5.5,40590,42932,2342
40131,OK,Rogers,,2012,4.8,41514,43618,2104
40131,OK,Rogers,,2013,4.9,41603,43768,2165
40131,OK,Rogers,,2014,4.1,41917,43691,1774
40131,OK,Rogers,,2015,4.3,42672,44578,1906
40131,OK,Rogers,,2016,4.8,42659,44828,2169
40131,OK,Rogers,,2017,4.2,42580,44430,1850
40131,OK,Rogers,,2018,3.2,43327,44746,1419
40131,OK,Rogers,,2019,2.9,43840,45157,1317
40131,OK,Rogers,,2020,5.9,41984,44609,2625
40131,OK,Rogers,,2021,3.5,43285,44863,1578
40133,OK,Seminole,,2007,5.3,9987,10545,558
40133,OK,Seminole,,2008,4.3,10522,10995,473
40133,OK,Seminole,,2009,8.8,10206,11195,989
40133,OK,Seminole,,2010,9.2,8987,9897,910
40133,OK,Seminole,,2011,7.9,9143,9930,787
40133,OK,Seminole,,2012,7.6,9189,9945,756
40133,OK,Seminole,,2013,7.9,8945,9716,771
40133,OK,Seminole,,2014,6.6,8922,9554,632
40133,OK,Seminole,,2015,6.7,8954,9592,638
40133,OK,Seminole,,2016,6.7,8795,9424,629
40133,OK,Seminole,,2017,5.4,8896,9404,508
40133,OK,Seminole,,2018,4.5,9031,9461,430
40133,OK,Seminole,,2019,4.6,8963,9392,429
40133,OK,Seminole,,2020,7.5,8479,9170,691
40133,OK,Seminole,,2021,5.1,8662,9125,463
40135,OK,Sequoyah,,2007,5.6,16865,17871,1006
40135,OK,Sequoyah,,2008,5.7,16620,17621,1001
40135,OK,Sequoyah,,2009,9.8,15950,17681,1731
40135,OK,Sequoyah,,2010,9.1,16387,18033,1646
40135,OK,Sequoyah,,2011,8.7,15870,17382,1512
40135,OK,Sequoyah,,2012,8.1,15756,17137,1381
40135,OK,Sequoyah,,2013,8.1,15457,16822,1365
40135,OK,Sequoyah,,2014,6.6,15558,16657,1099
40135,OK,Sequoyah,,2015,6.2,15718,16755,1037
40135,OK,Sequoyah,,2016,6,15799,16815,1016
40135,OK,Sequoyah,,2017,5.2,15652,16508,856
40135,OK,Sequoyah,,2018,4.1,15609,16284,675
40135,OK,Sequoyah,,2019,3.9,15650,16280,630
40135,OK,Sequoyah,,2020,6.9,15242,16378,1136
40135,OK,Sequoyah,,2021,4.3,15832,16550,718
40137,OK,Stephens,,2007,3.5,20767,21527,760
40137,OK,Stephens,,2008,3.3,21401,22133,732
40137,OK,Stephens,,2009,7.6,20569,22268,1699
40137,OK,Stephens,,2010,7.5,18446,19935,1489
40137,OK,Stephens,,2011,5.6,19212,20341,1129
40137,OK,Stephens,,2012,4.8,19516,20492,976
40137,OK,Stephens,,2013,5.2,19497,20577,1080
40137,OK,Stephens,,2014,4.3,19411,20286,875
40137,OK,Stephens,,2015,5.8,19071,20255,1184
40137,OK,Stephens,,2016,9.2,17232,18974,1742
40137,OK,Stephens,,2017,5.9,17048,18110,1062
40137,OK,Stephens,,2018,3.8,17757,18457,700
40137,OK,Stephens,,2019,4.1,17760,18515,755
40137,OK,Stephens,,2020,7.9,16974,18430,1456
40137,OK,Stephens,,2021,4.5,17907,18751,844
40139,OK,Texas,,2007,3.1,9077,9363,286
40139,OK,Texas,,2008,2.6,9471,9725,254
40139,OK,Texas,,2009,5.3,7297,7709,412
40139,OK,Texas,,2010,4.7,8193,8595,402
40139,OK,Texas,,2011,4.2,8447,8817,370
40139,OK,Texas,,2012,4,8589,8950,361
40139,OK,Texas,,2013,4.3,8884,9279,395
40139,OK,Texas,,2014,3.6,9010,9343,333
40139,OK,Texas,,2015,3.1,9384,9688,304
40139,OK,Texas,,2016,3.3,9089,9396,307
40139,OK,Texas,,2017,3,9060,9336,276
40139,OK,Texas,,2018,2.6,8762,8999,237
40139,OK,Texas,,2019,1.8,10970,11174,204
40139,OK,Texas,,2020,2.3,10982,11246,264
40139,OK,Texas,,2021,1.8,11202,11412,210
40141,OK,Tillman,,2007,4.5,3294,3450,156
40141,OK,Tillman,,2008,3.9,3372,3509,137
40141,OK,Tillman,,2009,7.2,3321,3579,258
40141,OK,Tillman,,2010,6,3199,3402,203
40141,OK,Tillman,,2011,5.6,3159,3345,186
40141,OK,Tillman,,2012,4.7,3240,3399,159
40141,OK,Tillman,,2013,5.2,3187,3363,176
40141,OK,Tillman,,2014,4.5,3145,3293,148
40141,OK,Tillman,,2015,4.2,3215,3355,140
40141,OK,Tillman,,2016,4.3,3167,3308,141
40141,OK,Tillman,,2017,4,3127,3257,130
40141,OK,Tillman,,2018,3.6,2978,3089,111
40141,OK,Tillman,,2019,3.5,2883,2988,105
40141,OK,Tillman,,2020,6.3,2827,3018,191
40141,OK,Tillman,,2021,4.2,2797,2921,124
40143,OK,Tulsa,,2007,3.7,280258,291123,10865
40143,OK,Tulsa,,2008,3.4,282707,292805,10098
40143,OK,Tulsa,,2009,6.7,274690,294494,19804
40143,OK,Tulsa,,2010,6.8,285527,306216,20689
40143,OK,Tulsa,,2011,5.7,285623,303026,17403
40143,OK,Tulsa,,2012,5,293070,308472,15402
40143,OK,Tulsa,,2013,4.9,295245,310617,15372
40143,OK,Tulsa,,2014,4.1,298511,311433,12922
40143,OK,Tulsa,,2015,4,304809,317640,12831
40143,OK,Tulsa,,2016,4.5,303589,317900,14311
40143,OK,Tulsa,,2017,4,305546,318416,12870
40143,OK,Tulsa,,2018,3.2,310559,320901,10342
40143,OK,Tulsa,,2019,3,313891,323628,9737
40143,OK,Tulsa,,2020,6.6,301019,322431,21412
40143,OK,Tulsa,,2021,4,310848,323923,13075
40145,OK,Wagoner,,2007,3.7,31311,32510,1199
40145,OK,Wagoner,,2008,3.5,32014,33161,1147
40145,OK,Wagoner,,2009,6.7,31227,33471,2244
40145,OK,Wagoner,,2010,6.5,32924,35217,2293
40145,OK,Wagoner,,2011,5.6,33066,35022,1956
40145,OK,Wagoner,,2012,5,34035,35835,1800
40145,OK,Wagoner,,2013,4.9,34115,35880,1765
40145,OK,Wagoner,,2014,4.1,34107,35567,1460
40145,OK,Wagoner,,2015,4.1,34737,36223,1486
40145,OK,Wagoner,,2016,4.6,34892,36576,1684
40145,OK,Wagoner,,2017,4.1,35378,36904,1526
40145,OK,Wagoner,,2018,3.2,36472,37672,1200
40145,OK,Wagoner,,2019,3,37224,38361,1137
40145,OK,Wagoner,,2020,5.9,36111,38363,2252
40145,OK,Wagoner,,2021,3.5,37279,38649,1370
40147,OK,Washington,,2007,3.3,25983,26882,899
40147,OK,Washington,,2008,2.9,26547,27346,799
40147,OK,Washington,,2009,5.6,26713,28308,1595
40147,OK,Washington,,2010,6.4,22554,24109,1555
40147,OK,Washington,,2011,5.5,22812,24130,1318
40147,OK,Washington,,2012,4.7,23339,24484,1145
40147,OK,Washington,,2013,4.7,23447,24598,1151
40147,OK,Washington,,2014,4.1,23447,24450,1003
40147,OK,Washington,,2015,4.2,23410,24436,1026
40147,OK,Washington,,2016,4.7,22779,23906,1127
40147,OK,Washington,,2017,4.3,22152,23140,988
40147,OK,Washington,,2018,3.7,21988,22844,856
40147,OK,Washington,,2019,3.2,21552,22275,723
40147,OK,Washington,,2020,5.9,20841,22159,1318
40147,OK,Washington,,2021,3.8,21609,22455,846
40149,OK,Washita,,2007,2.9,5774,5948,174
40149,OK,Washita,,2008,2.6,5965,6123,158
40149,OK,Washita,,2009,5.8,5957,6321,364
40149,OK,Washita,,2010,5.8,5134,5453,319
40149,OK,Washita,,2011,4.3,5264,5499,235
40149,OK,Washita,,2012,3.9,5409,5626,217
40149,OK,Washita,,2013,4.1,5343,5569,226
40149,OK,Washita,,2014,3.3,5416,5601,185
40149,OK,Washita,,2015,5.4,5297,5601,304
40149,OK,Washita,,2016,6.7,4956,5311,355
40149,OK,Washita,,2017,4.2,5126,5350,224
40149,OK,Washita,,2018,2.9,5103,5256,153
40149,OK,Washita,,2019,3.2,4980,5144,164
40149,OK,Washita,,2020,6.8,4735,5082,347
40149,OK,Washita,,2021,4.3,4749,4963,214
40151,OK,Woods,,2007,5.7,4161,4413,252
40151,OK,Woods,,2008,2.7,4214,4331,117
40151,OK,Woods,,2009,4.3,4382,4581,199
40151,OK,Woods,,2010,4.1,4113,4287,174
40151,OK,Woods,,2011,3.3,4335,4481,146
40151,OK,Woods,,2012,2.7,4918,5054,136
40151,OK,Woods,,2013,3.2,4975,5137,162
40151,OK,Woods,,2014,2.6,5151,5289,138
40151,OK,Woods,,2015,2.7,5222,5367,145
40151,OK,Woods,,2016,3.1,5055,5216,161
40151,OK,Woods,,2017,2.5,4787,4908,121
40151,OK,Woods,,2018,2.1,4535,4631,96
40151,OK,Woods,,2019,1.9,4492,4581,89
40151,OK,Woods,,2020,3.5,4421,4580,159
40151,OK,Woods,,2021,2.1,4634,4733,99
40153,OK,Woodward,,2007,2.6,11681,11987,306
40153,OK,Woodward,,2008,2.1,12302,12572,270
40153,OK,Woodward,,2009,6.4,10961,11707,746
40153,OK,Woodward,,2010,6.6,8723,9343,620
40153,OK,Woodward,,2011,4.4,9456,9895,439
40153,OK,Woodward,,2012,3.4,10191,10551,360
40153,OK,Woodward,,2013,3.4,10357,10726,369
40153,OK,Woodward,,2014,3,10441,10763,322
40153,OK,Woodward,,2015,5.1,9775,10295,520
40153,OK,Woodward,,2016,6,8933,9502,569
40153,OK,Woodward,,2017,3.9,9036,9404,368
40153,OK,Woodward,,2018,2.6,8995,9236,241
40153,OK,Woodward,,2019,2.7,8700,8946,246
40153,OK,Woodward,,2020,6.9,8271,8881,610
40153,OK,Woodward,,2021,4.2,8300,8665,365
41000,OR,Oregon,,2007,5.2,1812303,1910890,98587
41000,OR,Oregon,,2008,6.2,1825256,1946539,121283
41000,OR,Oregon,,2009,10.8,1755156,1968365,213209
41000,OR,Oregon,,2010,10.7,1778034,1991749,213715
41000,OR,Oregon,,2011,9.6,1804257,1995931,191674
41000,OR,Oregon,,2012,8.8,1791248,1964662,173414
41000,OR,Oregon,,2013,7.8,1775139,1924692,149553
41000,OR,Oregon,,2014,6.7,1820202,1950128,129926
41000,OR,Oregon,,2015,5.5,1871286,1979475,108189
41000,OR,Oregon,,2016,4.7,1946233,2042929,96696
41000,OR,Oregon,,2017,4.1,1991503,2075682,84179
41000,OR,Oregon,,2018,4,1996790,2080199,83409
41000,OR,Oregon,,2019,3.7,2017379,2094977,77598
41000,OR,Oregon,,2020,7.6,1944845,2104558,159713
41000,OR,Oregon,,2021,5.2,2036138,2148333,112195
41001,OR,Baker,,2007,5.8,6830,7250,420
41001,OR,Baker,,2008,6.8,6902,7407,505
41001,OR,Baker,,2009,10,6842,7599,757
41001,OR,Baker,,2010,10.3,6625,7389,764
41001,OR,Baker,,2011,11,6523,7326,803
41001,OR,Baker,,2012,10.5,6384,7136,752
41001,OR,Baker,,2013,9.5,6194,6846,652
41001,OR,Baker,,2014,8.2,6199,6752,553
41001,OR,Baker,,2015,6.6,6235,6675,440
41001,OR,Baker,,2016,6.2,6504,6933,429
41001,OR,Baker,,2017,5.4,6586,6960,374
41001,OR,Baker,,2018,5.2,6699,7066,367
41001,OR,Baker,,2019,4.5,6788,7110,322
41001,OR,Baker,,2020,7.2,6747,7269,522
41001,OR,Baker,,2021,5.1,7083,7467,384
41003,OR,Benton,,2007,4.1,40344,42085,1741
41003,OR,Benton,,2008,4.5,41029,42950,1921
41003,OR,Benton,,2009,7.6,40208,43534,3326
41003,OR,Benton,,2010,7.2,41990,45229,3239
41003,OR,Benton,,2011,6.5,43019,45986,2967
41003,OR,Benton,,2012,6,42512,45224,2712
41003,OR,Benton,,2013,5.6,41705,44197,2492
41003,OR,Benton,,2014,5,42410,44628,2218
41003,OR,Benton,,2015,4.1,43607,45479,1872
41003,OR,Benton,,2016,3.9,44891,46695,1804
41003,OR,Benton,,2017,3.2,46456,47990,1534
41003,OR,Benton,,2018,3.1,46370,47842,1472
41003,OR,Benton,,2019,3,46015,47425,1410
41003,OR,Benton,,2020,5.6,44036,46653,2617
41003,OR,Benton,,2021,3.9,45683,47556,1873
41005,OR,Clackamas,,2007,4.6,186359,195293,8934
41005,OR,Clackamas,,2008,5.4,188533,199400,10867
41005,OR,Clackamas,,2009,10,181400,201496,20096
41005,OR,Clackamas,,2010,10.1,182789,203414,20625
41005,OR,Clackamas,,2011,8.9,186042,204322,18280
41005,OR,Clackamas,,2012,8,185371,201578,16207
41005,OR,Clackamas,,2013,7,184482,198316,13834
41005,OR,Clackamas,,2014,6,189892,202082,12190
41005,OR,Clackamas,,2015,5,195069,205321,10252
41005,OR,Clackamas,,2016,4.3,203105,212188,9083
41005,OR,Clackamas,,2017,3.7,208169,216100,7931
41005,OR,Clackamas,,2018,3.6,208578,216445,7867
41005,OR,Clackamas,,2019,3.4,211061,218388,7327
41005,OR,Clackamas,,2020,7.2,202544,218357,15813
41005,OR,Clackamas,,2021,4.8,212018,222815,10797
41007,OR,Clatsop,,2007,4.7,18852,19777,925
41007,OR,Clatsop,,2008,5,19281,20297,1016
41007,OR,Clatsop,,2009,8.8,18847,20659,1812
41007,OR,Clatsop,,2010,10.1,17222,19149,1927
41007,OR,Clatsop,,2011,9.5,17242,19057,1815
41007,OR,Clatsop,,2012,8.7,17017,18647,1630
41007,OR,Clatsop,,2013,7.7,16608,17991,1383
41007,OR,Clatsop,,2014,6.5,16956,18130,1174
41007,OR,Clatsop,,2015,5.3,17385,18363,978
41007,OR,Clatsop,,2016,4.6,18097,18975,878
41007,OR,Clatsop,,2017,4,18325,19096,771
41007,OR,Clatsop,,2018,4,18354,19112,758
41007,OR,Clatsop,,2019,3.7,18586,19302,716
41007,OR,Clatsop,,2020,9.5,17441,19269,1828
41007,OR,Clatsop,,2021,6,18284,19452,1168
41009,OR,Columbia,,2007,5.7,22263,23611,1348
41009,OR,Columbia,,2008,6.8,22454,24088,1634
41009,OR,Columbia,,2009,12.8,21372,24514,3142
41009,OR,Columbia,,2010,13,20657,23744,3087
41009,OR,Columbia,,2011,11.4,20905,23600,2695
41009,OR,Columbia,,2012,10.7,20584,23053,2469
41009,OR,Columbia,,2013,9.5,20320,22456,2136
41009,OR,Columbia,,2014,8.3,20649,22510,1861
41009,OR,Columbia,,2015,7,21104,22688,1584
41009,OR,Columbia,,2016,6,22143,23557,1414
41009,OR,Columbia,,2017,5.1,22876,24094,1218
41009,OR,Columbia,,2018,4.9,22943,24124,1181
41009,OR,Columbia,,2019,4.4,23118,24192,1074
41009,OR,Columbia,,2020,7.9,22221,24130,1909
41009,OR,Columbia,,2021,5.8,23222,24640,1418
41011,OR,Coos,,2007,6.6,26213,28059,1846
41011,OR,Coos,,2008,7.9,25742,27955,2213
41011,OR,Coos,,2009,12.5,24871,28431,3560
41011,OR,Coos,,2010,12.8,24282,27851,3569
41011,OR,Coos,,2011,11.7,24725,28003,3278
41011,OR,Coos,,2012,11.1,24232,27251,3019
41011,OR,Coos,,2013,10.1,23839,26520,2681
41011,OR,Coos,,2014,8.8,23898,26205,2307
41011,OR,Coos,,2015,7.3,24071,25953,1882
41011,OR,Coos,,2016,6.3,24713,26370,1657
41011,OR,Coos,,2017,5.4,24866,26288,1422
41011,OR,Coos,,2018,5.2,24666,26028,1362
41011,OR,Coos,,2019,4.8,24865,26116,1251
41011,OR,Coos,,2020,8.6,24285,26580,2295
41011,OR,Coos,,2021,6.3,25337,27033,1696
41013,OR,Crook,,2007,6.2,9131,9735,604
41013,OR,Crook,,2008,9.5,8816,9740,924
41013,OR,Crook,,2009,17.5,7819,9478,1659
41013,OR,Crook,,2010,16.1,8078,9623,1545
41013,OR,Crook,,2011,14.4,8101,9465,1364
41013,OR,Crook,,2012,13.5,8022,9278,1256
41013,OR,Crook,,2013,12,7896,8968,1072
41013,OR,Crook,,2014,9.6,8190,9063,873
41013,OR,Crook,,2015,8.2,8285,9021,736
41013,OR,Crook,,2016,6.8,8682,9316,634
41013,OR,Crook,,2017,6.2,8771,9355,584
41013,OR,Crook,,2018,5.8,8884,9430,546
41013,OR,Crook,,2019,5.1,9305,9807,502
41013,OR,Crook,,2020,8.8,9454,10369,915
41013,OR,Crook,,2021,6.7,10205,10941,736
41015,OR,Curry,,2007,6.5,8837,9455,618
41015,OR,Curry,,2008,7.7,8736,9468,732
41015,OR,Curry,,2009,12.7,8240,9436,1196
41015,OR,Curry,,2010,12.7,8232,9432,1200
41015,OR,Curry,,2011,12.1,8105,9225,1120
41015,OR,Curry,,2012,11.8,7944,9003,1059
41015,OR,Curry,,2013,10.5,7787,8699,912
41015,OR,Curry,,2014,9.9,7809,8671,862
41015,OR,Curry,,2015,8,8011,8712,701
41015,OR,Curry,,2016,6.6,8421,9019,598
41015,OR,Curry,,2017,6,8374,8906,532
41015,OR,Curry,,2018,5.9,8355,8878,523
41015,OR,Curry,,2019,5.1,8403,8856,453
41015,OR,Curry,,2020,8.7,8183,8961,778
41015,OR,Curry,,2021,6.7,8546,9158,612
41017,OR,Deschutes,,2007,5,77178,81208,4030
41017,OR,Deschutes,,2008,7.8,74972,81331,6359
41017,OR,Deschutes,,2009,14.3,69626,81274,11648
41017,OR,Deschutes,,2010,13.9,70190,81567,11377
41017,OR,Deschutes,,2011,12.4,70653,80665,10012
41017,OR,Deschutes,,2012,11.2,70282,79176,8894
41017,OR,Deschutes,,2013,9.4,71376,78781,7405
41017,OR,Deschutes,,2014,7.6,75321,81509,6188
41017,OR,Deschutes,,2015,5.7,79935,84796,4861
41017,OR,Deschutes,,2016,4.8,85369,89650,4281
41017,OR,Deschutes,,2017,4.2,88783,92645,3862
41017,OR,Deschutes,,2018,4.1,90460,94324,3864
41017,OR,Deschutes,,2019,3.9,92211,95926,3715
41017,OR,Deschutes,,2020,8,90396,98204,7808
41017,OR,Deschutes,,2021,5.3,97124,102553,5429
41019,OR,Douglas,,2007,7.7,43171,46768,3597
41019,OR,Douglas,,2008,9.5,41886,46269,4383
41019,OR,Douglas,,2009,15.1,39797,46866,7069
41019,OR,Douglas,,2010,14.1,41299,48075,6776
41019,OR,Douglas,,2011,12.8,41451,47551,6100
41019,OR,Douglas,,2012,11.9,40478,45963,5485
41019,OR,Douglas,,2013,10.4,39796,44427,4631
41019,OR,Douglas,,2014,9,40313,44297,3984
41019,OR,Douglas,,2015,7.3,41128,44376,3248
41019,OR,Douglas,,2016,6.2,42770,45583,2813
41019,OR,Douglas,,2017,5.3,43500,45913,2413
41019,OR,Douglas,,2018,5.2,43716,46112,2396
41019,OR,Douglas,,2019,4.8,44200,46437,2237
41019,OR,Douglas,,2020,7.7,43658,47323,3665
41019,OR,Douglas,,2021,5.8,45073,47860,2787
41021,OR,Gilliam,,2007,4.5,993,1040,47
41021,OR,Gilliam,,2008,4.2,1147,1197,50
41021,OR,Gilliam,,2009,6.6,1143,1224,81
41021,OR,Gilliam,,2010,9.1,875,963,88
41021,OR,Gilliam,,2011,9.8,879,974,95
41021,OR,Gilliam,,2012,10.1,847,942,95
41021,OR,Gilliam,,2013,9.5,775,856,81
41021,OR,Gilliam,,2014,7.8,764,829,65
41021,OR,Gilliam,,2015,6.3,759,810,51
41021,OR,Gilliam,,2016,5.9,787,836,49
41021,OR,Gilliam,,2017,4.2,814,850,36
41021,OR,Gilliam,,2018,3.8,819,851,32
41021,OR,Gilliam,,2019,3.6,908,942,34
41021,OR,Gilliam,,2020,6.3,930,992,62
41021,OR,Gilliam,,2021,4.8,895,940,45
41023,OR,Grant,,2007,8,3142,3416,274
41023,OR,Grant,,2008,10.1,3018,3358,340
41023,OR,Grant,,2009,13.1,2991,3443,452
41023,OR,Grant,,2010,13.8,2941,3411,470
41023,OR,Grant,,2011,13.9,2949,3426,477
41023,OR,Grant,,2012,14,2860,3324,464
41023,OR,Grant,,2013,12.2,2817,3209,392
41023,OR,Grant,,2014,10.3,2827,3152,325
41023,OR,Grant,,2015,8.5,2828,3090,262
41023,OR,Grant,,2016,7.5,2866,3098,232
41023,OR,Grant,,2017,6.8,2900,3110,210
41023,OR,Grant,,2018,6.8,2899,3112,213
41023,OR,Grant,,2019,6.8,2961,3176,215
41023,OR,Grant,,2020,8.4,2933,3201,268
41023,OR,Grant,,2021,6.7,3030,3247,217
41025,OR,Harney,,2007,7.3,3058,3299,241
41025,OR,Harney,,2008,9.1,3028,3331,303
41025,OR,Harney,,2009,15.7,2962,3514,552
41025,OR,Harney,,2010,14.3,3299,3851,552
41025,OR,Harney,,2011,13.4,3230,3731,501
41025,OR,Harney,,2012,11.8,3120,3536,416
41025,OR,Harney,,2013,11.4,2964,3346,382
41025,OR,Harney,,2014,9.4,2987,3298,311
41025,OR,Harney,,2015,7,3074,3305,231
41025,OR,Harney,,2016,6.1,3204,3413,209
41025,OR,Harney,,2017,6.2,3178,3387,209
41025,OR,Harney,,2018,5.8,3303,3508,205
41025,OR,Harney,,2019,5.2,3379,3564,185
41025,OR,Harney,,2020,5.9,3420,3635,215
41025,OR,Harney,,2021,5.1,3568,3761,193
41027,OR,Hood River,,2007,4.5,12231,12809,578
41027,OR,Hood River,,2008,5.1,12622,13305,683
41027,OR,Hood River,,2009,7.8,12827,13918,1091
41027,OR,Hood River,,2010,8.3,13058,14246,1188
41027,OR,Hood River,,2011,8,13194,14343,1149
41027,OR,Hood River,,2012,7.2,13097,14119,1022
41027,OR,Hood River,,2013,6.2,12967,13831,864
41027,OR,Hood River,,2014,5.3,13077,13816,739
41027,OR,Hood River,,2015,4.6,12914,13537,623
41027,OR,Hood River,,2016,4.1,13312,13877,565
41027,OR,Hood River,,2017,3.5,13753,14255,502
41027,OR,Hood River,,2018,3.2,13902,14364,462
41027,OR,Hood River,,2019,3.1,13940,14389,449
41027,OR,Hood River,,2020,6.3,13215,14100,885
41027,OR,Hood River,,2021,4.5,13758,14410,652
41029,OR,Jackson,,2007,5.6,95200,100900,5700
41029,OR,Jackson,,2008,7.6,93717,101393,7676
41029,OR,Jackson,,2009,12.3,89274,101808,12534
41029,OR,Jackson,,2010,12.6,88638,101368,12730
41029,OR,Jackson,,2011,11.8,88691,100599,11908
41029,OR,Jackson,,2012,11.1,87981,98945,10964
41029,OR,Jackson,,2013,9.6,87325,96623,9298
41029,OR,Jackson,,2014,8.3,89199,97220,8021
41029,OR,Jackson,,2015,6.6,91580,98070,6490
41029,OR,Jackson,,2016,5.6,95428,101140,5712
41029,OR,Jackson,,2017,4.7,97799,102582,4783
41029,OR,Jackson,,2018,4.6,98641,103422,4781
41029,OR,Jackson,,2019,4.3,98989,103412,4423
41029,OR,Jackson,,2020,7.8,96906,105118,8212
41029,OR,Jackson,,2021,5.4,101863,107706,5843
41031,OR,Jefferson,,2007,6.8,8612,9236,624
41031,OR,Jefferson,,2008,9.6,8402,9296,894
41031,OR,Jefferson,,2009,14.4,7952,9295,1343
41031,OR,Jefferson,,2010,13.8,8337,9668,1331
41031,OR,Jefferson,,2011,12.9,8375,9612,1237
41031,OR,Jefferson,,2012,11.8,8506,9642,1136
41031,OR,Jefferson,,2013,10.3,8322,9279,957
41031,OR,Jefferson,,2014,8.7,8615,9440,825
41031,OR,Jefferson,,2015,7.1,8957,9646,689
41031,OR,Jefferson,,2016,6.5,9195,9833,638
41031,OR,Jefferson,,2017,5.5,9362,9908,546
41031,OR,Jefferson,,2018,5.3,9561,10094,533
41031,OR,Jefferson,,2019,5,9612,10117,505
41031,OR,Jefferson,,2020,8.2,9470,10321,851
41031,OR,Jefferson,,2021,6.5,9782,10459,677
41033,OR,Josephine,,2007,7.1,32219,34666,2447
41033,OR,Josephine,,2008,8.8,31732,34791,3059
41033,OR,Josephine,,2009,13.9,30234,35133,4899
41033,OR,Josephine,,2010,14.1,29735,34633,4898
41033,OR,Josephine,,2011,12.8,30132,34537,4405
41033,OR,Josephine,,2012,12.1,29471,33545,4074
41033,OR,Josephine,,2013,10.9,28878,32423,3545
41033,OR,Josephine,,2014,9.2,29919,32953,3034
41033,OR,Josephine,,2015,7.5,30766,33275,2509
41033,OR,Josephine,,2016,6.4,32019,34195,2176
41033,OR,Josephine,,2017,5.3,33100,34943,1843
41033,OR,Josephine,,2018,5.4,33435,35335,1900
41033,OR,Josephine,,2019,4.9,33926,35672,1746
41033,OR,Josephine,,2020,7.9,33262,36117,2855
41033,OR,Josephine,,2021,6.2,34710,36990,2280
41035,OR,Klamath,,2007,6.9,28294,30398,2104
41035,OR,Klamath,,2008,8.8,28003,30692,2689
41035,OR,Klamath,,2009,13.6,26870,31091,4221
41035,OR,Klamath,,2010,13,27262,31345,4083
41035,OR,Klamath,,2011,12.1,27532,31331,3799
41035,OR,Klamath,,2012,11.7,26620,30148,3528
41035,OR,Klamath,,2013,10.6,25957,29047,3090
41035,OR,Klamath,,2014,9.2,26117,28755,2638
41035,OR,Klamath,,2015,7.6,26481,28664,2183
41035,OR,Klamath,,2016,6.6,27206,29144,1938
41035,OR,Klamath,,2017,5.8,27644,29352,1708
41035,OR,Klamath,,2018,6.2,27507,29313,1806
41035,OR,Klamath,,2019,6,27554,29328,1774
41035,OR,Klamath,,2020,8.7,26952,29519,2567
41035,OR,Klamath,,2021,6.7,27762,29770,2008
41037,OR,Lake,,2007,7.3,3355,3618,263
41037,OR,Lake,,2008,8.3,3271,3566,295
41037,OR,Lake,,2009,12.1,3226,3672,446
41037,OR,Lake,,2010,13.6,3228,3735,507
41037,OR,Lake,,2011,13.3,3260,3758,498
41037,OR,Lake,,2012,12.9,3175,3647,472
41037,OR,Lake,,2013,11.2,3099,3490,391
41037,OR,Lake,,2014,9.4,3181,3512,331
41037,OR,Lake,,2015,7.5,3179,3436,257
41037,OR,Lake,,2016,6.2,3228,3443,215
41037,OR,Lake,,2017,5.6,3291,3486,195
41037,OR,Lake,,2018,5.4,3358,3551,193
41037,OR,Lake,,2019,5.3,3414,3606,192
41037,OR,Lake,,2020,5.6,3450,3656,206
41037,OR,Lake,,2021,5.5,3517,3721,204
41039,OR,Lane,,2007,5.2,171075,180440,9365
41039,OR,Lane,,2008,6.4,171294,183059,11765
41039,OR,Lane,,2009,11.8,161388,183031,21643
41039,OR,Lane,,2010,11.1,159101,178988,19887
41039,OR,Lane,,2011,9.8,160310,177663,17353
41039,OR,Lane,,2012,8.9,157828,173244,15416
41039,OR,Lane,,2013,7.9,155425,168771,13346
41039,OR,Lane,,2014,6.8,158772,170318,11546
41039,OR,Lane,,2015,5.7,162845,172635,9790
41039,OR,Lane,,2016,5,169145,178047,8902
41039,OR,Lane,,2017,4.4,172433,180311,7878
41039,OR,Lane,,2018,4.3,172070,179863,7793
41039,OR,Lane,,2019,4,172839,180022,7183
41039,OR,Lane,,2020,7.9,165033,179141,14108
41039,OR,Lane,,2021,5.5,172142,182197,10055
41041,OR,Lincoln,,2007,5.5,21150,22382,1232
41041,OR,Lincoln,,2008,6.3,21314,22748,1434
41041,OR,Lincoln,,2009,10.2,20803,23162,2359
41041,OR,Lincoln,,2010,11.1,19734,22207,2473
41041,OR,Lincoln,,2011,10.5,19649,21966,2317
41041,OR,Lincoln,,2012,9.9,19338,21465,2127
41041,OR,Lincoln,,2013,8.7,18950,20755,1805
41041,OR,Lincoln,,2014,7.7,19082,20670,1588
41041,OR,Lincoln,,2015,6.5,19197,20529,1332
41041,OR,Lincoln,,2016,5.5,19695,20843,1148
41041,OR,Lincoln,,2017,4.7,19974,20957,983
41041,OR,Lincoln,,2018,4.7,19901,20885,984
41041,OR,Lincoln,,2019,4.3,19871,20759,888
41041,OR,Lincoln,,2020,10.8,18505,20757,2252
41041,OR,Lincoln,,2021,6.8,19680,21119,1439
41043,OR,Linn,,2007,6.3,49979,53351,3372
41043,OR,Linn,,2008,7.4,50878,54956,4078
41043,OR,Linn,,2009,13.4,48392,55894,7502
41043,OR,Linn,,2010,12.9,49890,57300,7410
41043,OR,Linn,,2011,11.5,50195,56710,6515
41043,OR,Linn,,2012,10.7,49637,55605,5968
41043,OR,Linn,,2013,9.5,48763,53908,5145
41043,OR,Linn,,2014,8,50071,54407,4336
41043,OR,Linn,,2015,6.6,51589,55211,3622
41043,OR,Linn,,2016,5.6,53505,56682,3177
41043,OR,Linn,,2017,4.7,54752,57436,2684
41043,OR,Linn,,2018,4.6,55623,58285,2662
41043,OR,Linn,,2019,4.3,56004,58507,2503
41043,OR,Linn,,2020,7.7,54551,59127,4576
41043,OR,Linn,,2021,5.6,57235,60636,3401
41045,OR,Malheur,,2007,5.6,11934,12647,713
41045,OR,Malheur,,2008,7.2,11787,12699,912
41045,OR,Malheur,,2009,10.5,11731,13103,1372
41045,OR,Malheur,,2010,9.7,12206,13521,1315
41045,OR,Malheur,,2011,9.5,12111,13385,1274
41045,OR,Malheur,,2012,9.4,11692,12899,1207
41045,OR,Malheur,,2013,8.4,11379,12419,1040
41045,OR,Malheur,,2014,7.8,11164,12107,943
41045,OR,Malheur,,2015,6.2,11218,11960,742
41045,OR,Malheur,,2016,5.4,11771,12445,674
41045,OR,Malheur,,2017,4.6,11896,12466,570
41045,OR,Malheur,,2018,4.4,11791,12339,548
41045,OR,Malheur,,2019,4,11772,12268,496
41045,OR,Malheur,,2020,5.2,11918,12578,660
41045,OR,Malheur,,2021,4.4,12163,12717,554
41047,OR,Marion,,2007,5.4,142759,150907,8148
41047,OR,Marion,,2008,6.3,144909,154692,9783
41047,OR,Marion,,2009,10.7,140618,157453,16835
41047,OR,Marion,,2010,11.2,138412,155893,17481
41047,OR,Marion,,2011,10.6,138373,154728,16355
41047,OR,Marion,,2012,10,136344,151415,15071
41047,OR,Marion,,2013,8.7,135439,148377,12938
41047,OR,Marion,,2014,7.2,139301,150144,10843
41047,OR,Marion,,2015,5.9,143774,152715,8941
41047,OR,Marion,,2016,5,149200,157013,7813
41047,OR,Marion,,2017,4.3,152304,159089,6785
41047,OR,Marion,,2018,4.2,153093,159745,6652
41047,OR,Marion,,2019,3.9,155206,161459,6253
41047,OR,Marion,,2020,7,151236,162560,11324
41047,OR,Marion,,2021,5.1,158910,167425,8515
41049,OR,Morrow,,2007,5.5,5007,5296,289
41049,OR,Morrow,,2008,6.1,5094,5424,330
41049,OR,Morrow,,2009,9,5267,5786,519
41049,OR,Morrow,,2010,9.4,5208,5748,540
41049,OR,Morrow,,2011,8.3,5316,5798,482
41049,OR,Morrow,,2012,8.1,5216,5675,459
41049,OR,Morrow,,2013,7.6,5148,5571,423
41049,OR,Morrow,,2014,6.8,5137,5510,373
41049,OR,Morrow,,2015,5.6,5235,5545,310
41049,OR,Morrow,,2016,4.8,5478,5753,275
41049,OR,Morrow,,2017,4.4,5471,5720,249
41049,OR,Morrow,,2018,4.2,5453,5690,237
41049,OR,Morrow,,2019,4.1,5510,5743,233
41049,OR,Morrow,,2020,5.1,5473,5770,297
41049,OR,Morrow,,2021,4.6,5694,5966,272
41051,OR,Multnomah,,2007,4.9,358612,377019,18407
41051,OR,Multnomah,,2008,5.6,365102,386798,21696
41051,OR,Multnomah,,2009,10.1,352178,391875,39697
41051,OR,Multnomah,,2010,9.8,379568,420658,41090
41051,OR,Multnomah,,2011,8.5,389284,425218,35934
41051,OR,Multnomah,,2012,7.6,389862,421947,32085
41051,OR,Multnomah,,2013,6.7,387011,414728,27717
41051,OR,Multnomah,,2014,5.8,397764,422171,24407
41051,OR,Multnomah,,2015,4.8,409444,430032,20588
41051,OR,Multnomah,,2016,4.2,424464,442861,18397
41051,OR,Multnomah,,2017,3.6,434508,450620,16112
41051,OR,Multnomah,,2018,3.6,432846,448867,16021
41051,OR,Multnomah,,2019,3.2,436702,451347,14645
41051,OR,Multnomah,,2020,8.6,416679,456024,39345
41051,OR,Multnomah,,2021,5.6,436295,461936,25641
41053,OR,Polk,,2007,4.9,36368,38251,1883
41053,OR,Polk,,2008,5.4,37423,39552,2129
41053,OR,Polk,,2009,9.1,36419,40062,3643
41053,OR,Polk,,2010,9.8,32940,36523,3583
41053,OR,Polk,,2011,9.4,32928,36331,3403
41053,OR,Polk,,2012,8.9,32281,35430,3149
41053,OR,Polk,,2013,8,32158,34944,2786
41053,OR,Polk,,2014,6.7,33335,35729,2394
41053,OR,Polk,,2015,5.5,34598,36607,2009
41053,OR,Polk,,2016,5,36337,38236,1899
41053,OR,Polk,,2017,4.3,37397,39063,1666
41053,OR,Polk,,2018,4.2,37694,39358,1664
41053,OR,Polk,,2019,4,38420,40018,1598
41053,OR,Polk,,2020,6.5,37994,40644,2650
41053,OR,Polk,,2021,4.8,39974,42006,2032
41055,OR,Sherman,,2007,4.9,880,925,45
41055,OR,Sherman,,2008,5.6,916,970,54
41055,OR,Sherman,,2009,8.8,955,1047,92
41055,OR,Sherman,,2010,11.9,801,909,108
41055,OR,Sherman,,2011,11.2,818,921,103
41055,OR,Sherman,,2012,10.8,804,901,97
41055,OR,Sherman,,2013,9.2,791,871,80
41055,OR,Sherman,,2014,7.3,821,886,65
41055,OR,Sherman,,2015,6,835,888,53
41055,OR,Sherman,,2016,4.5,852,892,40
41055,OR,Sherman,,2017,4.7,851,893,42
41055,OR,Sherman,,2018,3.9,857,892,35
41055,OR,Sherman,,2019,3.5,893,925,32
41055,OR,Sherman,,2020,6.2,916,977,61
41055,OR,Sherman,,2021,4.3,922,963,41
41057,OR,Tillamook,,2007,4.9,11753,12362,609
41057,OR,Tillamook,,2008,5.2,11897,12555,658
41057,OR,Tillamook,,2009,9.2,11649,12826,1177
41057,OR,Tillamook,,2010,10.5,10568,11814,1246
41057,OR,Tillamook,,2011,10,10492,11661,1169
41057,OR,Tillamook,,2012,9.7,10144,11232,1088
41057,OR,Tillamook,,2013,8.3,10094,11002,908
41057,OR,Tillamook,,2014,6.8,10470,11231,761
41057,OR,Tillamook,,2015,5.5,10771,11396,625
41057,OR,Tillamook,,2016,4.8,11051,11612,561
41057,OR,Tillamook,,2017,4.2,11186,11674,488
41057,OR,Tillamook,,2018,4.2,11255,11754,499
41057,OR,Tillamook,,2019,3.8,11399,11852,453
41057,OR,Tillamook,,2020,8,10910,11862,952
41057,OR,Tillamook,,2021,5.5,11469,12137,668
41059,OR,Umatilla,,2007,5.8,34322,36435,2113
41059,OR,Umatilla,,2008,6.3,35125,37474,2349
41059,OR,Umatilla,,2009,9.4,34991,38603,3612
41059,OR,Umatilla,,2010,10.4,33008,36828,3820
41059,OR,Umatilla,,2011,9.6,33817,37422,3605
41059,OR,Umatilla,,2012,9.1,33549,36889,3340
41059,OR,Umatilla,,2013,8.7,32378,35468,3090
41059,OR,Umatilla,,2014,7.6,32788,35488,2700
41059,OR,Umatilla,,2015,6.2,33075,35260,2185
41059,OR,Umatilla,,2016,5.2,34040,35921,1881
41059,OR,Umatilla,,2017,4.7,34736,36464,1728
41059,OR,Umatilla,,2018,4.8,34509,36240,1731
41059,OR,Umatilla,,2019,4.7,34857,36592,1735
41059,OR,Umatilla,,2020,6.8,34480,36986,2506
41059,OR,Umatilla,,2021,5.2,35718,37687,1969
41061,OR,Union,,2007,5.5,11496,12165,669
41061,OR,Union,,2008,7.7,11309,12256,947
41061,OR,Union,,2009,11.2,11176,12579,1403
41061,OR,Union,,2010,10.4,11228,12534,1306
41061,OR,Union,,2011,10.1,11215,12471,1256
41061,OR,Union,,2012,9.4,11125,12281,1156
41061,OR,Union,,2013,8.3,10835,11819,984
41061,OR,Union,,2014,7.1,10829,11659,830
41061,OR,Union,,2015,6,11005,11708,703
41061,OR,Union,,2016,5.8,11252,11944,692
41061,OR,Union,,2017,5.2,11278,11894,616
41061,OR,Union,,2018,5.2,11238,11855,617
41061,OR,Union,,2019,4.8,11384,11952,568
41061,OR,Union,,2020,7.8,11072,12014,942
41061,OR,Union,,2021,5.6,11542,12222,680
41063,OR,Wallowa,,2007,6.1,3407,3627,220
41063,OR,Wallowa,,2008,7.3,3389,3654,265
41063,OR,Wallowa,,2009,11.6,3312,3745,433
41063,OR,Wallowa,,2010,13,3062,3518,456
41063,OR,Wallowa,,2011,12.3,3061,3492,431
41063,OR,Wallowa,,2012,11.5,2983,3369,386
41063,OR,Wallowa,,2013,11,2887,3243,356
41063,OR,Wallowa,,2014,9.8,2909,3225,316
41063,OR,Wallowa,,2015,7.6,2996,3242,246
41063,OR,Wallowa,,2016,6.6,3087,3305,218
41063,OR,Wallowa,,2017,5.5,3112,3294,182
41063,OR,Wallowa,,2018,5.8,3179,3375,196
41063,OR,Wallowa,,2019,5.7,3224,3419,195
41063,OR,Wallowa,,2020,7.1,3216,3462,246
41063,OR,Wallowa,,2021,5.4,3426,3622,196
41065,OR,Wasco,,2007,4.9,12514,13161,647
41065,OR,Wasco,,2008,5.8,12513,13283,770
41065,OR,Wasco,,2009,8.7,12862,14089,1227
41065,OR,Wasco,,2010,9.6,12410,13734,1324
41065,OR,Wasco,,2011,8.9,12677,13916,1239
41065,OR,Wasco,,2012,8.4,12711,13880,1169
41065,OR,Wasco,,2013,7.5,12760,13789,1029
41065,OR,Wasco,,2014,6.4,12775,13655,880
41065,OR,Wasco,,2015,5.5,12320,13032,712
41065,OR,Wasco,,2016,4.7,13011,13655,644
41065,OR,Wasco,,2017,4.1,13155,13716,561
41065,OR,Wasco,,2018,4.1,12704,13252,548
41065,OR,Wasco,,2019,4,12815,13355,540
41065,OR,Wasco,,2020,7.1,12498,13452,954
41065,OR,Wasco,,2021,5.2,12968,13684,716
41067,OR,Washington,,2007,4.3,270191,282376,12185
41067,OR,Washington,,2008,5.1,273704,288292,14588
41067,OR,Washington,,2009,9.1,263525,289903,26378
41067,OR,Washington,,2010,9,264444,290691,26247
41067,OR,Washington,,2011,7.8,271637,294534,22897
41067,OR,Washington,,2012,7.1,271984,292667,20683
41067,OR,Washington,,2013,6.2,271317,289282,17965
41067,OR,Washington,,2014,5.5,278821,295034,16213
41067,OR,Washington,,2015,4.6,288084,301910,13826
41067,OR,Washington,,2016,4,300084,312711,12627
41067,OR,Washington,,2017,3.4,307517,318470,10953
41067,OR,Washington,,2018,3.4,309361,320147,10786
41067,OR,Washington,,2019,3.1,314045,323935,9890
41067,OR,Washington,,2020,6.5,299729,320607,20878
41067,OR,Washington,,2021,4.4,313135,327487,14352
41069,OR,Wheeler,,2007,5.6,574,608,34
41069,OR,Wheeler,,2008,5.7,579,614,35
41069,OR,Wheeler,,2009,8.7,596,653,57
41069,OR,Wheeler,,2010,9.6,704,779,75
41069,OR,Wheeler,,2011,8.6,702,768,66
41069,OR,Wheeler,,2012,6.9,731,785,54
41069,OR,Wheeler,,2013,6.2,691,737,46
41069,OR,Wheeler,,2014,6.1,689,734,45
41069,OR,Wheeler,,2015,5.1,657,692,35
41069,OR,Wheeler,,2016,4.1,656,684,28
41069,OR,Wheeler,,2017,3.8,701,729,28
41069,OR,Wheeler,,2018,3.4,692,716,24
41069,OR,Wheeler,,2019,4.2,679,709,30
41069,OR,Wheeler,,2020,4.3,664,694,30
41069,OR,Wheeler,,2021,3.3,702,726,24
41071,OR,Yamhill,,2007,5,44001,46319,2318
41071,OR,Yamhill,,2008,6.2,44735,47684,2949
41071,OR,Yamhill,,2009,11.2,42798,48178,5380
41071,OR,Yamhill,,2010,10.5,46014,51413,5399
41071,OR,Yamhill,,2011,9.3,46666,51439,4773
41071,OR,Yamhill,,2012,8.5,46519,50827,4308
41071,OR,Yamhill,,2013,7.4,46009,49707,3698
41071,OR,Yamhill,,2014,6.3,47153,50339,3186
41071,OR,Yamhill,,2015,5.2,48276,50900,2624
41071,OR,Yamhill,,2016,4.5,50668,53067,2399
41071,OR,Yamhill,,2017,3.7,51688,53671,1983
41071,OR,Yamhill,,2018,3.6,52076,54030,1954
41071,OR,Yamhill,,2019,3.4,52525,54352,1827
41071,OR,Yamhill,,2020,6.8,50468,54131,3663
41071,OR,Yamhill,,2021,4.7,52704,55328,2624
42000,PA,Pennsylvania,,2007,4.6,6057645,6346588,288943
42000,PA,Pennsylvania,,2008,5.3,6096818,6439786,342968
42000,PA,Pennsylvania,,2009,8,5890073,6400238,510165
42000,PA,Pennsylvania,,2010,8.2,5838498,6360605,522107
42000,PA,Pennsylvania,,2011,7.8,5886748,6381749,495001
42000,PA,Pennsylvania,,2012,7.7,5955409,6449023,493614
42000,PA,Pennsylvania,,2013,7.1,5962130,6419837,457707
42000,PA,Pennsylvania,,2014,5.9,6010075,6389059,378984
42000,PA,Pennsylvania,,2015,5.4,6076402,6423155,346753
42000,PA,Pennsylvania,,2016,5.3,6114644,6458891,344247
42000,PA,Pennsylvania,,2017,5,6161913,6485253,323340
42000,PA,Pennsylvania,,2018,4.5,6210098,6500149,290051
42000,PA,Pennsylvania,,2019,4.5,6266508,6560773,294265
42000,PA,Pennsylvania,,2020,9.1,5893583,6482770,589187
42000,PA,Pennsylvania,,2021,6.3,5999442,6406185,406743
42001,PA,Adams,,2007,3.5,53971,55901,1930
42001,PA,Adams,,2008,4.3,53856,56295,2439
42001,PA,Adams,,2009,7.4,50934,54983,4049
42001,PA,Adams,,2010,7.5,50354,54433,4079
42001,PA,Adams,,2011,6.5,50453,53982,3529
42001,PA,Adams,,2012,6.3,51235,54651,3416
42001,PA,Adams,,2013,5.7,52086,55215,3129
42001,PA,Adams,,2014,4.6,52499,55056,2557
42001,PA,Adams,,2015,4.3,52627,54980,2353
42001,PA,Adams,,2016,3.9,53294,55472,2178
42001,PA,Adams,,2017,3.7,53794,55878,2084
42001,PA,Adams,,2018,3.4,53838,55740,1902
42001,PA,Adams,,2019,3.4,54078,55965,1887
42001,PA,Adams,,2020,6.9,50835,54605,3770
42001,PA,Adams,,2021,4.4,52066,54462,2396
42003,PA,Allegheny,,2007,4.3,606795,633964,27169
42003,PA,Allegheny,,2008,4.8,611134,642211,31077
42003,PA,Allegheny,,2009,6.7,596378,639448,43070
42003,PA,Allegheny,,2010,7.3,587632,634196,46564
42003,PA,Allegheny,,2011,6.9,597224,641826,44602
42003,PA,Allegheny,,2012,6.8,607613,651926,44313
42003,PA,Allegheny,,2013,6.3,608249,649324,41075
42003,PA,Allegheny,,2014,5.4,610848,645853,35005
42003,PA,Allegheny,,2015,5,615035,647733,32698
42003,PA,Allegheny,,2016,5.1,615242,648489,33247
42003,PA,Allegheny,,2017,4.8,620570,651929,31359
42003,PA,Allegheny,,2018,4.2,624269,651614,27345
42003,PA,Allegheny,,2019,4.2,628729,656477,27748
42003,PA,Allegheny,,2020,9,585953,644176,58223
42003,PA,Allegheny,,2021,6.1,592281,630750,38469
42005,PA,Armstrong,,2007,5.2,31159,32860,1701
42005,PA,Armstrong,,2008,5.9,31364,33345,1981
42005,PA,Armstrong,,2009,9,30106,33100,2994
42005,PA,Armstrong,,2010,8.8,30565,33522,2957
42005,PA,Armstrong,,2011,8,30864,33560,2696
42005,PA,Armstrong,,2012,7.9,31171,33830,2659
42005,PA,Armstrong,,2013,7.4,31005,33494,2489
42005,PA,Armstrong,,2014,6.5,30958,33120,2162
42005,PA,Armstrong,,2015,6.8,30813,33051,2238
42005,PA,Armstrong,,2016,7.4,30674,33133,2459
42005,PA,Armstrong,,2017,6.3,30597,32643,2046
42005,PA,Armstrong,,2018,5.2,30722,32413,1691
42005,PA,Armstrong,,2019,5.2,30760,32452,1692
42005,PA,Armstrong,,2020,9.8,28603,31723,3120
42005,PA,Armstrong,,2021,7.6,28903,31268,2365
42007,PA,Beaver,,2007,4.7,84814,88987,4173
42007,PA,Beaver,,2008,5.5,85414,90386,4972
42007,PA,Beaver,,2009,8,82732,89937,7205
42007,PA,Beaver,,2010,8.3,78228,85349,7121
42007,PA,Beaver,,2011,7.7,79183,85754,6571
42007,PA,Beaver,,2012,7.4,80320,86713,6393
42007,PA,Beaver,,2013,7,80214,86249,6035
42007,PA,Beaver,,2014,6.6,80212,85843,5631
42007,PA,Beaver,,2015,6.2,80545,85836,5291
42007,PA,Beaver,,2016,6.1,80207,85443,5236
42007,PA,Beaver,,2017,5.6,80434,85241,4807
42007,PA,Beaver,,2018,4.7,80523,84526,4003
42007,PA,Beaver,,2019,4.6,80859,84799,3940
42007,PA,Beaver,,2020,10.3,75060,83688,8628
42007,PA,Beaver,,2021,7.2,75860,81745,5885
42009,PA,Bedford,,2007,5.8,22191,23569,1378
42009,PA,Bedford,,2008,6.8,22753,24425,1672
42009,PA,Bedford,,2009,10.8,21656,24275,2619
42009,PA,Bedford,,2010,9.8,22800,25273,2473
42009,PA,Bedford,,2011,8.9,22697,24910,2213
42009,PA,Bedford,,2012,8.4,22907,25020,2113
42009,PA,Bedford,,2013,8.1,22624,24622,1998
42009,PA,Bedford,,2014,6.7,22618,24240,1622
42009,PA,Bedford,,2015,6.2,22646,24138,1492
42009,PA,Bedford,,2016,5.8,22687,24082,1395
42009,PA,Bedford,,2017,5.3,22722,23983,1261
42009,PA,Bedford,,2018,4.7,22808,23924,1116
42009,PA,Bedford,,2019,4.8,22732,23880,1148
42009,PA,Bedford,,2020,9,21791,23950,2159
42009,PA,Bedford,,2021,5.9,22317,23723,1406
42011,PA,Berks,,2007,4.4,194242,203172,8930
42011,PA,Berks,,2008,5.4,195056,206125,11069
42011,PA,Berks,,2009,8.7,186244,203880,17636
42011,PA,Berks,,2010,8.4,191835,209477,17642
42011,PA,Berks,,2011,7.7,193517,209653,16136
42011,PA,Berks,,2012,7.5,195497,211336,15839
42011,PA,Berks,,2013,6.9,196083,210607,14524
42011,PA,Berks,,2014,5.6,199054,210765,11711
42011,PA,Berks,,2015,5,201893,212575,10682
42011,PA,Berks,,2016,4.9,203031,213539,10508
42011,PA,Berks,,2017,4.7,204385,214413,10028
42011,PA,Berks,,2018,4.3,205903,215228,9325
42011,PA,Berks,,2019,4.5,208196,217947,9751
42011,PA,Berks,,2020,9.5,194595,214967,20372
42011,PA,Berks,,2021,6.6,197487,211376,13889
42013,PA,Blair,,2007,4.3,62299,65125,2826
42013,PA,Blair,,2008,5.2,62047,65455,3408
42013,PA,Blair,,2009,7.1,60496,65102,4606
42013,PA,Blair,,2010,7.8,56807,61584,4777
42013,PA,Blair,,2011,7.1,57020,61398,4378
42013,PA,Blair,,2012,7.3,57229,61715,4486
42013,PA,Blair,,2013,6.7,57184,61320,4136
42013,PA,Blair,,2014,5.8,57348,60880,3532
42013,PA,Blair,,2015,5.2,57810,61011,3201
42013,PA,Blair,,2016,5.2,57677,60859,3182
42013,PA,Blair,,2017,4.9,57720,60697,2977
42013,PA,Blair,,2018,4.4,57445,60070,2625
42013,PA,Blair,,2019,4.6,57507,60290,2783
42013,PA,Blair,,2020,8.7,54823,60042,5219
42013,PA,Blair,,2021,6,55701,59237,3536
42015,PA,Bradford,,2007,4.9,29337,30850,1513
42015,PA,Bradford,,2008,5.3,29447,31090,1643
42015,PA,Bradford,,2009,8.3,28747,31346,2599
42015,PA,Bradford,,2010,7,28578,30731,2153
42015,PA,Bradford,,2011,6.3,29932,31954,2022
42015,PA,Bradford,,2012,6.7,30383,32571,2188
42015,PA,Bradford,,2013,7.1,29510,31749,2239
42015,PA,Bradford,,2014,5.5,29854,31590,1736
42015,PA,Bradford,,2015,6,29490,31381,1891
42015,PA,Bradford,,2016,6.5,28262,30214,1952
42015,PA,Bradford,,2017,5.2,28030,29574,1544
42015,PA,Bradford,,2018,4.5,27835,29159,1324
42015,PA,Bradford,,2019,4.5,27722,29022,1300
42015,PA,Bradford,,2020,7.5,26329,28471,2142
42015,PA,Bradford,,2021,5.6,26294,27852,1558
42017,PA,Bucks,,2007,3.9,333787,347487,13700
42017,PA,Bucks,,2008,4.7,336113,352807,16694
42017,PA,Bucks,,2009,7.2,319056,343952,24896
42017,PA,Bucks,,2010,7.4,311287,336119,24832
42017,PA,Bucks,,2011,7.1,311668,335647,23979
42017,PA,Bucks,,2012,7,314322,338068,23746
42017,PA,Bucks,,2013,6.4,314645,336071,21426
42017,PA,Bucks,,2014,5.3,317133,334885,17752
42017,PA,Bucks,,2015,4.8,321616,337666,16050
42017,PA,Bucks,,2016,4.6,325784,341373,15589
42017,PA,Bucks,,2017,4.3,328632,343469,14837
42017,PA,Bucks,,2018,3.9,330950,344427,13477
42017,PA,Bucks,,2019,3.9,334924,348636,13712
42017,PA,Bucks,,2020,8.3,315041,343462,28421
42017,PA,Bucks,,2021,5.3,324437,342596,18159
42019,PA,Butler,,2007,4.2,92956,96988,4032
42019,PA,Butler,,2008,4.7,94437,99053,4616
42019,PA,Butler,,2009,6.9,92801,99704,6903
42019,PA,Butler,,2010,7.1,88686,95503,6817
42019,PA,Butler,,2011,6.5,90171,96463,6292
42019,PA,Butler,,2012,6.3,91658,97815,6157
42019,PA,Butler,,2013,6,91763,97579,5816
42019,PA,Butler,,2014,5.1,92344,97327,4983
42019,PA,Butler,,2015,4.8,93410,98129,4719
42019,PA,Butler,,2016,5,93817,98766,4949
42019,PA,Butler,,2017,4.6,94928,99554,4626
42019,PA,Butler,,2018,4,96263,100311,4048
42019,PA,Butler,,2019,4,97139,101175,4036
42019,PA,Butler,,2020,7.8,91640,99378,7738
42019,PA,Butler,,2021,5.6,92616,98106,5490
42021,PA,Cambria,,2007,5.5,64634,68397,3763
42021,PA,Cambria,,2008,6.2,65176,69457,4281
42021,PA,Cambria,,2009,8.5,63222,69063,5841
42021,PA,Cambria,,2010,9.2,60434,66524,6090
42021,PA,Cambria,,2011,8.5,60407,66038,5631
42021,PA,Cambria,,2012,8.6,60165,65820,5655
42021,PA,Cambria,,2013,8.4,58948,64380,5432
42021,PA,Cambria,,2014,7.1,58501,62946,4445
42021,PA,Cambria,,2015,6.7,58206,62371,4165
42021,PA,Cambria,,2016,6.7,57404,61532,4128
42021,PA,Cambria,,2017,6.1,56525,60219,3694
42021,PA,Cambria,,2018,5.4,55687,58860,3173
42021,PA,Cambria,,2019,5.5,55321,58515,3194
42021,PA,Cambria,,2020,9.5,51562,56988,5426
42021,PA,Cambria,,2021,7,51760,55668,3908
42023,PA,Cameron,,2007,6.2,2399,2558,159
42023,PA,Cameron,,2008,9,2303,2531,228
42023,PA,Cameron,,2009,16.9,1961,2361,400
42023,PA,Cameron,,2010,12.3,2232,2544,312
42023,PA,Cameron,,2011,10.5,2241,2503,262
42023,PA,Cameron,,2012,10,2201,2446,245
42023,PA,Cameron,,2013,9.4,2125,2345,220
42023,PA,Cameron,,2014,7.1,2133,2297,164
42023,PA,Cameron,,2015,7.3,2100,2265,165
42023,PA,Cameron,,2016,7.3,2072,2234,162
42023,PA,Cameron,,2017,6.9,2062,2216,154
42023,PA,Cameron,,2018,5.2,2048,2160,112
42023,PA,Cameron,,2019,6.1,1987,2115,128
42023,PA,Cameron,,2020,12.5,1807,2065,258
42023,PA,Cameron,,2021,7.7,1855,2009,154
42025,PA,Carbon,,2007,5.6,29382,31110,1728
42025,PA,Carbon,,2008,6.8,29413,31547,2134
42025,PA,Carbon,,2009,10,28304,31448,3144
42025,PA,Carbon,,2010,10.3,28416,31666,3250
42025,PA,Carbon,,2011,9.8,28667,31792,3125
42025,PA,Carbon,,2012,9.8,29075,32231,3156
42025,PA,Carbon,,2013,9,29202,32096,2894
42025,PA,Carbon,,2014,7.2,29301,31566,2265
42025,PA,Carbon,,2015,6.2,29534,31477,1943
42025,PA,Carbon,,2016,5.9,29747,31613,1866
42025,PA,Carbon,,2017,5.7,29992,31789,1797
42025,PA,Carbon,,2018,5.2,30387,32070,1683
42025,PA,Carbon,,2019,5.5,30723,32519,1796
42025,PA,Carbon,,2020,9.8,28839,31966,3127
42025,PA,Carbon,,2021,6.7,29924,32079,2155
42027,PA,Centre,,2007,3.6,71036,73716,2680
42027,PA,Centre,,2008,4.3,72142,75397,3255
42027,PA,Centre,,2009,5.8,71000,75335,4335
42027,PA,Centre,,2010,5.8,72708,77150,4442
42027,PA,Centre,,2011,5.3,73171,77275,4104
42027,PA,Centre,,2012,5.4,73287,77441,4154
42027,PA,Centre,,2013,5.1,73840,77806,3966
42027,PA,Centre,,2014,4.3,74166,77538,3372
42027,PA,Centre,,2015,4,74668,77816,3148
42027,PA,Centre,,2016,4.1,75796,79058,3262
42027,PA,Centre,,2017,3.8,76808,79801,2993
42027,PA,Centre,,2018,3.4,77735,80454,2719
42027,PA,Centre,,2019,3.4,78054,80830,2776
42027,PA,Centre,,2020,5.8,73057,77577,4520
42027,PA,Centre,,2021,4.6,72547,76030,3483
42029,PA,Chester,,2007,3.2,258591,267246,8655
42029,PA,Chester,,2008,3.9,262937,273712,10775
42029,PA,Chester,,2009,6.2,251584,268170,16586
42029,PA,Chester,,2010,6,252588,268853,16265
42029,PA,Chester,,2011,5.6,254367,269597,15230
42029,PA,Chester,,2012,5.5,257539,272533,14994
42029,PA,Chester,,2013,5.1,258850,272790,13940
42029,PA,Chester,,2014,4.2,262015,273533,11518
42029,PA,Chester,,2015,3.9,266346,277098,10752
42029,PA,Chester,,2016,3.8,270039,280797,10758
42029,PA,Chester,,2017,3.7,273197,283553,10356
42029,PA,Chester,,2018,3.3,276376,285793,9417
42029,PA,Chester,,2019,3.3,281287,290781,9494
42029,PA,Chester,,2020,6.4,266873,285148,18275
42029,PA,Chester,,2021,4.2,274342,286372,12030
42031,PA,Clarion,,2007,4.9,19298,20299,1001
42031,PA,Clarion,,2008,6.3,19496,20799,1303
42031,PA,Clarion,,2009,9.4,18717,20657,1940
42031,PA,Clarion,,2010,10,17564,19508,1944
42031,PA,Clarion,,2011,9.7,17202,19058,1856
42031,PA,Clarion,,2012,8.8,17290,18956,1666
42031,PA,Clarion,,2013,7.8,17150,18610,1460
42031,PA,Clarion,,2014,6.3,17251,18420,1169
42031,PA,Clarion,,2015,6.1,17167,18278,1111
42031,PA,Clarion,,2016,6.1,16953,18053,1100
42031,PA,Clarion,,2017,5.7,16866,17891,1025
42031,PA,Clarion,,2018,5,16710,17589,879
42031,PA,Clarion,,2019,5,16407,17273,866
42031,PA,Clarion,,2020,8.3,15585,16995,1410
42031,PA,Clarion,,2021,6.5,15565,16640,1075
42033,PA,Clearfield,,2007,5.7,38510,40819,2309
42033,PA,Clearfield,,2008,6.7,37958,40705,2747
42033,PA,Clearfield,,2009,9.9,36704,40724,4020
42033,PA,Clearfield,,2010,10.1,34087,37933,3846
42033,PA,Clearfield,,2011,9.2,34462,37962,3500
42033,PA,Clearfield,,2012,9.2,34645,38137,3492
42033,PA,Clearfield,,2013,8.7,34350,37639,3289
42033,PA,Clearfield,,2014,7.3,33991,36667,2676
42033,PA,Clearfield,,2015,6.8,33969,36435,2466
42033,PA,Clearfield,,2016,7.2,33733,36354,2621
42033,PA,Clearfield,,2017,6,34022,36200,2178
42033,PA,Clearfield,,2018,5.2,34250,36121,1871
42033,PA,Clearfield,,2019,5.3,34409,36344,1935
42033,PA,Clearfield,,2020,9.2,32772,36093,3321
42033,PA,Clearfield,,2021,7,33007,35498,2491
42035,PA,Clinton,,2007,5.4,18126,19166,1040
42035,PA,Clinton,,2008,6.2,18219,19425,1206
42035,PA,Clinton,,2009,8.8,17643,19337,1694
42035,PA,Clinton,,2010,9.1,16980,18682,1702
42035,PA,Clinton,,2011,8.2,17569,19136,1567
42035,PA,Clinton,,2012,8.6,17736,19415,1679
42035,PA,Clinton,,2013,8.8,17528,19212,1684
42035,PA,Clinton,,2014,7.4,17553,18952,1399
42035,PA,Clinton,,2015,7,17460,18778,1318
42035,PA,Clinton,,2016,7,17278,18579,1301
42035,PA,Clinton,,2017,6.2,17372,18526,1154
42035,PA,Clinton,,2018,5.5,17539,18562,1023
42035,PA,Clinton,,2019,5.6,17474,18502,1028
42035,PA,Clinton,,2020,8.7,16349,17910,1561
42035,PA,Clinton,,2021,6.7,16076,17226,1150
42037,PA,Columbia,,2007,5.2,33394,35235,1841
42037,PA,Columbia,,2008,5.9,34201,36346,2145
42037,PA,Columbia,,2009,8.5,33355,36445,3090
42037,PA,Columbia,,2010,9.1,31483,34620,3137
42037,PA,Columbia,,2011,8.5,31768,34709,2941
42037,PA,Columbia,,2012,8.2,32540,35433,2893
42037,PA,Columbia,,2013,7.4,32588,35209,2621
42037,PA,Columbia,,2014,6.3,32047,34197,2150
42037,PA,Columbia,,2015,5.8,31808,33751,1943
42037,PA,Columbia,,2016,5.5,32091,33950,1859
42037,PA,Columbia,,2017,5.3,32235,34028,1793
42037,PA,Columbia,,2018,4.9,32187,33853,1666
42037,PA,Columbia,,2019,4.9,32189,33840,1651
42037,PA,Columbia,,2020,8.1,31042,33784,2742
42037,PA,Columbia,,2021,5.9,31328,33275,1947
42039,PA,Crawford,,2007,5.1,40631,42820,2189
42039,PA,Crawford,,2008,5.6,41029,43484,2455
42039,PA,Crawford,,2009,9.8,38680,42878,4198
42039,PA,Crawford,,2010,9.2,37732,41546,3814
42039,PA,Crawford,,2011,7.8,38193,41438,3245
42039,PA,Crawford,,2012,7.5,38769,41896,3127
42039,PA,Crawford,,2013,7,38735,41647,2912
42039,PA,Crawford,,2014,5.9,38792,41210,2418
42039,PA,Crawford,,2015,5.3,38884,41059,2175
42039,PA,Crawford,,2016,5.9,38150,40559,2409
42039,PA,Crawford,,2017,5.6,37586,39808,2222
42039,PA,Crawford,,2018,4.9,37412,39322,1910
42039,PA,Crawford,,2019,4.8,37146,39038,1892
42039,PA,Crawford,,2020,8.9,35224,38660,3436
42039,PA,Crawford,,2021,6.7,35305,37822,2517
42041,PA,Cumberland,,2007,3.4,119042,123205,4163
42041,PA,Cumberland,,2008,4.3,120245,125594,5349
42041,PA,Cumberland,,2009,6.6,116715,124917,8202
42041,PA,Cumberland,,2010,6.6,115889,124102,8213
42041,PA,Cumberland,,2011,6.2,116484,124189,7705
42041,PA,Cumberland,,2012,6,117950,125534,7584
42041,PA,Cumberland,,2013,5.5,118482,125406,6924
42041,PA,Cumberland,,2014,4.5,120237,125954,5717
42041,PA,Cumberland,,2015,4.1,123192,128407,5215
42041,PA,Cumberland,,2016,4,125064,130295,5231
42041,PA,Cumberland,,2017,3.9,126312,131396,5084
42041,PA,Cumberland,,2018,3.5,127480,132055,4575
42041,PA,Cumberland,,2019,3.5,129560,134203,4643
42041,PA,Cumberland,,2020,6.6,124212,133054,8842
42041,PA,Cumberland,,2021,4.6,126550,132627,6077
42043,PA,Dauphin,,2007,4.1,130371,135876,5505
42043,PA,Dauphin,,2008,4.7,131355,137831,6476
42043,PA,Dauphin,,2009,7.4,126950,137080,10130
42043,PA,Dauphin,,2010,7.8,129234,140162,10928
42043,PA,Dauphin,,2011,7.4,129789,140192,10403
42043,PA,Dauphin,,2012,7.3,130640,140870,10230
42043,PA,Dauphin,,2013,6.6,130764,140007,9243
42043,PA,Dauphin,,2014,5.4,131653,139179,7526
42043,PA,Dauphin,,2015,4.7,134341,141032,6691
42043,PA,Dauphin,,2016,4.7,135593,142301,6708
42043,PA,Dauphin,,2017,4.6,137104,143690,6586
42043,PA,Dauphin,,2018,4.1,138273,144231,5958
42043,PA,Dauphin,,2019,4.1,140029,146075,6046
42043,PA,Dauphin,,2020,8.9,133508,146534,13026
42043,PA,Dauphin,,2021,6.3,136049,145162,9113
42045,PA,Delaware,,2007,4.2,271318,283258,11940
42045,PA,Delaware,,2008,5,272605,286958,14353
42045,PA,Delaware,,2009,7.5,259010,280089,21079
42045,PA,Delaware,,2010,7.7,263172,285259,22087
42045,PA,Delaware,,2011,7.6,264559,286263,21704
42045,PA,Delaware,,2012,7.5,267200,288958,21758
42045,PA,Delaware,,2013,6.8,269746,289497,19751
42045,PA,Delaware,,2014,5.6,273671,289871,16200
42045,PA,Delaware,,2015,5,277085,291615,14530
42045,PA,Delaware,,2016,4.8,280449,294655,14206
42045,PA,Delaware,,2017,4.6,284084,297750,13666
42045,PA,Delaware,,2018,4.2,286729,299233,12504
42045,PA,Delaware,,2019,4.2,290501,303096,12595
42045,PA,Delaware,,2020,9.2,271519,298936,27417
42045,PA,Delaware,,2021,6.3,277226,295824,18598
42047,PA,Elk,,2007,4.9,16641,17494,853
42047,PA,Elk,,2008,6,16496,17545,1049
42047,PA,Elk,,2009,12.5,14957,17099,2142
42047,PA,Elk,,2010,9.4,15068,16624,1556
42047,PA,Elk,,2011,7.2,15615,16833,1218
42047,PA,Elk,,2012,6.8,15706,16854,1148
42047,PA,Elk,,2013,6.6,15327,16412,1085
42047,PA,Elk,,2014,5.2,15490,16338,848
42047,PA,Elk,,2015,5,15514,16334,820
42047,PA,Elk,,2016,5.5,15464,16356,892
42047,PA,Elk,,2017,4.9,15368,16159,791
42047,PA,Elk,,2018,4,15399,16038,639
42047,PA,Elk,,2019,5,15040,15824,784
42047,PA,Elk,,2020,12.2,13546,15420,1874
42047,PA,Elk,,2021,6.9,13814,14836,1022
42049,PA,Erie,,2007,5,133663,140692,7029
42049,PA,Erie,,2008,5.7,133653,141662,8009
42049,PA,Erie,,2009,8.8,127534,139877,12343
42049,PA,Erie,,2010,9,123620,135877,12257
42049,PA,Erie,,2011,8,126053,136975,10922
42049,PA,Erie,,2012,7.6,126665,137128,10463
42049,PA,Erie,,2013,7.2,125776,135527,9751
42049,PA,Erie,,2014,6.3,126078,134490,8412
42049,PA,Erie,,2015,5.6,127260,134801,7541
42049,PA,Erie,,2016,6.4,125178,133789,8611
42049,PA,Erie,,2017,5.9,124230,131953,7723
42049,PA,Erie,,2018,4.9,124230,130607,6377
42049,PA,Erie,,2019,4.7,124269,130359,6090
42049,PA,Erie,,2020,9.8,116100,128723,12623
42049,PA,Erie,,2021,7.3,117276,126536,9260
42051,PA,Fayette,,2007,5.9,61852,65728,3876
42051,PA,Fayette,,2008,6.6,62231,66605,4374
42051,PA,Fayette,,2009,9.1,60005,66002,5997
42051,PA,Fayette,,2010,10.5,53111,59315,6204
42051,PA,Fayette,,2011,9.9,53657,59530,5873
42051,PA,Fayette,,2012,9.7,54255,60095,5840
42051,PA,Fayette,,2013,9.3,53934,59477,5543
42051,PA,Fayette,,2014,8,53772,58427,4655
42051,PA,Fayette,,2015,7.6,53952,58414,4462
42051,PA,Fayette,,2016,8,53815,58506,4691
42051,PA,Fayette,,2017,7,53873,57956,4083
42051,PA,Fayette,,2018,6.1,53964,57452,3488
42051,PA,Fayette,,2019,6.1,53979,57499,3520
42051,PA,Fayette,,2020,11.8,50131,56830,6699
42051,PA,Fayette,,2021,8.7,50665,55515,4850
42053,PA,Forest,,2007,6.8,2235,2398,163
42053,PA,Forest,,2008,7.7,2205,2388,183
42053,PA,Forest,,2009,10.8,2124,2381,257
42053,PA,Forest,,2010,11,1910,2145,235
42053,PA,Forest,,2011,9.3,1842,2030,188
42053,PA,Forest,,2012,9.6,1816,2008,192
42053,PA,Forest,,2013,9.6,1778,1966,188
42053,PA,Forest,,2014,8.1,1771,1928,157
42053,PA,Forest,,2015,8,1748,1900,152
42053,PA,Forest,,2016,7.8,1746,1893,147
42053,PA,Forest,,2017,6.8,1726,1851,125
42053,PA,Forest,,2018,6.5,1720,1839,119
42053,PA,Forest,,2019,7,1705,1833,128
42053,PA,Forest,,2020,10.6,1623,1815,192
42053,PA,Forest,,2021,8.3,1602,1747,145
42055,PA,Franklin,,2007,3.5,77931,80767,2836
42055,PA,Franklin,,2008,4.3,79051,82616,3565
42055,PA,Franklin,,2009,8,74463,80944,6481
42055,PA,Franklin,,2010,8.3,69227,75482,6255
42055,PA,Franklin,,2011,7.2,69972,75388,5416
42055,PA,Franklin,,2012,6.9,70958,76186,5228
42055,PA,Franklin,,2013,6.4,71489,76372,4883
42055,PA,Franklin,,2014,5.5,72222,76431,4209
42055,PA,Franklin,,2015,5.1,73942,77875,3933
42055,PA,Franklin,,2016,5.1,73651,77607,3956
42055,PA,Franklin,,2017,4.5,73804,77298,3494
42055,PA,Franklin,,2018,3.8,74795,77787,2992
42055,PA,Franklin,,2019,3.9,75436,78527,3091
42055,PA,Franklin,,2020,7.6,72545,78502,5957
42055,PA,Franklin,,2021,5.1,73196,77153,3957
42057,PA,Fulton,,2007,5.8,7644,8112,468
42057,PA,Fulton,,2008,7.2,7543,8131,588
42057,PA,Fulton,,2009,13.3,6622,7638,1016
42057,PA,Fulton,,2010,11.9,6519,7401,882
42057,PA,Fulton,,2011,9.9,6607,7333,726
42057,PA,Fulton,,2012,9,6753,7423,670
42057,PA,Fulton,,2013,8.9,6716,7375,659
42057,PA,Fulton,,2014,7.2,6773,7296,523
42057,PA,Fulton,,2015,6.4,6973,7446,473
42057,PA,Fulton,,2016,6.2,6857,7314,457
42057,PA,Fulton,,2017,5.2,6938,7315,377
42057,PA,Fulton,,2018,4.1,7584,7910,326
42057,PA,Fulton,,2019,4.6,7431,7790,359
42057,PA,Fulton,,2020,11.9,6609,7504,895
42057,PA,Fulton,,2021,6.3,6661,7109,448
42059,PA,Greene,,2007,5.2,17205,18142,937
42059,PA,Greene,,2008,5.8,17509,18589,1080
42059,PA,Greene,,2009,7.4,17702,19111,1409
42059,PA,Greene,,2010,8.1,15947,17356,1409
42059,PA,Greene,,2011,7.5,16796,18155,1359
42059,PA,Greene,,2012,7.1,17677,19037,1360
42059,PA,Greene,,2013,7,17395,18701,1306
42059,PA,Greene,,2014,5.6,17454,18497,1043
42059,PA,Greene,,2015,6.1,17061,18171,1110
42059,PA,Greene,,2016,7.7,15991,17318,1327
42059,PA,Greene,,2017,6,15937,16954,1017
42059,PA,Greene,,2018,5.1,15929,16777,848
42059,PA,Greene,,2019,5.2,15917,16798,881
42059,PA,Greene,,2020,9.7,14579,16153,1574
42059,PA,Greene,,2021,7.3,14575,15723,1148
42061,PA,Huntingdon,,2007,5.3,21021,22205,1184
42061,PA,Huntingdon,,2008,6.6,21103,22590,1487
42061,PA,Huntingdon,,2009,10.4,20371,22733,2362
42061,PA,Huntingdon,,2010,10.4,18844,21034,2190
42061,PA,Huntingdon,,2011,9.9,18879,20953,2074
42061,PA,Huntingdon,,2012,9.7,18704,20718,2014
42061,PA,Huntingdon,,2013,9.5,18323,20252,1929
42061,PA,Huntingdon,,2014,8,18260,19846,1586
42061,PA,Huntingdon,,2015,7.2,18276,19684,1408
42061,PA,Huntingdon,,2016,6.9,18326,19687,1361
42061,PA,Huntingdon,,2017,6.1,18769,19985,1216
42061,PA,Huntingdon,,2018,5.5,18923,20026,1103
42061,PA,Huntingdon,,2019,6.1,18906,20124,1218
42061,PA,Huntingdon,,2020,10.5,17736,19826,2090
42061,PA,Huntingdon,,2021,7.3,17776,19181,1405
42063,PA,Indiana,,2007,4.8,43532,45735,2203
42063,PA,Indiana,,2008,5.3,44404,46885,2481
42063,PA,Indiana,,2009,7.4,43715,47201,3486
42063,PA,Indiana,,2010,8.4,40233,43936,3703
42063,PA,Indiana,,2011,7.7,40556,43940,3384
42063,PA,Indiana,,2012,7.9,41116,44661,3545
42063,PA,Indiana,,2013,7.5,40647,43936,3289
42063,PA,Indiana,,2014,6.1,40512,43163,2651
42063,PA,Indiana,,2015,6.4,39092,41777,2685
42063,PA,Indiana,,2016,7.2,37321,40217,2896
42063,PA,Indiana,,2017,5.9,37264,39611,2347
42063,PA,Indiana,,2018,5.1,37198,39199,2001
42063,PA,Indiana,,2019,5.2,37451,39491,2040
42063,PA,Indiana,,2020,9.1,34661,38132,3471
42063,PA,Indiana,,2021,7.1,34461,37090,2629
42065,PA,Jefferson,,2007,4.8,22004,23109,1105
42065,PA,Jefferson,,2008,5.6,21963,23260,1297
42065,PA,Jefferson,,2009,9.3,20708,22832,2124
42065,PA,Jefferson,,2010,9.8,19421,21526,2105
42065,PA,Jefferson,,2011,8.6,19882,21743,1861
42065,PA,Jefferson,,2012,8.1,19939,21707,1768
42065,PA,Jefferson,,2013,7.9,19347,21017,1670
42065,PA,Jefferson,,2014,6.5,19484,20835,1351
42065,PA,Jefferson,,2015,6.2,19678,20983,1305
42065,PA,Jefferson,,2016,6.8,19326,20730,1404
42065,PA,Jefferson,,2017,5.7,19585,20760,1175
42065,PA,Jefferson,,2018,4.8,19737,20738,1001
42065,PA,Jefferson,,2019,4.9,19774,20782,1008
42065,PA,Jefferson,,2020,8.8,18565,20351,1786
42065,PA,Jefferson,,2021,6.5,18346,19626,1280
42067,PA,Juniata,,2007,4.4,11950,12495,545
42067,PA,Juniata,,2008,5.4,11763,12429,666
42067,PA,Juniata,,2009,7.8,11207,12158,951
42067,PA,Juniata,,2010,7.7,11121,12050,929
42067,PA,Juniata,,2011,7.2,11122,11987,865
42067,PA,Juniata,,2012,7.1,11170,12024,854
42067,PA,Juniata,,2013,6.9,11164,11991,827
42067,PA,Juniata,,2014,5.7,11166,11843,677
42067,PA,Juniata,,2015,5,11389,11994,605
42067,PA,Juniata,,2016,5.3,11570,12217,647
42067,PA,Juniata,,2017,4.7,11909,12491,582
42067,PA,Juniata,,2018,4.2,12066,12593,527
42067,PA,Juniata,,2019,4.5,12166,12745,579
42067,PA,Juniata,,2020,7.2,11830,12745,915
42067,PA,Juniata,,2021,5,11877,12501,624
42069,PA,Lackawanna,,2007,5,101684,106985,5301
42069,PA,Lackawanna,,2008,5.8,102017,108335,6318
42069,PA,Lackawanna,,2009,8.1,98475,107191,8716
42069,PA,Lackawanna,,2010,8.7,97365,106644,9279
42069,PA,Lackawanna,,2011,8.6,97780,107016,9236
42069,PA,Lackawanna,,2012,8.6,98089,107371,9282
42069,PA,Lackawanna,,2013,8,98616,107214,8598
42069,PA,Lackawanna,,2014,6.6,99512,106598,7086
42069,PA,Lackawanna,,2015,5.9,100145,106458,6313
42069,PA,Lackawanna,,2016,5.6,101105,107087,5982
42069,PA,Lackawanna,,2017,5.2,101344,106928,5584
42069,PA,Lackawanna,,2018,4.8,101395,106463,5068
42069,PA,Lackawanna,,2019,5,100971,106301,5330
42069,PA,Lackawanna,,2020,9.6,94896,105010,10114
42069,PA,Lackawanna,,2021,6.9,96225,103325,7100
42071,PA,Lancaster,,2007,3.5,260103,269648,9545
42071,PA,Lancaster,,2008,4.3,262326,274034,11708
42071,PA,Lancaster,,2009,7.1,250328,269588,19260
42071,PA,Lancaster,,2010,7.3,247815,267222,19407
42071,PA,Lancaster,,2011,6.7,247641,265492,17851
42071,PA,Lancaster,,2012,6.4,251573,268700,17127
42071,PA,Lancaster,,2013,5.8,253945,269655,15710
42071,PA,Lancaster,,2014,4.7,259550,272259,12709
42071,PA,Lancaster,,2015,4.2,264467,276028,11561
42071,PA,Lancaster,,2016,4.1,266858,278301,11443
42071,PA,Lancaster,,2017,3.9,270538,281545,11007
42071,PA,Lancaster,,2018,3.5,275237,285302,10065
42071,PA,Lancaster,,2019,3.5,278164,288378,10214
42071,PA,Lancaster,,2020,7.5,264119,285487,21368
42071,PA,Lancaster,,2021,4.9,270883,284893,14010
42073,PA,Lawrence,,2007,5.4,41725,44107,2382
42073,PA,Lawrence,,2008,6.2,41153,43874,2721
42073,PA,Lawrence,,2009,9.2,39555,43575,4020
42073,PA,Lawrence,,2010,9,39136,42983,3847
42073,PA,Lawrence,,2011,8.2,39420,42945,3525
42073,PA,Lawrence,,2012,7.7,39892,43235,3343
42073,PA,Lawrence,,2013,7.3,39771,42896,3125
42073,PA,Lawrence,,2014,6.3,39889,42568,2679
42073,PA,Lawrence,,2015,6.4,39429,42140,2711
42073,PA,Lawrence,,2016,6.6,38799,41562,2763
42073,PA,Lawrence,,2017,6.2,38493,41018,2525
42073,PA,Lawrence,,2018,5.3,39070,41250,2180
42073,PA,Lawrence,,2019,5.3,38988,41149,2161
42073,PA,Lawrence,,2020,10.4,36557,40785,4228
42073,PA,Lawrence,,2021,7.6,36612,39632,3020
42075,PA,Lebanon,,2007,3.6,69554,72139,2585
42075,PA,Lebanon,,2008,4.2,70176,73229,3053
42075,PA,Lebanon,,2009,6.6,67940,72774,4834
42075,PA,Lebanon,,2010,7.2,64798,69857,5059
42075,PA,Lebanon,,2011,6.8,64980,69709,4729
42075,PA,Lebanon,,2012,6.5,66154,70778,4624
42075,PA,Lebanon,,2013,6,66279,70521,4242
42075,PA,Lebanon,,2014,5,66536,70051,3515
42075,PA,Lebanon,,2015,4.6,66849,70081,3232
42075,PA,Lebanon,,2016,4.4,67561,70694,3133
42075,PA,Lebanon,,2017,4.2,68391,71387,2996
42075,PA,Lebanon,,2018,3.9,69180,72007,2827
42075,PA,Lebanon,,2019,4,70213,73139,2926
42075,PA,Lebanon,,2020,7.9,67204,72985,5781
42075,PA,Lebanon,,2021,5.5,68671,72636,3965
42077,PA,Lehigh,,2007,4.6,167885,175900,8015
42077,PA,Lehigh,,2008,5.6,168540,178632,10092
42077,PA,Lehigh,,2009,8.6,163083,178417,15334
42077,PA,Lehigh,,2010,8.9,160848,176592,15744
42077,PA,Lehigh,,2011,8.5,163922,179080,15158
42077,PA,Lehigh,,2012,8.3,167310,182454,15144
42077,PA,Lehigh,,2013,7.6,168805,182642,13837
42077,PA,Lehigh,,2014,6.1,171665,182897,11232
42077,PA,Lehigh,,2015,5.4,175780,185867,10087
42077,PA,Lehigh,,2016,5.3,179314,189319,10005
42077,PA,Lehigh,,2017,5.1,181692,191452,9760
42077,PA,Lehigh,,2018,4.8,183886,193125,9239
42077,PA,Lehigh,,2019,4.6,186666,195732,9066
42077,PA,Lehigh,,2020,9.6,176099,194736,18637
42077,PA,Lehigh,,2021,6.8,182781,196119,13338
42079,PA,Luzerne,,2007,5.2,151021,159243,8222
42079,PA,Luzerne,,2008,6.3,151324,161460,10136
42079,PA,Luzerne,,2009,8.9,146899,161283,14384
42079,PA,Luzerne,,2010,9.7,143804,159212,15408
42079,PA,Luzerne,,2011,9.4,144450,159444,14994
42079,PA,Luzerne,,2012,9.6,145056,160422,15366
42079,PA,Luzerne,,2013,9.1,145551,160094,14543
42079,PA,Luzerne,,2014,7.4,147114,158890,11776
42079,PA,Luzerne,,2015,6.6,148426,158870,10444
42079,PA,Luzerne,,2016,6.2,149291,159198,9907
42079,PA,Luzerne,,2017,6,150490,160068,9578
42079,PA,Luzerne,,2018,5.6,150704,159673,8969
42079,PA,Luzerne,,2019,5.8,150771,160092,9321
42079,PA,Luzerne,,2020,10.9,141990,159443,17453
42079,PA,Luzerne,,2021,8.3,143982,156930,12948
42081,PA,Lycoming,,2007,5.1,56349,59374,3025
42081,PA,Lycoming,,2008,5.9,57016,60597,3581
42081,PA,Lycoming,,2009,8.7,54767,60005,5238
42081,PA,Lycoming,,2010,8.7,54149,59284,5135
42081,PA,Lycoming,,2011,7.6,56344,60963,4619
42081,PA,Lycoming,,2012,7.7,57796,62618,4822
42081,PA,Lycoming,,2013,7.6,56975,61644,4669
42081,PA,Lycoming,,2014,6.2,57647,61472,3825
42081,PA,Lycoming,,2015,6.2,57180,60933,3753
42081,PA,Lycoming,,2016,6.6,54941,58797,3856
42081,PA,Lycoming,,2017,5.7,55072,58389,3317
42081,PA,Lycoming,,2018,5,55068,57951,2883
42081,PA,Lycoming,,2019,4.9,54714,57557,2843
42081,PA,Lycoming,,2020,8.8,51752,56760,5008
42081,PA,Lycoming,,2021,6.7,51607,55322,3715
42083,PA,McKean,,2007,5.2,20569,21693,1124
42083,PA,McKean,,2008,6.2,20551,21899,1348
42083,PA,McKean,,2009,10.2,19031,21184,2153
42083,PA,McKean,,2010,9.8,18024,19979,1955
42083,PA,McKean,,2011,8.6,18350,20067,1717
42083,PA,McKean,,2012,8.2,18564,20223,1659
42083,PA,McKean,,2013,7.9,18069,19620,1551
42083,PA,McKean,,2014,6.5,18047,19297,1250
42083,PA,McKean,,2015,6.2,17814,18989,1175
42083,PA,McKean,,2016,6.5,17303,18515,1212
42083,PA,McKean,,2017,6.2,17200,18337,1137
42083,PA,McKean,,2018,5,17115,18015,900
42083,PA,McKean,,2019,5.4,16571,17517,946
42083,PA,McKean,,2020,9.8,15621,17323,1702
42083,PA,McKean,,2021,6.9,15711,16882,1171
42085,PA,Mercer,,2007,5.7,52304,55488,3184
42085,PA,Mercer,,2008,6.7,51961,55709,3748
42085,PA,Mercer,,2009,11.1,48681,54733,6052
42085,PA,Mercer,,2010,9.2,48497,53432,4935
42085,PA,Mercer,,2011,7.7,49126,53227,4101
42085,PA,Mercer,,2012,7.4,49847,53825,3978
42085,PA,Mercer,,2013,7,49806,53551,3745
42085,PA,Mercer,,2014,5.9,49867,53014,3147
42085,PA,Mercer,,2015,5.6,50077,53022,2945
42085,PA,Mercer,,2016,5.9,49502,52607,3105
42085,PA,Mercer,,2017,5.6,48322,51162,2840
42085,PA,Mercer,,2018,4.9,48012,50481,2469
42085,PA,Mercer,,2019,5,47078,49554,2476
42085,PA,Mercer,,2020,9.7,43991,48710,4719
42085,PA,Mercer,,2021,7.1,44435,47850,3415
42087,PA,Mifflin,,2007,5.4,21315,22534,1219
42087,PA,Mifflin,,2008,6.6,21252,22749,1497
42087,PA,Mifflin,,2009,9.8,20344,22554,2210
42087,PA,Mifflin,,2010,9.9,19079,21186,2107
42087,PA,Mifflin,,2011,8.7,19122,20952,1830
42087,PA,Mifflin,,2012,8.5,19296,21083,1787
42087,PA,Mifflin,,2013,7.9,19625,21309,1684
42087,PA,Mifflin,,2014,6.5,19708,21076,1368
42087,PA,Mifflin,,2015,5.9,19693,20924,1231
42087,PA,Mifflin,,2016,5.7,19657,20836,1179
42087,PA,Mifflin,,2017,5.4,19740,20868,1128
42087,PA,Mifflin,,2018,4.9,19983,21004,1021
42087,PA,Mifflin,,2019,4.8,20261,21278,1017
42087,PA,Mifflin,,2020,8.5,19526,21331,1805
42087,PA,Mifflin,,2021,6.1,19593,20860,1267
42089,PA,Monroe,,2007,5.1,77525,81675,4150
42089,PA,Monroe,,2008,6,78825,83866,5041
42089,PA,Monroe,,2009,9,75421,82852,7431
42089,PA,Monroe,,2010,9.4,74649,82414,7765
42089,PA,Monroe,,2011,9.5,74214,81997,7783
42089,PA,Monroe,,2012,9.6,74353,82207,7854
42089,PA,Monroe,,2013,9.1,73888,81248,7360
42089,PA,Monroe,,2014,7.6,73695,79786,6091
42089,PA,Monroe,,2015,6.6,75512,80817,5305
42089,PA,Monroe,,2016,6.2,76939,82003,5064
42089,PA,Monroe,,2017,6,78056,83002,4946
42089,PA,Monroe,,2018,5.6,78631,83259,4628
42089,PA,Monroe,,2019,5.5,79615,84265,4650
42089,PA,Monroe,,2020,11.5,73276,82783,9507
42089,PA,Monroe,,2021,7.7,75678,81973,6295
42091,PA,Montgomery,,2007,3.6,414682,430147,15465
42091,PA,Montgomery,,2008,4.3,418247,437181,18934
42091,PA,Montgomery,,2009,6.8,396422,425141,28719
42091,PA,Montgomery,,2010,6.7,400319,429193,28874
42091,PA,Montgomery,,2011,6.3,402275,429511,27236
42091,PA,Montgomery,,2012,6.2,407767,434777,27010
42091,PA,Montgomery,,2013,5.7,409692,434319,24627
42091,PA,Montgomery,,2014,4.7,415511,436057,20546
42091,PA,Montgomery,,2015,4.2,422288,440958,18670
42091,PA,Montgomery,,2016,4.1,429780,448108,18328
42091,PA,Montgomery,,2017,3.9,434530,452283,17753
42091,PA,Montgomery,,2018,3.6,438929,455203,16274
42091,PA,Montgomery,,2019,3.6,445356,461953,16597
42091,PA,Montgomery,,2020,7.6,420355,454869,34514
42091,PA,Montgomery,,2021,5,432931,455531,22600
42093,PA,Montour,,2007,4,8850,9218,368
42093,PA,Montour,,2008,4.8,8969,9420,451
42093,PA,Montour,,2009,6.5,8736,9343,607
42093,PA,Montour,,2010,6.5,8465,9055,590
42093,PA,Montour,,2011,6.1,8614,9175,561
42093,PA,Montour,,2012,5.7,8891,9427,536
42093,PA,Montour,,2013,5.3,8938,9436,498
42093,PA,Montour,,2014,4.7,8794,9229,435
42093,PA,Montour,,2015,4.4,8746,9148,402
42093,PA,Montour,,2016,4.2,8757,9142,385
42093,PA,Montour,,2017,3.9,8827,9186,359
42093,PA,Montour,,2018,3.6,8859,9192,333
42093,PA,Montour,,2019,3.7,8922,9262,340
42093,PA,Montour,,2020,6.2,8531,9096,565
42093,PA,Montour,,2021,4.4,8609,9001,392
42095,PA,Northampton,,2007,4.6,145040,151980,6940
42095,PA,Northampton,,2008,5.5,145096,153524,8428
42095,PA,Northampton,,2009,8.3,140937,153704,12767
42095,PA,Northampton,,2010,8.5,138498,151401,12903
42095,PA,Northampton,,2011,8.1,140012,152320,12308
42095,PA,Northampton,,2012,7.9,142791,155096,12305
42095,PA,Northampton,,2013,7.2,144133,155251,11118
42095,PA,Northampton,,2014,6,145875,155203,9328
42095,PA,Northampton,,2015,5.4,148266,156657,8391
42095,PA,Northampton,,2016,5.1,150961,159085,8124
42095,PA,Northampton,,2017,5,152125,160098,7973
42095,PA,Northampton,,2018,4.6,153991,161415,7424
42095,PA,Northampton,,2019,4.6,156047,163543,7496
42095,PA,Northampton,,2020,8.9,146914,161346,14432
42095,PA,Northampton,,2021,5.9,152487,162125,9638
42097,PA,Northumberland,,2007,5.3,44856,47347,2491
42097,PA,Northumberland,,2008,6.6,44802,47945,3143
42097,PA,Northumberland,,2009,9.6,42783,47318,4535
42097,PA,Northumberland,,2010,9.7,40841,45204,4363
42097,PA,Northumberland,,2011,9,40820,44850,4030
42097,PA,Northumberland,,2012,8.9,40967,44973,4006
42097,PA,Northumberland,,2013,8.5,40780,44551,3771
42097,PA,Northumberland,,2014,6.8,40904,43887,2983
42097,PA,Northumberland,,2015,6.2,40755,43454,2699
42097,PA,Northumberland,,2016,6.2,41296,44014,2718
42097,PA,Northumberland,,2017,5.8,41537,44074,2537
42097,PA,Northumberland,,2018,5.4,41201,43570,2369
42097,PA,Northumberland,,2019,5.7,41130,43635,2505
42097,PA,Northumberland,,2020,9.4,38777,42800,4023
42097,PA,Northumberland,,2021,6.8,39224,42079,2855
42099,PA,Perry,,2007,4.2,23540,24570,1030
42099,PA,Perry,,2008,5.2,23650,24957,1307
42099,PA,Perry,,2009,7.8,22806,24729,1923
42099,PA,Perry,,2010,7.8,22955,24908,1953
42099,PA,Perry,,2011,7.2,22887,24668,1781
42099,PA,Perry,,2012,7.1,22863,24609,1746
42099,PA,Perry,,2013,6.3,22652,24181,1529
42099,PA,Perry,,2014,5.2,22732,23984,1252
42099,PA,Perry,,2015,4.5,23016,24113,1097
42099,PA,Perry,,2016,4.6,23206,24316,1110
42099,PA,Perry,,2017,4.4,23447,24514,1067
42099,PA,Perry,,2018,3.9,23542,24494,952
42099,PA,Perry,,2019,3.8,23820,24762,942
42099,PA,Perry,,2020,6.8,22681,24330,1649
42099,PA,Perry,,2021,4.7,23084,24211,1127
42101,PA,Philadelphia,,2007,6.3,582110,621257,39147
42101,PA,Philadelphia,,2008,7.1,584793,629517,44724
42101,PA,Philadelphia,,2009,9.7,589286,652248,62962
42101,PA,Philadelphia,,2010,10.3,614806,685108,70302
42101,PA,Philadelphia,,2011,10.5,616991,689005,72014
42101,PA,Philadelphia,,2012,10.6,623042,697304,74262
42101,PA,Philadelphia,,2013,10,625827,695193,69366
42101,PA,Philadelphia,,2014,8.2,633841,690525,56684
42101,PA,Philadelphia,,2015,7.2,645690,696073,50383
42101,PA,Philadelphia,,2016,6.7,657187,704284,47097
42101,PA,Philadelphia,,2017,6.3,666564,711750,45186
42101,PA,Philadelphia,,2018,5.8,676682,718024,41342
42101,PA,Philadelphia,,2019,5.7,690507,732044,41537
42101,PA,Philadelphia,,2020,12.4,644480,736067,91587
42101,PA,Philadelphia,,2021,9.2,655154,721225,66071
42103,PA,Pike,,2007,5.6,26106,27658,1552
42103,PA,Pike,,2008,6,26680,28395,1715
42103,PA,Pike,,2009,9,25841,28395,2554
42103,PA,Pike,,2010,9.4,23592,26045,2453
42103,PA,Pike,,2011,9.7,23515,26040,2525
42103,PA,Pike,,2012,9.9,23431,26003,2572
42103,PA,Pike,,2013,9.3,23380,25787,2407
42103,PA,Pike,,2014,7.7,23209,25135,1926
42103,PA,Pike,,2015,6.7,23335,24998,1663
42103,PA,Pike,,2016,6.3,23395,24968,1573
42103,PA,Pike,,2017,6,23496,25002,1506
42103,PA,Pike,,2018,5.5,23975,25374,1399
42103,PA,Pike,,2019,5.7,24181,25640,1459
42103,PA,Pike,,2020,10.5,22737,25415,2678
42103,PA,Pike,,2021,7.3,23327,25175,1848
42105,PA,Potter,,2007,7.5,7189,7770,581
42105,PA,Potter,,2008,7.2,7213,7771,558
42105,PA,Potter,,2009,11,6866,7715,849
42105,PA,Potter,,2010,10.1,6988,7773,785
42105,PA,Potter,,2011,9,7115,7815,700
42105,PA,Potter,,2012,8.9,7204,7909,705
42105,PA,Potter,,2013,9,7022,7716,694
42105,PA,Potter,,2014,7.5,6998,7562,564
42105,PA,Potter,,2015,7.2,6852,7380,528
42105,PA,Potter,,2016,7.8,6816,7390,574
42105,PA,Potter,,2017,6.6,6852,7337,485
42105,PA,Potter,,2018,5.5,6855,7257,402
42105,PA,Potter,,2019,6,6871,7311,440
42105,PA,Potter,,2020,9.4,6607,7289,682
42105,PA,Potter,,2021,6.8,6635,7122,487
42107,PA,Schuylkill,,2007,5.2,69833,73652,3819
42107,PA,Schuylkill,,2008,6.2,69719,74363,4644
42107,PA,Schuylkill,,2009,9.8,66678,73915,7237
42107,PA,Schuylkill,,2010,10.3,63169,70417,7248
42107,PA,Schuylkill,,2011,9.6,63197,69888,6691
42107,PA,Schuylkill,,2012,9.5,64056,70802,6746
42107,PA,Schuylkill,,2013,8.9,63724,69954,6230
42107,PA,Schuylkill,,2014,7.2,63979,68912,4933
42107,PA,Schuylkill,,2015,6.4,63858,68229,4371
42107,PA,Schuylkill,,2016,6.1,63524,67661,4137
42107,PA,Schuylkill,,2017,5.9,62924,66896,3972
42107,PA,Schuylkill,,2018,5.4,63252,66841,3589
42107,PA,Schuylkill,,2019,5.6,63536,67270,3734
42107,PA,Schuylkill,,2020,9.3,60768,66976,6208
42107,PA,Schuylkill,,2021,6.8,60936,65357,4421
42109,PA,Snyder,,2007,4.8,18893,19847,954
42109,PA,Snyder,,2008,6.1,18576,19786,1210
42109,PA,Snyder,,2009,8.9,17648,19374,1726
42109,PA,Snyder,,2010,8.1,18416,20045,1629
42109,PA,Snyder,,2011,7.5,18281,19769,1488
42109,PA,Snyder,,2012,7.4,18322,19793,1471
42109,PA,Snyder,,2013,6.6,18371,19679,1308
42109,PA,Snyder,,2014,5.2,18802,19839,1037
42109,PA,Snyder,,2015,4.8,19111,20070,959
42109,PA,Snyder,,2016,4.6,19598,20547,949
42109,PA,Snyder,,2017,4.5,19970,20907,937
42109,PA,Snyder,,2018,4.1,19679,20526,847
42109,PA,Snyder,,2019,5.6,19188,20319,1131
42109,PA,Snyder,,2020,7.7,18143,19648,1505
42109,PA,Snyder,,2021,5.2,18557,19565,1008
42111,PA,Somerset,,2007,5.7,36693,38908,2215
42111,PA,Somerset,,2008,6.4,36865,39371,2506
42111,PA,Somerset,,2009,8.4,35574,38853,3279
42111,PA,Somerset,,2010,9.3,33580,37019,3439
42111,PA,Somerset,,2011,8.7,33641,36857,3216
42111,PA,Somerset,,2012,8.7,33332,36496,3164
42111,PA,Somerset,,2013,8.9,32472,35663,3191
42111,PA,Somerset,,2014,7.4,32389,34975,2586
42111,PA,Somerset,,2015,7,32090,34490,2400
42111,PA,Somerset,,2016,7.1,31799,34234,2435
42111,PA,Somerset,,2017,6.1,31868,33956,2088
42111,PA,Somerset,,2018,5.3,32116,33914,1798
42111,PA,Somerset,,2019,5.5,32001,33848,1847
42111,PA,Somerset,,2020,9.5,30019,33152,3133
42111,PA,Somerset,,2021,6.7,30399,32597,2198
42113,PA,Sullivan,,2007,4.8,2855,2998,143
42113,PA,Sullivan,,2008,5.7,2829,3000,171
42113,PA,Sullivan,,2009,8.4,2770,3023,253
42113,PA,Sullivan,,2010,7.8,2722,2952,230
42113,PA,Sullivan,,2011,7.2,2817,3034,217
42113,PA,Sullivan,,2012,7.7,2859,3096,237
42113,PA,Sullivan,,2013,8,2802,3047,245
42113,PA,Sullivan,,2014,6.2,2868,3057,189
42113,PA,Sullivan,,2015,6.3,2845,3036,191
42113,PA,Sullivan,,2016,7.1,2642,2844,202
42113,PA,Sullivan,,2017,6.1,2551,2716,165
42113,PA,Sullivan,,2018,5.1,2579,2719,140
42113,PA,Sullivan,,2019,5.4,2539,2683,144
42113,PA,Sullivan,,2020,8.5,2391,2614,223
42113,PA,Sullivan,,2021,7.4,2380,2569,189
42115,PA,Susquehanna,,2007,4.5,20685,21659,974
42115,PA,Susquehanna,,2008,5.7,20740,21990,1250
42115,PA,Susquehanna,,2009,8.4,19958,21794,1836
42115,PA,Susquehanna,,2010,8.5,19729,21552,1823
42115,PA,Susquehanna,,2011,7.8,20178,21884,1706
42115,PA,Susquehanna,,2012,7.4,20790,22462,1672
42115,PA,Susquehanna,,2013,6.9,20730,22264,1534
42115,PA,Susquehanna,,2014,6,20136,21421,1285
42115,PA,Susquehanna,,2015,5.7,20192,21410,1218
42115,PA,Susquehanna,,2016,5.6,19729,20904,1175
42115,PA,Susquehanna,,2017,4.8,19787,20786,999
42115,PA,Susquehanna,,2018,4.1,19823,20681,858
42115,PA,Susquehanna,,2019,4.4,19835,20751,916
42115,PA,Susquehanna,,2020,7.3,18558,20029,1471
42115,PA,Susquehanna,,2021,5.5,18865,19956,1091
42117,PA,Tioga,,2007,5.7,19239,20394,1155
42117,PA,Tioga,,2008,6.1,19334,20588,1254
42117,PA,Tioga,,2009,9.6,18446,20410,1964
42117,PA,Tioga,,2010,8,18508,20127,1619
42117,PA,Tioga,,2011,6.9,19704,21153,1449
42117,PA,Tioga,,2012,7.5,20065,21682,1617
42117,PA,Tioga,,2013,8.3,19426,21184,1758
42117,PA,Tioga,,2014,7,19004,20438,1434
42117,PA,Tioga,,2015,6.6,18994,20344,1350
42117,PA,Tioga,,2016,7.1,18489,19892,1403
42117,PA,Tioga,,2017,6.1,18126,19296,1170
42117,PA,Tioga,,2018,5.4,18028,19050,1022
42117,PA,Tioga,,2019,5.4,18185,19228,1043
42117,PA,Tioga,,2020,9,17382,19110,1728
42117,PA,Tioga,,2021,6.6,17633,18887,1254
42119,PA,Union,,2007,5.4,16728,17692,964
42119,PA,Union,,2008,6.3,16698,17818,1120
42119,PA,Union,,2009,9,16094,17680,1586
42119,PA,Union,,2010,7.5,17704,19138,1434
42119,PA,Union,,2011,6.6,17768,19026,1258
42119,PA,Union,,2012,6.3,17895,19096,1201
42119,PA,Union,,2013,6.1,17919,19090,1171
42119,PA,Union,,2014,5,18143,19106,963
42119,PA,Union,,2015,4.6,18432,19312,880
42119,PA,Union,,2016,4.7,18874,19811,937
42119,PA,Union,,2017,4.4,18974,19854,880
42119,PA,Union,,2018,3.9,19044,19817,773
42119,PA,Union,,2019,4.1,19306,20133,827
42119,PA,Union,,2020,6.7,18234,19552,1318
42119,PA,Union,,2021,4.7,18560,19470,910
42121,PA,Venango,,2007,5.1,24765,26093,1328
42121,PA,Venango,,2008,5.7,24895,26400,1505
42121,PA,Venango,,2009,8.6,24073,26337,2264
42121,PA,Venango,,2010,8.2,24172,26341,2169
42121,PA,Venango,,2011,7.2,24439,26344,1905
42121,PA,Venango,,2012,7.5,24276,26245,1969
42121,PA,Venango,,2013,7.5,23285,25180,1895
42121,PA,Venango,,2014,6,23190,24669,1479
42121,PA,Venango,,2015,6.1,22991,24472,1481
42121,PA,Venango,,2016,7.2,22040,23742,1702
42121,PA,Venango,,2017,6.2,21738,23175,1437
42121,PA,Venango,,2018,5.1,21528,22683,1155
42121,PA,Venango,,2019,4.9,21537,22657,1120
42121,PA,Venango,,2020,8.9,20410,22410,2000
42121,PA,Venango,,2021,6.8,20370,21865,1495
42123,PA,Warren,,2007,4.7,20425,21436,1011
42123,PA,Warren,,2008,5.2,20647,21785,1138
42123,PA,Warren,,2009,7.8,20202,21900,1698
42123,PA,Warren,,2010,8,19162,20830,1668
42123,PA,Warren,,2011,7.3,18904,20403,1499
42123,PA,Warren,,2012,6.7,19173,20548,1375
42123,PA,Warren,,2013,6.2,19107,20361,1254
42123,PA,Warren,,2014,5.3,19075,20151,1076
42123,PA,Warren,,2015,5.1,18948,19962,1014
42123,PA,Warren,,2016,5.4,18732,19804,1072
42123,PA,Warren,,2017,5.4,18437,19481,1044
42123,PA,Warren,,2018,4.6,18373,19262,889
42123,PA,Warren,,2019,4.6,18262,19150,888
42123,PA,Warren,,2020,8.1,17332,18862,1530
42123,PA,Warren,,2021,6.7,16814,18026,1212
42125,PA,Washington,,2007,4.7,99199,104136,4937
42125,PA,Washington,,2008,5.2,100664,106229,5565
42125,PA,Washington,,2009,7.5,98426,106462,8036
42125,PA,Washington,,2010,7.9,96722,104964,8242
42125,PA,Washington,,2011,7.2,98073,105684,7611
42125,PA,Washington,,2012,7,99685,107225,7540
42125,PA,Washington,,2013,6.7,99487,106642,7155
42125,PA,Washington,,2014,5.8,99879,106059,6180
42125,PA,Washington,,2015,5.7,100616,106670,6054
42125,PA,Washington,,2016,6,100914,107411,6497
42125,PA,Washington,,2017,5.3,101631,107341,5710
42125,PA,Washington,,2018,4.5,102663,107488,4825
42125,PA,Washington,,2019,4.6,103372,108359,4987
42125,PA,Washington,,2020,9.4,96787,106805,10018
42125,PA,Washington,,2021,6.6,97826,104785,6959
42127,PA,Wayne,,2007,4.3,24554,25668,1114
42127,PA,Wayne,,2008,5.2,24349,25697,1348
42127,PA,Wayne,,2009,7.4,23755,25643,1888
42127,PA,Wayne,,2010,7.9,21690,23541,1851
42127,PA,Wayne,,2011,7.9,21384,23227,1843
42127,PA,Wayne,,2012,7.9,21254,23073,1819
42127,PA,Wayne,,2013,7.6,20911,22635,1724
42127,PA,Wayne,,2014,6.5,20876,22326,1450
42127,PA,Wayne,,2015,5.9,20960,22282,1322
42127,PA,Wayne,,2016,5.7,21282,22564,1282
42127,PA,Wayne,,2017,5.2,21448,22623,1175
42127,PA,Wayne,,2018,4.9,21527,22639,1112
42127,PA,Wayne,,2019,4.9,21628,22733,1105
42127,PA,Wayne,,2020,9.2,20338,22391,2053
42127,PA,Wayne,,2021,6.6,20898,22379,1481
42129,PA,Westmoreland,,2007,4.7,177143,185955,8812
42129,PA,Westmoreland,,2008,5.3,178647,188667,10020
42129,PA,Westmoreland,,2009,7.7,174167,188747,14580
42129,PA,Westmoreland,,2010,8,169950,184724,14774
42129,PA,Westmoreland,,2011,7.4,171833,185548,13715
42129,PA,Westmoreland,,2012,7.2,173745,187255,13510
42129,PA,Westmoreland,,2013,6.8,173182,185755,12573
42129,PA,Westmoreland,,2014,5.8,172387,183031,10644
42129,PA,Westmoreland,,2015,5.5,172937,182989,10052
42129,PA,Westmoreland,,2016,5.8,172471,183064,10593
42129,PA,Westmoreland,,2017,5.3,172856,182464,9608
42129,PA,Westmoreland,,2018,4.6,173627,181986,8359
42129,PA,Westmoreland,,2019,4.6,174387,182809,8422
42129,PA,Westmoreland,,2020,9.1,162500,178773,16273
42129,PA,Westmoreland,,2021,6.3,164272,175353,11081
42131,PA,Wyoming,,2007,5.5,13639,14426,787
42131,PA,Wyoming,,2008,6.1,13643,14523,880
42131,PA,Wyoming,,2009,8.4,13230,14446,1216
42131,PA,Wyoming,,2010,8.5,13072,14287,1215
42131,PA,Wyoming,,2011,8.6,13065,14296,1231
42131,PA,Wyoming,,2012,8.8,13102,14360,1258
42131,PA,Wyoming,,2013,8.4,13079,14271,1192
42131,PA,Wyoming,,2014,6.7,13299,14259,960
42131,PA,Wyoming,,2015,6.2,13246,14122,876
42131,PA,Wyoming,,2016,6.1,13261,14127,866
42131,PA,Wyoming,,2017,5.4,13227,13977,750
42131,PA,Wyoming,,2018,4.7,13109,13756,647
42131,PA,Wyoming,,2019,5,13012,13697,685
42131,PA,Wyoming,,2020,8.4,12215,13340,1125
42131,PA,Wyoming,,2021,6.3,12380,13216,836
42133,PA,York,,2007,3.9,216627,225503,8876
42133,PA,York,,2008,4.7,218000,228801,10801
42133,PA,York,,2009,8.1,208451,226702,18251
42133,PA,York,,2010,8.2,210966,229698,18732
42133,PA,York,,2011,7.3,213294,230193,16899
42133,PA,York,,2012,7.3,215842,232731,16889
42133,PA,York,,2013,6.5,216313,231382,15069
42133,PA,York,,2014,5.5,217797,230353,12556
42133,PA,York,,2015,4.8,221333,232597,11264
42133,PA,York,,2016,4.6,224336,235081,10745
42133,PA,York,,2017,4.4,226281,236803,10522
42133,PA,York,,2018,4,227519,237045,9526
42133,PA,York,,2019,3.9,229069,238484,9415
42133,PA,York,,2020,8,217448,236371,18923
42133,PA,York,,2021,5.4,222181,234914,12733
44000,RI,Rhode Island,,2007,5.1,541956,571086,29130
44000,RI,Rhode Island,,2008,7.6,525187,568229,43042
44000,RI,Rhode Island,,2009,11.4,505930,571203,65273
44000,RI,Rhode Island,,2010,11.6,504957,571505,66548
44000,RI,Rhode Island,,2011,11,500109,562061,61952
44000,RI,Rhode Island,,2012,10.2,502897,560204,57307
44000,RI,Rhode Island,,2013,9.5,505776,558747,52971
44000,RI,Rhode Island,,2014,7.8,513406,556635,43229
44000,RI,Rhode Island,,2015,6,521767,555272,33505
44000,RI,Rhode Island,,2016,5.2,524438,553231,28793
44000,RI,Rhode Island,,2017,4.5,542552,568144,25592
44000,RI,Rhode Island,,2018,4.1,547994,571152,23158
44000,RI,Rhode Island,,2019,3.6,552057,572382,20325
44000,RI,Rhode Island,,2020,9.2,514911,567055,52144
44000,RI,Rhode Island,,2021,5.6,538969,571034,32065
44001,RI,Bristol,,2007,4.4,26333,27550,1217
44001,RI,Bristol,,2008,6.6,25548,27358,1810
44001,RI,Bristol,,2009,10.5,24401,27256,2855
44001,RI,Bristol,,2010,10.1,24421,27168,2747
44001,RI,Bristol,,2011,9.6,23852,26383,2531
44001,RI,Bristol,,2012,8.8,23960,26281,2321
44001,RI,Bristol,,2013,8.1,24205,26338,2133
44001,RI,Bristol,,2014,6.8,24416,26191,1775
44001,RI,Bristol,,2015,5.3,24805,26199,1394
44001,RI,Bristol,,2016,4.6,24919,26132,1213
44001,RI,Bristol,,2017,3.9,25619,26654,1035
44001,RI,Bristol,,2018,3.5,25792,26714,922
44001,RI,Bristol,,2019,3,25844,26644,800
44001,RI,Bristol,,2020,7.4,24111,26049,1938
44001,RI,Bristol,,2021,4.7,25239,26496,1257
44003,RI,Kent,,2007,4.9,92665,97450,4785
44003,RI,Kent,,2008,7.2,90029,96998,6969
44003,RI,Kent,,2009,10.9,86868,97463,10595
44003,RI,Kent,,2010,11.5,84080,95049,10969
44003,RI,Kent,,2011,10.6,83176,93057,9881
44003,RI,Kent,,2012,9.8,83445,92497,9052
44003,RI,Kent,,2013,9,83894,92146,8252
44003,RI,Kent,,2014,7.2,84952,91577,6625
44003,RI,Kent,,2015,5.6,86087,91150,5063
44003,RI,Kent,,2016,4.7,86415,90719,4304
44003,RI,Kent,,2017,4.1,88649,92476,3827
44003,RI,Kent,,2018,3.7,89785,93212,3427
44003,RI,Kent,,2019,3.2,90524,93518,2994
44003,RI,Kent,,2020,8.6,84857,92814,7957
44003,RI,Kent,,2021,5.2,88828,93708,4880
44005,RI,Newport,,2007,4.5,43198,45216,2018
44005,RI,Newport,,2008,6.6,40960,43861,2901
44005,RI,Newport,,2009,10.2,39272,43711,4439
44005,RI,Newport,,2010,10.4,40701,45416,4715
44005,RI,Newport,,2011,10,40127,44606,4479
44005,RI,Newport,,2012,9.1,40313,44361,4048
44005,RI,Newport,,2013,8.7,40598,44463,3865
44005,RI,Newport,,2014,6.9,41069,44131,3062
44005,RI,Newport,,2015,5.4,41740,44144,2404
44005,RI,Newport,,2016,4.7,42145,44231,2086
44005,RI,Newport,,2017,3.9,43823,45621,1798
44005,RI,Newport,,2018,3.6,43867,45483,1616
44005,RI,Newport,,2019,3.1,43864,45270,1406
44005,RI,Newport,,2020,8,40912,44473,3561
44005,RI,Newport,,2021,4.9,42827,45042,2215
44007,RI,Providence,,2007,5.5,308909,326920,18011
44007,RI,Providence,,2008,8.2,299594,326229,26635
44007,RI,Providence,,2009,12.3,288605,329173,40568
44007,RI,Providence,,2010,12.2,291192,331760,40568
44007,RI,Providence,,2011,11.6,289337,327303,37966
44007,RI,Providence,,2012,10.8,291552,326755,35203
44007,RI,Providence,,2013,10,293165,325702,32537
44007,RI,Providence,,2014,8.2,298306,325022,26716
44007,RI,Providence,,2015,6.4,303657,324384,20727
44007,RI,Providence,,2016,5.5,305286,323196,17910
44007,RI,Providence,,2017,4.8,316683,332757,16074
44007,RI,Providence,,2018,4.4,319949,334606,14657
44007,RI,Providence,,2019,3.8,323216,336130,12914
44007,RI,Providence,,2020,10,301230,334632,33402
44007,RI,Providence,,2021,6,315326,335620,20294
44009,RI,Washington,,2007,4.2,70850,73949,3099
44009,RI,Washington,,2008,6.4,69058,73785,4727
44009,RI,Washington,,2009,9.3,66786,73604,6818
44009,RI,Washington,,2010,10.5,64563,72113,7550
44009,RI,Washington,,2011,10,63618,70715,7097
44009,RI,Washington,,2012,9.5,63628,70310,6682
44009,RI,Washington,,2013,8.8,63914,70098,6184
44009,RI,Washington,,2014,7.2,64662,69713,5051
44009,RI,Washington,,2015,5.6,65478,69395,3917
44009,RI,Washington,,2016,4.8,65674,68954,3280
44009,RI,Washington,,2017,4,67778,70638,2860
44009,RI,Washington,,2018,3.6,68601,71137,2536
44009,RI,Washington,,2019,3.1,68609,70819,2210
44009,RI,Washington,,2020,7.6,63803,69088,5285
44009,RI,Washington,,2021,4.9,66749,70167,3418
45000,SC,South Carolina,,2007,6.1,2024493,2155198,130705
45000,SC,South Carolina,,2008,7.3,2002903,2160084,157181
45000,SC,South Carolina,,2009,11.4,1919307,2166737,247430
45000,SC,South Carolina,,2010,11.3,1928442,2174535,246093
45000,SC,South Carolina,,2011,10.4,1957493,2185171,227678
45000,SC,South Carolina,,2012,9,1992957,2190203,197246
45000,SC,South Carolina,,2013,7.4,2034404,2197876,163472
45000,SC,South Carolina,,2014,6.3,2082941,2222426,139485
45000,SC,South Carolina,,2015,5.9,2134087,2267837,133750
45000,SC,South Carolina,,2016,4.9,2174301,2286054,111753
45000,SC,South Carolina,,2017,4.2,2166708,2261766,95058
45000,SC,South Carolina,,2018,3.4,2202377,2279431,77054
45000,SC,South Carolina,,2019,2.8,2256313,2321189,64876
45000,SC,South Carolina,,2020,6,2191331,2330863,139532
45000,SC,South Carolina,,2021,4,2269813,2364366,94553
45001,SC,Abbeville,,2007,8.7,10680,11693,1013
45001,SC,Abbeville,,2008,8.6,10452,11439,987
45001,SC,Abbeville,,2009,14.4,9709,11339,1630
45001,SC,Abbeville,,2010,13.8,9506,11026,1520
45001,SC,Abbeville,,2011,12.3,9493,10825,1332
45001,SC,Abbeville,,2012,10.4,9584,10697,1113
45001,SC,Abbeville,,2013,9.3,9590,10570,980
45001,SC,Abbeville,,2014,7.5,9776,10570,794
45001,SC,Abbeville,,2015,6.8,9637,10342,705
45001,SC,Abbeville,,2016,5.4,9702,10252,550
45001,SC,Abbeville,,2017,4.5,9316,9758,442
45001,SC,Abbeville,,2018,3.9,9334,9715,381
45001,SC,Abbeville,,2019,3.3,9502,9824,322
45001,SC,Abbeville,,2020,6.5,9107,9736,629
45001,SC,Abbeville,,2021,4.5,9184,9621,437
45003,SC,Aiken,,2007,5.8,71235,75585,4350
45003,SC,Aiken,,2008,6.3,70744,75469,4725
45003,SC,Aiken,,2009,9.4,69895,77105,7210
45003,SC,Aiken,,2010,9.4,66098,72970,6872
45003,SC,Aiken,,2011,9.1,66901,73635,6734
45003,SC,Aiken,,2012,8.4,66929,73077,6148
45003,SC,Aiken,,2013,7.4,67531,72889,5358
45003,SC,Aiken,,2014,6.3,68338,72954,4616
45003,SC,Aiken,,2015,5.8,69572,73880,4308
45003,SC,Aiken,,2016,4.9,70293,73907,3614
45003,SC,Aiken,,2017,4,69563,72489,2926
45003,SC,Aiken,,2018,3.3,70013,72399,2386
45003,SC,Aiken,,2019,2.8,71349,73432,2083
45003,SC,Aiken,,2020,4.9,70057,73641,3584
45003,SC,Aiken,,2021,3.4,71580,74070,2490
45005,SC,Allendale,,2007,11.1,3211,3610,399
45005,SC,Allendale,,2008,17.5,2793,3387,594
45005,SC,Allendale,,2009,20.9,2709,3425,716
45005,SC,Allendale,,2010,19.3,2704,3352,648
45005,SC,Allendale,,2011,18.1,2693,3290,597
45005,SC,Allendale,,2012,16.6,2612,3132,520
45005,SC,Allendale,,2013,13.7,2672,3096,424
45005,SC,Allendale,,2014,11.9,2523,2863,340
45005,SC,Allendale,,2015,11.2,2438,2746,308
45005,SC,Allendale,,2016,8.4,2429,2651,222
45005,SC,Allendale,,2017,6.8,2466,2646,180
45005,SC,Allendale,,2018,5.6,2550,2702,152
45005,SC,Allendale,,2019,5.2,2458,2594,136
45005,SC,Allendale,,2020,9.3,2310,2547,237
45005,SC,Allendale,,2021,7.8,2255,2445,190
45007,SC,Anderson,,2007,6.2,80824,86160,5336
45007,SC,Anderson,,2008,7.2,79806,86021,6215
45007,SC,Anderson,,2009,12.2,75294,85741,10447
45007,SC,Anderson,,2010,11.7,75908,85992,10084
45007,SC,Anderson,,2011,10.2,77496,86285,8789
45007,SC,Anderson,,2012,8.7,78287,85717,7430
45007,SC,Anderson,,2013,6.9,80126,86082,5956
45007,SC,Anderson,,2014,5.8,81652,86680,5028
45007,SC,Anderson,,2015,5.3,83693,88419,4726
45007,SC,Anderson,,2016,4.5,84665,88643,3978
45007,SC,Anderson,,2017,3.9,84199,87576,3377
45007,SC,Anderson,,2018,3.2,85287,88094,2807
45007,SC,Anderson,,2019,2.7,86575,88935,2360
45007,SC,Anderson,,2020,5.8,83340,88440,5100
45007,SC,Anderson,,2021,3.7,86686,90029,3343
45009,SC,Bamberg,,2007,9.8,5717,6335,618
45009,SC,Bamberg,,2008,12,5633,6401,768
45009,SC,Bamberg,,2009,15.9,5453,6482,1029
45009,SC,Bamberg,,2010,16.3,5499,6573,1074
45009,SC,Bamberg,,2011,16,5322,6338,1016
45009,SC,Bamberg,,2012,15.6,4895,5799,904
45009,SC,Bamberg,,2013,13.2,4853,5589,736
45009,SC,Bamberg,,2014,11.3,4929,5555,626
45009,SC,Bamberg,,2015,10.4,4888,5455,567
45009,SC,Bamberg,,2016,8.8,4827,5295,468
45009,SC,Bamberg,,2017,7.4,4661,5031,370
45009,SC,Bamberg,,2018,6.4,4584,4898,314
45009,SC,Bamberg,,2019,5.4,4569,4831,262
45009,SC,Bamberg,,2020,8.8,4327,4742,415
45009,SC,Bamberg,,2021,7.5,4341,4691,350
45011,SC,Barnwell,,2007,10,8072,8966,894
45011,SC,Barnwell,,2008,11.6,7880,8915,1035
45011,SC,Barnwell,,2009,17.4,7490,9066,1576
45011,SC,Barnwell,,2010,16.8,7969,9582,1613
45011,SC,Barnwell,,2011,15,7848,9237,1389
45011,SC,Barnwell,,2012,13.6,7744,8963,1219
45011,SC,Barnwell,,2013,11.8,7700,8733,1033
45011,SC,Barnwell,,2014,9.4,7822,8637,815
45011,SC,Barnwell,,2015,8.9,7624,8369,745
45011,SC,Barnwell,,2016,7.2,7462,8043,581
45011,SC,Barnwell,,2017,5.9,7378,7843,465
45011,SC,Barnwell,,2018,4.7,7745,8127,382
45011,SC,Barnwell,,2019,4.2,7645,7978,333
45011,SC,Barnwell,,2020,7.2,7193,7750,557
45011,SC,Barnwell,,2021,6.5,7079,7572,493
45013,SC,Beaufort,,2007,4.7,61689,64720,3031
45013,SC,Beaufort,,2008,5.7,60558,64201,3643
45013,SC,Beaufort,,2009,8.9,57658,63266,5608
45013,SC,Beaufort,,2010,8.8,60100,65881,5781
45013,SC,Beaufort,,2011,8.6,60131,65765,5634
45013,SC,Beaufort,,2012,7.4,61164,66043,4879
45013,SC,Beaufort,,2013,6.2,63279,67472,4193
45013,SC,Beaufort,,2014,5.5,65598,69430,3832
45013,SC,Beaufort,,2015,5.4,67743,71613,3870
45013,SC,Beaufort,,2016,4.7,68914,72294,3380
45013,SC,Beaufort,,2017,4,69863,72775,2912
45013,SC,Beaufort,,2018,3.2,71877,74241,2364
45013,SC,Beaufort,,2019,2.6,73756,75746,1990
45013,SC,Beaufort,,2020,5.3,70743,74689,3946
45013,SC,Beaufort,,2021,3.5,73502,76131,2629
45015,SC,Berkeley,,2007,5.1,74615,78657,4042
45015,SC,Berkeley,,2008,6.6,75200,80474,5274
45015,SC,Berkeley,,2009,10.4,72536,80970,8434
45015,SC,Berkeley,,2010,10.2,74974,83455,8481
45015,SC,Berkeley,,2011,9.5,78035,86190,8155
45015,SC,Berkeley,,2012,8.2,81276,88556,7280
45015,SC,Berkeley,,2013,6.8,83118,89180,6062
45015,SC,Berkeley,,2014,5.8,85561,90863,5302
45015,SC,Berkeley,,2015,5.4,88352,93431,5079
45015,SC,Berkeley,,2016,4.5,92384,96705,4321
45015,SC,Berkeley,,2017,3.8,94119,97791,3672
45015,SC,Berkeley,,2018,3,96329,99297,2968
45015,SC,Berkeley,,2019,2.5,100812,103381,2569
45015,SC,Berkeley,,2020,5.4,98469,104073,5604
45015,SC,Berkeley,,2021,3.6,103265,107149,3884
45017,SC,Calhoun,,2007,6.7,6525,6994,469
45017,SC,Calhoun,,2008,8.2,6266,6823,557
45017,SC,Calhoun,,2009,12.4,5929,6772,843
45017,SC,Calhoun,,2010,12.5,6221,7108,887
45017,SC,Calhoun,,2011,12.2,6252,7123,871
45017,SC,Calhoun,,2012,11,6195,6958,763
45017,SC,Calhoun,,2013,9.3,6299,6948,649
45017,SC,Calhoun,,2014,7.8,6343,6880,537
45017,SC,Calhoun,,2015,7.1,6401,6887,486
45017,SC,Calhoun,,2016,6,6462,6878,416
45017,SC,Calhoun,,2017,5.1,6259,6597,338
45017,SC,Calhoun,,2018,4.2,6102,6372,270
45017,SC,Calhoun,,2019,3.5,6181,6406,225
45017,SC,Calhoun,,2020,6,5960,6339,379
45017,SC,Calhoun,,2021,4.5,6122,6411,289
45019,SC,Charleston,,2007,4.7,167524,175734,8210
45019,SC,Charleston,,2008,5.7,165562,175535,9973
45019,SC,Charleston,,2009,8.9,159095,174633,15538
45019,SC,Charleston,,2010,8.9,164252,180349,16097
45019,SC,Charleston,,2011,8.2,168779,183865,15086
45019,SC,Charleston,,2012,7,173805,186874,13069
45019,SC,Charleston,,2013,5.7,177472,188255,10783
45019,SC,Charleston,,2014,5,182709,192347,9638
45019,SC,Charleston,,2015,4.8,188588,198083,9495
45019,SC,Charleston,,2016,4,193146,201188,8042
45019,SC,Charleston,,2017,3.4,192647,199512,6865
45019,SC,Charleston,,2018,2.7,196411,201964,5553
45019,SC,Charleston,,2019,2.3,202035,206718,4683
45019,SC,Charleston,,2020,6.2,193644,206334,12690
45019,SC,Charleston,,2021,3.6,203337,210944,7607
45021,SC,Cherokee,,2007,7.3,23763,25627,1864
45021,SC,Cherokee,,2008,9.7,23307,25801,2494
45021,SC,Cherokee,,2009,16.1,21636,25778,4142
45021,SC,Cherokee,,2010,16,20096,23910,3814
45021,SC,Cherokee,,2011,14.5,20283,23736,3453
45021,SC,Cherokee,,2012,12.6,20782,23768,2986
45021,SC,Cherokee,,2013,10.2,21355,23787,2432
45021,SC,Cherokee,,2014,8.1,21735,23647,1912
45021,SC,Cherokee,,2015,7.1,21792,23446,1654
45021,SC,Cherokee,,2016,5.8,22085,23456,1371
45021,SC,Cherokee,,2017,4.9,22187,23326,1139
45021,SC,Cherokee,,2018,3.6,23625,24502,877
45021,SC,Cherokee,,2019,3,23905,24641,736
45021,SC,Cherokee,,2020,7.8,22807,24736,1929
45021,SC,Cherokee,,2021,5.1,23561,24817,1256
45023,SC,Chester,,2007,11.6,13918,15752,1834
45023,SC,Chester,,2008,12.6,13549,15498,1949
45023,SC,Chester,,2009,20.1,12591,15756,3165
45023,SC,Chester,,2010,19.5,11943,14837,2894
45023,SC,Chester,,2011,17.1,11985,14462,2477
45023,SC,Chester,,2012,14.5,12005,14039,2034
45023,SC,Chester,,2013,11.9,12069,13703,1634
45023,SC,Chester,,2014,9.4,12154,13418,1264
45023,SC,Chester,,2015,8.3,12328,13443,1115
45023,SC,Chester,,2016,7,12404,13344,940
45023,SC,Chester,,2017,6,12245,13030,785
45023,SC,Chester,,2018,4.8,12183,12801,618
45023,SC,Chester,,2019,4.1,12397,12927,530
45023,SC,Chester,,2020,8.8,11997,13154,1157
45023,SC,Chester,,2021,5.9,12490,13279,789
45025,SC,Chesterfield,,2007,8.3,17197,18754,1557
45025,SC,Chesterfield,,2008,9.6,16982,18776,1794
45025,SC,Chesterfield,,2009,16.7,15951,19160,3209
45025,SC,Chesterfield,,2010,14.6,18356,21487,3131
45025,SC,Chesterfield,,2011,12.7,18553,21251,2698
45025,SC,Chesterfield,,2012,11.1,18724,21069,2345
45025,SC,Chesterfield,,2013,8.9,19167,21050,1883
45025,SC,Chesterfield,,2014,6.7,19798,21215,1417
45025,SC,Chesterfield,,2015,6,20145,21431,1286
45025,SC,Chesterfield,,2016,4.9,20516,21568,1052
45025,SC,Chesterfield,,2017,4.3,20149,21044,895
45025,SC,Chesterfield,,2018,3.2,20710,21394,684
45025,SC,Chesterfield,,2019,2.8,20926,21539,613
45025,SC,Chesterfield,,2020,5.9,20043,21298,1255
45025,SC,Chesterfield,,2021,4.5,20570,21543,973
45027,SC,Clarendon,,2007,9,11690,12843,1153
45027,SC,Clarendon,,2008,10.4,11326,12643,1317
45027,SC,Clarendon,,2009,15.2,10890,12847,1957
45027,SC,Clarendon,,2010,14.2,12020,14010,1990
45027,SC,Clarendon,,2011,14.3,11731,13693,1962
45027,SC,Clarendon,,2012,12.6,11621,13292,1671
45027,SC,Clarendon,,2013,10.1,11705,13014,1309
45027,SC,Clarendon,,2014,8.2,11920,12978,1058
45027,SC,Clarendon,,2015,7.6,12061,13056,995
45027,SC,Clarendon,,2016,6.5,11849,12677,828
45027,SC,Clarendon,,2017,5.9,11409,12121,712
45027,SC,Clarendon,,2018,4.6,11714,12281,567
45027,SC,Clarendon,,2019,3.8,11918,12388,470
45027,SC,Clarendon,,2020,6.6,11621,12438,817
45027,SC,Clarendon,,2021,4.9,11701,12307,606
45029,SC,Colleton,,2007,6.5,15601,16690,1089
45029,SC,Colleton,,2008,8.8,15328,16805,1477
45029,SC,Colleton,,2009,13.2,15011,17303,2292
45029,SC,Colleton,,2010,13.9,14614,16983,2369
45029,SC,Colleton,,2011,13.9,14394,16727,2333
45029,SC,Colleton,,2012,11.8,14519,16470,1951
45029,SC,Colleton,,2013,9.7,14795,16382,1587
45029,SC,Colleton,,2014,7.4,15401,16638,1237
45029,SC,Colleton,,2015,6.9,15554,16707,1153
45029,SC,Colleton,,2016,5.5,15788,16703,915
45029,SC,Colleton,,2017,4.7,15490,16256,766
45029,SC,Colleton,,2018,3.9,15695,16338,643
45029,SC,Colleton,,2019,3.1,15903,16413,510
45029,SC,Colleton,,2020,5.9,15272,16233,961
45029,SC,Colleton,,2021,4.4,15470,16178,708
45031,SC,Darlington,,2007,7,29032,31216,2184
45031,SC,Darlington,,2008,9.1,28586,31442,2856
45031,SC,Darlington,,2009,13.2,27156,31277,4121
45031,SC,Darlington,,2010,13.4,26741,30872,4131
45031,SC,Darlington,,2011,12.8,26675,30575,3900
45031,SC,Darlington,,2012,10.8,27148,30446,3298
45031,SC,Darlington,,2013,9.1,27421,30167,2746
45031,SC,Darlington,,2014,7.8,27421,29729,2308
45031,SC,Darlington,,2015,7.3,27849,30042,2193
45031,SC,Darlington,,2016,6.1,27993,29810,1817
45031,SC,Darlington,,2017,5.2,27757,29274,1517
45031,SC,Darlington,,2018,4,28255,29427,1172
45031,SC,Darlington,,2019,3.3,28703,29694,991
45031,SC,Darlington,,2020,6.3,27944,29821,1877
45031,SC,Darlington,,2021,4.5,28521,29869,1348
45033,SC,Dillon,,2007,9.7,11909,13192,1283
45033,SC,Dillon,,2008,11,11673,13115,1442
45033,SC,Dillon,,2009,15.5,11723,13879,2156
45033,SC,Dillon,,2010,16.1,11865,14148,2283
45033,SC,Dillon,,2011,15.6,11564,13705,2141
45033,SC,Dillon,,2012,13.8,11379,13208,1829
45033,SC,Dillon,,2013,11.5,11308,12784,1476
45033,SC,Dillon,,2014,9.4,11405,12585,1180
45033,SC,Dillon,,2015,8.5,11582,12662,1080
45033,SC,Dillon,,2016,6.6,11805,12643,838
45033,SC,Dillon,,2017,5.6,11506,12193,687
45033,SC,Dillon,,2018,4.7,11697,12279,582
45033,SC,Dillon,,2019,4,12149,12656,507
45033,SC,Dillon,,2020,6,12156,12929,773
45033,SC,Dillon,,2021,5.8,12367,13128,761
45035,SC,Dorchester,,2007,4.7,59975,62931,2956
45035,SC,Dorchester,,2008,6,60124,63993,3869
45035,SC,Dorchester,,2009,9.9,58062,64442,6380
45035,SC,Dorchester,,2010,9.7,59736,66125,6389
45035,SC,Dorchester,,2011,8.9,61361,67330,5969
45035,SC,Dorchester,,2012,7.7,63096,68327,5231
45035,SC,Dorchester,,2013,6.4,64419,68858,4439
45035,SC,Dorchester,,2014,5.7,66286,70276,3990
45035,SC,Dorchester,,2015,5.4,68727,72661,3934
45035,SC,Dorchester,,2016,4.5,69685,72954,3269
45035,SC,Dorchester,,2017,3.8,69888,72640,2752
45035,SC,Dorchester,,2018,3,72392,74611,2219
45035,SC,Dorchester,,2019,2.4,74486,76350,1864
45035,SC,Dorchester,,2020,5.7,71521,75805,4284
45035,SC,Dorchester,,2021,3.6,75008,77830,2822
45037,SC,Edgefield,,2007,6.8,10378,11133,755
45037,SC,Edgefield,,2008,7.2,10232,11024,792
45037,SC,Edgefield,,2009,10.3,10064,11221,1157
45037,SC,Edgefield,,2010,10.1,9962,11081,1119
45037,SC,Edgefield,,2011,9.8,9888,10962,1074
45037,SC,Edgefield,,2012,9.2,9674,10658,984
45037,SC,Edgefield,,2013,7.8,9723,10550,827
45037,SC,Edgefield,,2014,6.5,9862,10552,690
45037,SC,Edgefield,,2015,6.3,9991,10660,669
45037,SC,Edgefield,,2016,5.5,9931,10514,583
45037,SC,Edgefield,,2017,4.5,9897,10363,466
45037,SC,Edgefield,,2018,3.4,10024,10381,357
45037,SC,Edgefield,,2019,2.8,10214,10503,289
45037,SC,Edgefield,,2020,5,9833,10352,519
45037,SC,Edgefield,,2021,3.4,10043,10394,351
45039,SC,Fairfield,,2007,9.1,10269,11295,1026
45039,SC,Fairfield,,2008,11.3,10036,11320,1284
45039,SC,Fairfield,,2009,13.4,9435,10889,1454
45039,SC,Fairfield,,2010,14.8,9177,10773,1596
45039,SC,Fairfield,,2011,14.3,9070,10588,1518
45039,SC,Fairfield,,2012,12.8,9072,10399,1327
45039,SC,Fairfield,,2013,10.5,9059,10120,1061
45039,SC,Fairfield,,2014,8.5,9176,10023,847
45039,SC,Fairfield,,2015,8,9215,10014,799
45039,SC,Fairfield,,2016,7.1,9258,9962,704
45039,SC,Fairfield,,2017,7.2,9009,9713,704
45039,SC,Fairfield,,2018,6.2,8811,9390,579
45039,SC,Fairfield,,2019,4.4,8882,9289,407
45039,SC,Fairfield,,2020,7.8,8462,9182,720
45039,SC,Fairfield,,2021,5.8,8691,9231,540
45041,SC,Florence,,2007,6.5,59334,63466,4132
45041,SC,Florence,,2008,7.5,58654,63398,4744
45041,SC,Florence,,2009,11.3,56806,64055,7249
45041,SC,Florence,,2010,11.5,57303,64740,7437
45041,SC,Florence,,2011,11.1,57539,64700,7161
45041,SC,Florence,,2012,9.4,58914,65058,6144
45041,SC,Florence,,2013,8,59864,65096,5232
45041,SC,Florence,,2014,7,60279,64829,4550
45041,SC,Florence,,2015,6.5,61234,65470,4236
45041,SC,Florence,,2016,5.2,61817,65180,3363
45041,SC,Florence,,2017,4.5,61190,64043,2853
45041,SC,Florence,,2018,3.6,62498,64813,2315
45041,SC,Florence,,2019,2.9,63668,65547,1879
45041,SC,Florence,,2020,5.4,61858,65409,3551
45041,SC,Florence,,2021,4.1,63305,65981,2676
45043,SC,Georgetown,,2007,6.6,27596,29554,1958
45043,SC,Georgetown,,2008,7.9,28204,30632,2428
45043,SC,Georgetown,,2009,12.1,26739,30425,3686
45043,SC,Georgetown,,2010,14.7,22427,26289,3862
45043,SC,Georgetown,,2011,13.4,22194,25634,3440
45043,SC,Georgetown,,2012,11.7,21799,24696,2897
45043,SC,Georgetown,,2013,9.9,22013,24432,2419
45043,SC,Georgetown,,2014,8.3,22748,24817,2069
45043,SC,Georgetown,,2015,8.3,23112,25212,2100
45043,SC,Georgetown,,2016,6.7,23225,24882,1657
45043,SC,Georgetown,,2017,5.5,23022,24362,1340
45043,SC,Georgetown,,2018,4.5,23671,24790,1119
45043,SC,Georgetown,,2019,3.7,24250,25179,929
45043,SC,Georgetown,,2020,7.3,23643,25508,1865
45043,SC,Georgetown,,2021,4.8,24692,25930,1238
45045,SC,Greenville,,2007,5,212452,223700,11248
45045,SC,Greenville,,2008,5.9,212221,225610,13389
45045,SC,Greenville,,2009,9.9,202267,224564,22297
45045,SC,Greenville,,2010,9.8,200398,222091,21693
45045,SC,Greenville,,2011,8.6,206016,225288,19272
45045,SC,Greenville,,2012,7.3,210863,227402,16539
45045,SC,Greenville,,2013,5.9,217819,231560,13741
45045,SC,Greenville,,2014,5.2,223367,235581,12214
45045,SC,Greenville,,2015,4.9,230968,242842,11874
45045,SC,Greenville,,2016,4.1,234676,244829,10153
45045,SC,Greenville,,2017,3.6,234572,243310,8738
45045,SC,Greenville,,2018,2.9,238985,246072,7087
45045,SC,Greenville,,2019,2.4,244443,250437,5994
45045,SC,Greenville,,2020,5.5,237271,251085,13814
45045,SC,Greenville,,2021,3.4,246829,255544,8715
45047,SC,Greenwood,,2007,7.4,29070,31394,2324
45047,SC,Greenwood,,2008,8.1,28373,30889,2516
45047,SC,Greenwood,,2009,12.7,27245,31200,3955
45047,SC,Greenwood,,2010,12,28288,32154,3866
45047,SC,Greenwood,,2011,11.2,28573,32178,3605
45047,SC,Greenwood,,2012,9.9,28905,32093,3188
45047,SC,Greenwood,,2013,8.4,28979,31636,2657
45047,SC,Greenwood,,2014,6.7,29536,31656,2120
45047,SC,Greenwood,,2015,6.3,29288,31243,1955
45047,SC,Greenwood,,2016,5.1,29671,31252,1581
45047,SC,Greenwood,,2017,4.4,28757,30094,1337
45047,SC,Greenwood,,2018,3.6,29199,30289,1090
45047,SC,Greenwood,,2019,3,29793,30719,926
45047,SC,Greenwood,,2020,6.2,28785,30692,1907
45047,SC,Greenwood,,2021,4.5,28958,30333,1375
45049,SC,Hampton,,2007,7.2,7398,7969,571
45049,SC,Hampton,,2008,9.6,7051,7797,746
45049,SC,Hampton,,2009,15,6810,8011,1201
45049,SC,Hampton,,2010,13,7713,8865,1152
45049,SC,Hampton,,2011,12.8,7561,8670,1109
45049,SC,Hampton,,2012,10.9,7508,8431,923
45049,SC,Hampton,,2013,9.1,7611,8369,758
45049,SC,Hampton,,2014,7.5,7685,8309,624
45049,SC,Hampton,,2015,8.3,7647,8340,693
45049,SC,Hampton,,2016,5.7,7734,8203,469
45049,SC,Hampton,,2017,4.4,7597,7944,347
45049,SC,Hampton,,2018,3.4,7868,8142,274
45049,SC,Hampton,,2019,2.6,7971,8186,215
45049,SC,Hampton,,2020,4.8,7594,7975,381
45049,SC,Hampton,,2021,3.6,7734,8019,285
45051,SC,Horry,,2007,5.4,124896,132002,7106
45051,SC,Horry,,2008,7.6,121866,131823,9957
45051,SC,Horry,,2009,11.9,115587,131142,15555
45051,SC,Horry,,2010,12.5,115661,132121,16460
45051,SC,Horry,,2011,11.8,117260,132897,15637
45051,SC,Horry,,2012,10.1,119373,132855,13482
45051,SC,Horry,,2013,8.4,122022,133217,11195
45051,SC,Horry,,2014,7.2,124494,134144,9650
45051,SC,Horry,,2015,7,127562,137237,9675
45051,SC,Horry,,2016,5.7,131738,139740,8002
45051,SC,Horry,,2017,4.9,133715,140661,6946
45051,SC,Horry,,2018,4.2,135888,141890,6002
45051,SC,Horry,,2019,3.6,139392,144561,5169
45051,SC,Horry,,2020,8.4,132169,144273,12104
45051,SC,Horry,,2021,5.1,141225,148763,7538
45053,SC,Jasper,,2007,4.9,9692,10192,500
45053,SC,Jasper,,2008,6.5,9478,10134,656
45053,SC,Jasper,,2009,10.5,9095,10159,1064
45053,SC,Jasper,,2010,10,9892,10990,1098
45053,SC,Jasper,,2011,9.8,9962,11041,1079
45053,SC,Jasper,,2012,8.3,10070,10979,909
45053,SC,Jasper,,2013,6.7,10460,11214,754
45053,SC,Jasper,,2014,5.5,10797,11430,633
45053,SC,Jasper,,2015,5.1,11215,11813,598
45053,SC,Jasper,,2016,4.3,11454,11964,510
45053,SC,Jasper,,2017,3.6,11345,11773,428
45053,SC,Jasper,,2018,3,11738,12096,358
45053,SC,Jasper,,2019,2.5,12275,12589,314
45053,SC,Jasper,,2020,5,12147,12780,633
45053,SC,Jasper,,2021,3.4,12675,13121,446
45055,SC,Kershaw,,2007,5.7,28308,30034,1726
45055,SC,Kershaw,,2008,7,27892,29994,2102
45055,SC,Kershaw,,2009,10.7,26836,30062,3226
45055,SC,Kershaw,,2010,11.7,25072,28384,3312
45055,SC,Kershaw,,2011,10.9,25224,28313,3089
45055,SC,Kershaw,,2012,9.3,25542,28168,2626
45055,SC,Kershaw,,2013,7.6,25889,28021,2132
45055,SC,Kershaw,,2014,6.3,26644,28424,1780
45055,SC,Kershaw,,2015,5.9,27215,28924,1709
45055,SC,Kershaw,,2016,5.1,27668,29157,1489
45055,SC,Kershaw,,2017,4.4,27375,28640,1265
45055,SC,Kershaw,,2018,3.5,27249,28237,988
45055,SC,Kershaw,,2019,2.9,27934,28761,827
45055,SC,Kershaw,,2020,5.2,27342,28830,1488
45055,SC,Kershaw,,2021,3.7,28084,29168,1084
45057,SC,Lancaster,,2007,10.2,27187,30290,3103
45057,SC,Lancaster,,2008,12.3,26266,29934,3668
45057,SC,Lancaster,,2009,17.6,25183,30567,5384
45057,SC,Lancaster,,2010,14.9,29158,34271,5113
45057,SC,Lancaster,,2011,13.2,29777,34292,4515
45057,SC,Lancaster,,2012,11,30590,34386,3796
45057,SC,Lancaster,,2013,9.1,31284,34399,3115
45057,SC,Lancaster,,2014,7,32785,35261,2476
45057,SC,Lancaster,,2015,6.2,34401,36684,2283
45057,SC,Lancaster,,2016,5.2,36233,38222,1989
45057,SC,Lancaster,,2017,4.6,36799,38564,1765
45057,SC,Lancaster,,2018,3.7,37781,39249,1468
45057,SC,Lancaster,,2019,3.3,39502,40847,1345
45057,SC,Lancaster,,2020,6.6,39386,42172,2786
45057,SC,Lancaster,,2021,4.4,41056,42926,1870
45059,SC,Laurens,,2007,7.7,31258,33854,2596
45059,SC,Laurens,,2008,7.9,30564,33187,2623
45059,SC,Laurens,,2009,11.9,28419,32261,3842
45059,SC,Laurens,,2010,12.5,26667,30465,3798
45059,SC,Laurens,,2011,11.5,26983,30490,3507
45059,SC,Laurens,,2012,10.1,27038,30071,3033
45059,SC,Laurens,,2013,8.3,27475,29977,2502
45059,SC,Laurens,,2014,6.9,27818,29878,2060
45059,SC,Laurens,,2015,6.5,28302,30269,1967
45059,SC,Laurens,,2016,5.1,28417,29943,1526
45059,SC,Laurens,,2017,4.3,27967,29228,1261
45059,SC,Laurens,,2018,3.5,28144,29173,1029
45059,SC,Laurens,,2019,2.9,28494,29350,856
45059,SC,Laurens,,2020,6.7,27330,29285,1955
45059,SC,Laurens,,2021,4.3,28428,29708,1280
45061,SC,Lee,,2007,8.7,7546,8265,719
45061,SC,Lee,,2008,10,7392,8209,817
45061,SC,Lee,,2009,14.5,7316,8554,1238
45061,SC,Lee,,2010,16.4,5867,7021,1154
45061,SC,Lee,,2011,16,5800,6905,1105
45061,SC,Lee,,2012,13.8,5804,6731,927
45061,SC,Lee,,2013,10.8,5869,6577,708
45061,SC,Lee,,2014,8.8,5876,6445,569
45061,SC,Lee,,2015,8.4,5914,6453,539
45061,SC,Lee,,2016,6.9,5972,6417,445
45061,SC,Lee,,2017,5.9,5894,6262,368
45061,SC,Lee,,2018,4.5,6127,6417,290
45061,SC,Lee,,2019,3.9,6177,6427,250
45061,SC,Lee,,2020,7.4,6157,6652,495
45061,SC,Lee,,2021,5.6,6228,6595,367
45063,SC,Lexington,,2007,4.4,127316,133178,5862
45063,SC,Lexington,,2008,5.2,126555,133531,6976
45063,SC,Lexington,,2009,8.2,122856,133772,10916
45063,SC,Lexington,,2010,8.3,122886,134049,11163
45063,SC,Lexington,,2011,7.9,124359,134996,10637
45063,SC,Lexington,,2012,6.8,127490,136865,9375
45063,SC,Lexington,,2013,5.6,130217,137982,7765
45063,SC,Lexington,,2014,4.9,134576,141540,6964
45063,SC,Lexington,,2015,4.8,138353,145305,6952
45063,SC,Lexington,,2016,4,141777,147657,5880
45063,SC,Lexington,,2017,3.5,140415,145563,5148
45063,SC,Lexington,,2018,2.8,140635,144732,4097
45063,SC,Lexington,,2019,2.3,143835,147203,3368
45063,SC,Lexington,,2020,4.2,141382,147607,6225
45063,SC,Lexington,,2021,3,145337,149900,4563
45065,SC,McCormick,,2007,10.7,3178,3557,379
45065,SC,McCormick,,2008,11.5,3083,3482,399
45065,SC,McCormick,,2009,16.3,2885,3448,563
45065,SC,McCormick,,2010,14.2,3137,3658,521
45065,SC,McCormick,,2011,13.5,3156,3647,491
45065,SC,McCormick,,2012,11.5,3162,3574,412
45065,SC,McCormick,,2013,9.6,3178,3515,337
45065,SC,McCormick,,2014,7.7,3219,3486,267
45065,SC,McCormick,,2015,7.1,3196,3439,243
45065,SC,McCormick,,2016,5.5,3198,3383,185
45065,SC,McCormick,,2017,4.5,3152,3299,147
45065,SC,McCormick,,2018,3.4,3204,3318,114
45065,SC,McCormick,,2019,3,3205,3304,99
45065,SC,McCormick,,2020,6.5,3061,3273,212
45065,SC,McCormick,,2021,4.8,3174,3334,160
45067,SC,Marion,,2007,12.3,11479,13091,1612
45067,SC,Marion,,2008,14.6,11051,12935,1884
45067,SC,Marion,,2009,20.6,10333,13019,2686
45067,SC,Marion,,2010,18.5,11857,14552,2695
45067,SC,Marion,,2011,17.5,11724,14213,2489
45067,SC,Marion,,2012,15.6,11403,13509,2106
45067,SC,Marion,,2013,12.8,11403,13072,1669
45067,SC,Marion,,2014,10.3,11523,12843,1320
45067,SC,Marion,,2015,9.9,11580,12849,1269
45067,SC,Marion,,2016,8.5,11553,12632,1079
45067,SC,Marion,,2017,7.3,11311,12199,888
45067,SC,Marion,,2018,5.5,11912,12599,687
45067,SC,Marion,,2019,4.2,12138,12675,537
45067,SC,Marion,,2020,7.6,11953,12937,984
45067,SC,Marion,,2021,6.6,12094,12953,859
45069,SC,Marlboro,,2007,12.7,10525,12054,1529
45069,SC,Marlboro,,2008,13.3,10234,11806,1572
45069,SC,Marlboro,,2009,19.3,9783,12129,2346
45069,SC,Marlboro,,2010,21.5,8626,10983,2357
45069,SC,Marlboro,,2011,19.5,8683,10781,2098
45069,SC,Marlboro,,2012,17.2,8933,10794,1861
45069,SC,Marlboro,,2013,13.5,9109,10526,1417
45069,SC,Marlboro,,2014,10.3,8930,9959,1029
45069,SC,Marlboro,,2015,10,8678,9637,959
45069,SC,Marlboro,,2016,8.2,8514,9278,764
45069,SC,Marlboro,,2017,6.4,8376,8953,577
45069,SC,Marlboro,,2018,5,8500,8945,445
45069,SC,Marlboro,,2019,4.7,8497,8913,416
45069,SC,Marlboro,,2020,9.5,8194,9051,857
45069,SC,Marlboro,,2021,7.8,8154,8840,686
45071,SC,Newberry,,2007,6,17167,18266,1099
45071,SC,Newberry,,2008,7.4,17346,18740,1394
45071,SC,Newberry,,2009,11.5,16425,18565,2140
45071,SC,Newberry,,2010,10.9,16687,18738,2051
45071,SC,Newberry,,2011,10.2,16752,18660,1908
45071,SC,Newberry,,2012,8.6,16683,18261,1578
45071,SC,Newberry,,2013,7.1,16721,17993,1272
45071,SC,Newberry,,2014,5.6,17524,18557,1033
45071,SC,Newberry,,2015,5.2,17895,18886,991
45071,SC,Newberry,,2016,4.3,18303,19135,832
45071,SC,Newberry,,2017,4.1,17281,18020,739
45071,SC,Newberry,,2018,3,17921,18483,562
45071,SC,Newberry,,2019,2.6,18190,18675,485
45071,SC,Newberry,,2020,4.6,17929,18800,871
45071,SC,Newberry,,2021,3.3,18628,19262,634
45073,SC,Oconee,,2007,7.4,28413,30672,2259
45073,SC,Oconee,,2008,7.8,28461,30874,2413
45073,SC,Oconee,,2009,13.5,27205,31439,4234
45073,SC,Oconee,,2010,11.5,29729,33610,3881
45073,SC,Oconee,,2011,9.9,30114,33425,3311
45073,SC,Oconee,,2012,8.6,30565,33441,2876
45073,SC,Oconee,,2013,7.5,30810,33294,2484
45073,SC,Oconee,,2014,6.1,32079,34180,2101
45073,SC,Oconee,,2015,5.7,32490,34467,1977
45073,SC,Oconee,,2016,5,32396,34119,1723
45073,SC,Oconee,,2017,4.3,31937,33373,1436
45073,SC,Oconee,,2018,3.3,32769,33892,1123
45073,SC,Oconee,,2019,2.7,33208,34141,933
45073,SC,Oconee,,2020,5.2,32421,34191,1770
45073,SC,Oconee,,2021,3.6,32885,34123,1238
45075,SC,Orangeburg,,2007,8.7,37380,40935,3555
45075,SC,Orangeburg,,2008,10.8,37056,41529,4473
45075,SC,Orangeburg,,2009,15.5,35357,41846,6489
45075,SC,Orangeburg,,2010,16.1,33958,40490,6532
45075,SC,Orangeburg,,2011,15.6,34079,40384,6305
45075,SC,Orangeburg,,2012,14,33886,39392,5506
45075,SC,Orangeburg,,2013,12.1,33944,38600,4656
45075,SC,Orangeburg,,2014,11,33618,37794,4176
45075,SC,Orangeburg,,2015,10.8,32930,36902,3972
45075,SC,Orangeburg,,2016,8.7,32396,35474,3078
45075,SC,Orangeburg,,2017,7.1,31500,33891,2391
45075,SC,Orangeburg,,2018,5.7,31638,33547,1909
45075,SC,Orangeburg,,2019,4.6,32302,33873,1571
45075,SC,Orangeburg,,2020,8.8,30969,33961,2992
45075,SC,Orangeburg,,2021,7.1,31406,33801,2395
45077,SC,Pickens,,2007,5.4,55703,58904,3201
45077,SC,Pickens,,2008,6.5,54815,58607,3792
45077,SC,Pickens,,2009,10.7,51237,57350,6113
45077,SC,Pickens,,2010,11,48849,54910,6061
45077,SC,Pickens,,2011,9.8,49620,54987,5367
45077,SC,Pickens,,2012,8.8,50028,54840,4812
45077,SC,Pickens,,2013,7.2,50883,54825,3942
45077,SC,Pickens,,2014,6.1,51482,54850,3368
45077,SC,Pickens,,2015,5.7,52833,56030,3197
45077,SC,Pickens,,2016,4.9,53455,56189,2734
45077,SC,Pickens,,2017,4.1,52830,55068,2238
45077,SC,Pickens,,2018,3.3,53669,55499,1830
45077,SC,Pickens,,2019,2.8,54750,56310,1560
45077,SC,Pickens,,2020,5.2,52706,55575,2869
45077,SC,Pickens,,2021,3.5,54866,56837,1971
45079,SC,Richland,,2007,5.6,171683,181905,10222
45079,SC,Richland,,2008,6.5,169980,181861,11881
45079,SC,Richland,,2009,9.4,163973,180968,16995
45079,SC,Richland,,2010,9.5,168729,186378,17649
45079,SC,Richland,,2011,9,170293,187224,16931
45079,SC,Richland,,2012,8,174505,189636,15131
45079,SC,Richland,,2013,6.7,178448,191182,12734
45079,SC,Richland,,2014,5.8,182681,193943,11262
45079,SC,Richland,,2015,5.6,187463,198564,11101
45079,SC,Richland,,2016,4.7,190406,199813,9407
45079,SC,Richland,,2017,4.2,186698,194865,8167
45079,SC,Richland,,2018,3.4,185496,192047,6551
45079,SC,Richland,,2019,2.7,187840,193117,5277
45079,SC,Richland,,2020,5.7,183126,194203,11077
45079,SC,Richland,,2021,4.1,188213,196303,8090
45081,SC,Saluda,,2007,5.7,8713,9239,526
45081,SC,Saluda,,2008,6.4,8422,8998,576
45081,SC,Saluda,,2009,9.6,8149,9019,870
45081,SC,Saluda,,2010,10.2,7868,8759,891
45081,SC,Saluda,,2011,9.6,7872,8712,840
45081,SC,Saluda,,2012,8.3,7895,8609,714
45081,SC,Saluda,,2013,6.7,8018,8596,578
45081,SC,Saluda,,2014,5.5,8177,8656,479
45081,SC,Saluda,,2015,5.2,8367,8825,458
45081,SC,Saluda,,2016,4.4,8476,8870,394
45081,SC,Saluda,,2017,3.9,8356,8692,336
45081,SC,Saluda,,2018,3.1,8304,8568,264
45081,SC,Saluda,,2019,2.6,8387,8612,225
45081,SC,Saluda,,2020,4.2,7973,8320,347
45081,SC,Saluda,,2021,3.1,8145,8409,264
45083,SC,Spartanburg,,2007,6.1,127857,136097,8240
45083,SC,Spartanburg,,2008,7.3,126841,136844,10003
45083,SC,Spartanburg,,2009,12.1,120037,136523,16486
45083,SC,Spartanburg,,2010,12,117019,133003,15984
45083,SC,Spartanburg,,2011,10.8,119426,133878,14452
45083,SC,Spartanburg,,2012,9.2,122526,134988,12462
45083,SC,Spartanburg,,2013,7.5,125746,135982,10236
45083,SC,Spartanburg,,2014,6.2,128416,136871,8455
45083,SC,Spartanburg,,2015,5.7,131890,139790,7900
45083,SC,Spartanburg,,2016,4.6,135410,141957,6547
45083,SC,Spartanburg,,2017,4,137850,143524,5674
45083,SC,Spartanburg,,2018,3.1,141770,146259,4489
45083,SC,Spartanburg,,2019,2.5,147797,151568,3771
45083,SC,Spartanburg,,2020,6.3,145822,155678,9856
45083,SC,Spartanburg,,2021,4,149935,156109,6174
45085,SC,Sumter,,2007,7.5,41859,45266,3407
45085,SC,Sumter,,2008,8.8,40268,44170,3902
45085,SC,Sumter,,2009,12.5,39487,45116,5629
45085,SC,Sumter,,2010,12.6,39159,44822,5663
45085,SC,Sumter,,2011,11.9,39640,45003,5363
45085,SC,Sumter,,2012,10.4,40111,44784,4673
45085,SC,Sumter,,2013,8.5,40545,44323,3778
45085,SC,Sumter,,2014,7.1,41229,44389,3160
45085,SC,Sumter,,2015,6.8,41354,44355,3001
45085,SC,Sumter,,2016,5.8,41595,44134,2539
45085,SC,Sumter,,2017,5.1,40864,43072,2208
45085,SC,Sumter,,2018,4,41001,42702,1701
45085,SC,Sumter,,2019,3.3,41081,42486,1405
45085,SC,Sumter,,2020,6.5,40077,42871,2794
45085,SC,Sumter,,2021,4.6,40705,42665,1960
45087,SC,Union,,2007,9.6,10710,11848,1138
45087,SC,Union,,2008,11.5,10466,11829,1363
45087,SC,Union,,2009,19.4,9807,12171,2364
45087,SC,Union,,2010,17.9,10273,12514,2241
45087,SC,Union,,2011,15.8,10333,12277,1944
45087,SC,Union,,2012,13.4,10370,11968,1598
45087,SC,Union,,2013,11,10462,11758,1296
45087,SC,Union,,2014,8.4,10531,11495,964
45087,SC,Union,,2015,7.8,10644,11547,903
45087,SC,Union,,2016,6.1,10736,11431,695
45087,SC,Union,,2017,5.3,10681,11280,599
45087,SC,Union,,2018,4.1,10688,11147,459
45087,SC,Union,,2019,3.4,10897,11282,385
45087,SC,Union,,2020,8.9,10413,11431,1018
45087,SC,Union,,2021,6.5,10712,11454,742
45089,SC,Williamsburg,,2007,9.6,14016,15510,1494
45089,SC,Williamsburg,,2008,11.1,13880,15608,1728
45089,SC,Williamsburg,,2009,14.7,13613,15968,2355
45089,SC,Williamsburg,,2010,17.5,11126,13483,2357
45089,SC,Williamsburg,,2011,16.5,11251,13473,2222
45089,SC,Williamsburg,,2012,15.5,10509,12434,1925
45089,SC,Williamsburg,,2013,12.2,11149,12699,1550
45089,SC,Williamsburg,,2014,9.7,11405,12635,1230
45089,SC,Williamsburg,,2015,9.1,11637,12805,1168
45089,SC,Williamsburg,,2016,7.6,11490,12431,941
45089,SC,Williamsburg,,2017,6.3,11148,11893,745
45089,SC,Williamsburg,,2018,5.4,11203,11843,640
45089,SC,Williamsburg,,2019,4.4,11239,11762,523
45089,SC,Williamsburg,,2020,8,10541,11463,922
45089,SC,Williamsburg,,2021,6.1,10487,11170,683
45091,SC,York,,2007,5.8,99935,106071,6136
45091,SC,York,,2008,7.5,100454,108594,8140
45091,SC,York,,2009,13.7,97572,113056,15484
45091,SC,York,,2010,12.3,102355,116684,14329
45091,SC,York,,2011,10.8,104847,117525,12678
45091,SC,York,,2012,9.1,107974,118749,10775
45091,SC,York,,2013,7.5,110828,119806,8978
45091,SC,York,,2014,6.1,115119,122624,7505
45091,SC,York,,2015,5.4,119739,126603,6864
45091,SC,York,,2016,4.5,124395,130280,5885
45091,SC,York,,2017,3.9,126065,131218,5153
45091,SC,York,,2018,3.2,129186,133473,4287
45091,SC,York,,2019,2.7,134687,138428,3741
45091,SC,York,,2020,5.8,134279,142608,8329
45091,SC,York,,2021,3.7,140086,145482,5396
46000,SD,South Dakota,,2007,2.8,423910,436295,12385
46000,SD,South Dakota,,2008,3.1,425670,439212,13542
46000,SD,South Dakota,,2009,4.6,421123,441300,20177
46000,SD,South Dakota,,2010,4.9,421815,443618,21803
46000,SD,South Dakota,,2011,4.6,425367,445866,20499
46000,SD,South Dakota,,2012,4.1,428943,447056,18113
46000,SD,South Dakota,,2013,3.7,430834,447479,16645
46000,SD,South Dakota,,2014,3.3,435733,450769,15036
46000,SD,South Dakota,,2015,3,439293,453091,13798
46000,SD,South Dakota,,2016,3,441418,455133,13715
46000,SD,South Dakota,,2017,3.1,441450,455339,13889
46000,SD,South Dakota,,2018,2.8,444569,457328,12759
46000,SD,South Dakota,,2019,2.8,448619,461610,12991
46000,SD,South Dakota,,2020,4.3,441550,461624,20074
46000,SD,South Dakota,,2021,3.1,453511,468015,14504
46003,SD,Aurora,,2007,2.9,1322,1362,40
46003,SD,Aurora,,2008,3.1,1410,1455,45
46003,SD,Aurora,,2009,4.1,1452,1514,62
46003,SD,Aurora,,2010,3.4,1627,1685,58
46003,SD,Aurora,,2011,3,1634,1685,51
46003,SD,Aurora,,2012,2.8,1654,1701,47
46003,SD,Aurora,,2013,2.7,1613,1657,44
46003,SD,Aurora,,2014,2.5,1578,1619,41
46003,SD,Aurora,,2015,2.2,1547,1581,34
46003,SD,Aurora,,2016,2.2,1494,1528,34
46003,SD,Aurora,,2017,2.6,1481,1521,40
46003,SD,Aurora,,2018,2.7,1512,1554,42
46003,SD,Aurora,,2019,2.3,1470,1505,35
46003,SD,Aurora,,2020,3,1419,1463,44
46003,SD,Aurora,,2021,2.4,1443,1478,35
46005,SD,Beadle,,2007,2.4,9086,9314,228
46005,SD,Beadle,,2008,2.5,9303,9543,240
46005,SD,Beadle,,2009,3.4,9301,9629,328
46005,SD,Beadle,,2010,4.1,9086,9477,391
46005,SD,Beadle,,2011,3.7,9241,9594,353
46005,SD,Beadle,,2012,3.3,9353,9671,318
46005,SD,Beadle,,2013,3.5,9208,9542,334
46005,SD,Beadle,,2014,3,9198,9485,287
46005,SD,Beadle,,2015,2.6,9284,9531,247
46005,SD,Beadle,,2016,2.6,9213,9459,246
46005,SD,Beadle,,2017,2.6,9129,9375,246
46005,SD,Beadle,,2018,2.4,9286,9519,233
46005,SD,Beadle,,2019,2.7,9274,9529,255
46005,SD,Beadle,,2020,3.6,8971,9306,335
46005,SD,Beadle,,2021,2.8,8978,9240,262
46007,SD,Bennett,,2007,4.1,1314,1370,56
46007,SD,Bennett,,2008,4.1,1290,1345,55
46007,SD,Bennett,,2009,5,1345,1416,71
46007,SD,Bennett,,2010,7.2,1115,1201,86
46007,SD,Bennett,,2011,7.1,1106,1190,84
46007,SD,Bennett,,2012,6.4,1132,1209,77
46007,SD,Bennett,,2013,6.2,1071,1142,71
46007,SD,Bennett,,2014,5.3,1081,1142,61
46007,SD,Bennett,,2015,4.9,1081,1137,56
46007,SD,Bennett,,2016,4,1084,1129,45
46007,SD,Bennett,,2017,4.1,1065,1110,45
46007,SD,Bennett,,2018,4.1,1028,1072,44
46007,SD,Bennett,,2019,4.7,1020,1070,50
46007,SD,Bennett,,2020,4.8,1019,1070,51
46007,SD,Bennett,,2021,4.3,1009,1054,45
46009,SD,Bon Homme,,2007,3.8,2932,3048,116
46009,SD,Bon Homme,,2008,3.5,2918,3023,105
46009,SD,Bon Homme,,2009,5,2948,3102,154
46009,SD,Bon Homme,,2010,4.1,3073,3206,133
46009,SD,Bon Homme,,2011,4.8,2997,3149,152
46009,SD,Bon Homme,,2012,3.7,2955,3069,114
46009,SD,Bon Homme,,2013,3.2,2928,3024,96
46009,SD,Bon Homme,,2014,2.7,2941,3024,83
46009,SD,Bon Homme,,2015,2.6,2950,3029,79
46009,SD,Bon Homme,,2016,2.7,2879,2960,81
46009,SD,Bon Homme,,2017,2.7,2831,2910,79
46009,SD,Bon Homme,,2018,2.3,2792,2859,67
46009,SD,Bon Homme,,2019,2.6,2770,2845,75
46009,SD,Bon Homme,,2020,3.8,2729,2837,108
46009,SD,Bon Homme,,2021,2.8,2740,2820,80
46011,SD,Brookings,,2007,2.2,19007,19429,422
46011,SD,Brookings,,2008,2.4,18797,19267,470
46011,SD,Brookings,,2009,3.5,18187,18841,654
46011,SD,Brookings,,2010,4.6,17113,17941,828
46011,SD,Brookings,,2011,4.3,17296,18074,778
46011,SD,Brookings,,2012,3.7,17209,17872,663
46011,SD,Brookings,,2013,3.3,17289,17888,599
46011,SD,Brookings,,2014,3.1,17747,18309,562
46011,SD,Brookings,,2015,2.9,18146,18684,538
46011,SD,Brookings,,2016,2.8,18457,18983,526
46011,SD,Brookings,,2017,2.9,18246,18790,544
46011,SD,Brookings,,2018,2.6,18458,18960,502
46011,SD,Brookings,,2019,2.8,18451,18980,529
46011,SD,Brookings,,2020,4.1,17649,18406,757
46011,SD,Brookings,,2021,3.2,17940,18533,593
46013,SD,Brown,,2007,2.3,20464,20950,486
46013,SD,Brown,,2008,2.5,20359,20876,517
46013,SD,Brown,,2009,3.4,20314,21019,705
46013,SD,Brown,,2010,3.8,20196,20994,798
46013,SD,Brown,,2011,3.7,20204,20989,785
46013,SD,Brown,,2012,3.4,20374,21086,712
46013,SD,Brown,,2013,3.2,20422,21095,673
46013,SD,Brown,,2014,2.8,20558,21159,601
46013,SD,Brown,,2015,2.6,20573,21126,553
46013,SD,Brown,,2016,2.7,20623,21196,573
46013,SD,Brown,,2017,2.8,20333,20910,577
46013,SD,Brown,,2018,2.6,20220,20760,540
46013,SD,Brown,,2019,2.6,20086,20626,540
46013,SD,Brown,,2020,4.1,19617,20458,841
46013,SD,Brown,,2021,3,19927,20545,618
46015,SD,Brule,,2007,2.6,2702,2774,72
46015,SD,Brule,,2008,2.7,2682,2757,75
46015,SD,Brule,,2009,3.3,2738,2830,92
46015,SD,Brule,,2010,3.7,2647,2748,101
46015,SD,Brule,,2011,3.9,2633,2740,107
46015,SD,Brule,,2012,3.4,2584,2676,92
46015,SD,Brule,,2013,3.4,2534,2622,88
46015,SD,Brule,,2014,3.2,2502,2584,82
46015,SD,Brule,,2015,2.6,2485,2552,67
46015,SD,Brule,,2016,2.6,2420,2484,64
46015,SD,Brule,,2017,2.8,2407,2476,69
46015,SD,Brule,,2018,2.5,2435,2497,62
46015,SD,Brule,,2019,2.7,2366,2432,66
46015,SD,Brule,,2020,4.2,2354,2456,102
46015,SD,Brule,,2021,2.5,2495,2560,65
46017,SD,Buffalo,,2007,11,429,482,53
46017,SD,Buffalo,,2008,10.1,426,474,48
46017,SD,Buffalo,,2009,14.2,430,501,71
46017,SD,Buffalo,,2010,11.1,618,695,77
46017,SD,Buffalo,,2011,10,667,741,74
46017,SD,Buffalo,,2012,9.2,682,751,69
46017,SD,Buffalo,,2013,8.7,680,745,65
46017,SD,Buffalo,,2014,7.6,682,738,56
46017,SD,Buffalo,,2015,7,669,719,50
46017,SD,Buffalo,,2016,8.4,669,730,61
46017,SD,Buffalo,,2017,6.9,657,706,49
46017,SD,Buffalo,,2018,5.5,665,704,39
46017,SD,Buffalo,,2019,5.5,630,667,37
46017,SD,Buffalo,,2020,7.6,635,687,52
46017,SD,Buffalo,,2021,5.4,664,702,38
46019,SD,Butte,,2007,2.7,5125,5267,142
46019,SD,Butte,,2008,2.8,5242,5392,150
46019,SD,Butte,,2009,4.7,5136,5389,253
46019,SD,Butte,,2010,5,4879,5136,257
46019,SD,Butte,,2011,4.8,4832,5073,241
46019,SD,Butte,,2012,4.4,4803,5025,222
46019,SD,Butte,,2013,3.8,4880,5073,193
46019,SD,Butte,,2014,3.3,4954,5123,169
46019,SD,Butte,,2015,3.3,4953,5124,171
46019,SD,Butte,,2016,3.5,4896,5073,177
46019,SD,Butte,,2017,3.3,4852,5016,164
46019,SD,Butte,,2018,3,4871,5024,153
46019,SD,Butte,,2019,2.9,4888,5034,146
46019,SD,Butte,,2020,5,4711,4961,250
46019,SD,Butte,,2021,3.4,4843,5013,170
46021,SD,Campbell,,2007,3.2,798,824,26
46021,SD,Campbell,,2008,2.9,801,825,24
46021,SD,Campbell,,2009,3.9,815,848,33
46021,SD,Campbell,,2010,4.3,873,912,39
46021,SD,Campbell,,2011,3.8,847,880,33
46021,SD,Campbell,,2012,3.4,840,870,30
46021,SD,Campbell,,2013,3.5,818,848,30
46021,SD,Campbell,,2014,3.2,829,856,27
46021,SD,Campbell,,2015,2.9,830,855,25
46021,SD,Campbell,,2016,2.9,829,854,25
46021,SD,Campbell,,2017,3.1,805,831,26
46021,SD,Campbell,,2018,3.7,752,781,29
46021,SD,Campbell,,2019,3.1,741,765,24
46021,SD,Campbell,,2020,3.3,754,780,26
46021,SD,Campbell,,2021,3.4,748,774,26
46023,SD,Charles Mix,,2007,3.4,3839,3973,134
46023,SD,Charles Mix,,2008,3.5,3845,3986,141
46023,SD,Charles Mix,,2009,4.6,3960,4149,189
46023,SD,Charles Mix,,2010,4.8,3964,4166,202
46023,SD,Charles Mix,,2011,4.8,3969,4171,202
46023,SD,Charles Mix,,2012,4.7,3904,4096,192
46023,SD,Charles Mix,,2013,4.3,3851,4022,171
46023,SD,Charles Mix,,2014,3.7,3894,4044,150
46023,SD,Charles Mix,,2015,3.4,3874,4009,135
46023,SD,Charles Mix,,2016,3.2,3782,3908,126
46023,SD,Charles Mix,,2017,3.4,3748,3879,131
46023,SD,Charles Mix,,2018,2.9,3711,3822,111
46023,SD,Charles Mix,,2019,3.2,3615,3734,119
46023,SD,Charles Mix,,2020,5.9,3531,3754,223
46023,SD,Charles Mix,,2021,3.7,3663,3804,141
46025,SD,Clark,,2007,3.6,1743,1808,65
46025,SD,Clark,,2008,3.9,1716,1785,69
46025,SD,Clark,,2009,5.3,1712,1807,95
46025,SD,Clark,,2010,5.1,1885,1986,101
46025,SD,Clark,,2011,4.6,1875,1966,91
46025,SD,Clark,,2012,4.1,1862,1942,80
46025,SD,Clark,,2013,3.9,1915,1992,77
46025,SD,Clark,,2014,3.8,1926,2002,76
46025,SD,Clark,,2015,3.6,1907,1978,71
46025,SD,Clark,,2016,3.9,1854,1930,76
46025,SD,Clark,,2017,4.3,1801,1882,81
46025,SD,Clark,,2018,3.7,1829,1899,70
46025,SD,Clark,,2019,3.4,1830,1895,65
46025,SD,Clark,,2020,3.7,2062,2142,80
46025,SD,Clark,,2021,3.7,1853,1925,72
46027,SD,Clay,,2007,2.5,7318,7507,189
46027,SD,Clay,,2008,2.8,7362,7572,210
46027,SD,Clay,,2009,3.7,7297,7579,282
46027,SD,Clay,,2010,4.2,7117,7427,310
46027,SD,Clay,,2011,3.9,7270,7568,298
46027,SD,Clay,,2012,3.6,7235,7507,272
46027,SD,Clay,,2013,3.6,6874,7132,258
46027,SD,Clay,,2014,3.4,6898,7138,240
46027,SD,Clay,,2015,3,6842,7055,213
46027,SD,Clay,,2016,3,6810,7023,213
46027,SD,Clay,,2017,3,6898,7113,215
46027,SD,Clay,,2018,2.6,7032,7223,191
46027,SD,Clay,,2019,2.8,7177,7386,209
46027,SD,Clay,,2020,4.3,6810,7113,303
46027,SD,Clay,,2021,3,7114,7331,217
46029,SD,Codington,,2007,2.7,16102,16542,440
46029,SD,Codington,,2008,3,15852,16348,496
46029,SD,Codington,,2009,5.7,15146,16069,923
46029,SD,Codington,,2010,5.1,14356,15128,772
46029,SD,Codington,,2011,4.4,14823,15509,686
46029,SD,Codington,,2012,3.7,15076,15652,576
46029,SD,Codington,,2013,3.5,15010,15556,546
46029,SD,Codington,,2014,3.2,14969,15468,499
46029,SD,Codington,,2015,3,14951,15418,467
46029,SD,Codington,,2016,3.1,14808,15283,475
46029,SD,Codington,,2017,3.1,14724,15193,469
46029,SD,Codington,,2018,2.8,14864,15290,426
46029,SD,Codington,,2019,2.7,15024,15441,417
46029,SD,Codington,,2020,4.6,14665,15370,705
46029,SD,Codington,,2021,3.1,15188,15673,485
46031,SD,Corson,,2007,5.7,1258,1334,76
46031,SD,Corson,,2008,5.2,1273,1343,70
46031,SD,Corson,,2009,6.2,1312,1398,86
46031,SD,Corson,,2010,6.9,1443,1550,107
46031,SD,Corson,,2011,7.3,1436,1549,113
46031,SD,Corson,,2012,7.6,1409,1525,116
46031,SD,Corson,,2013,6.8,1415,1518,103
46031,SD,Corson,,2014,5.7,1415,1501,86
46031,SD,Corson,,2015,5,1424,1499,75
46031,SD,Corson,,2016,4.5,1395,1461,66
46031,SD,Corson,,2017,3.9,1364,1419,55
46031,SD,Corson,,2018,3.8,1330,1382,52
46031,SD,Corson,,2019,4.9,1275,1341,66
46031,SD,Corson,,2020,4.6,1255,1316,61
46031,SD,Corson,,2021,4.7,1252,1314,62
46033,SD,Custer,,2007,2.8,4516,4645,129
46033,SD,Custer,,2008,2.8,4685,4821,136
46033,SD,Custer,,2009,3.9,4776,4969,193
46033,SD,Custer,,2010,5.7,3854,4089,235
46033,SD,Custer,,2011,5.4,3894,4118,224
46033,SD,Custer,,2012,5.1,3850,4056,206
46033,SD,Custer,,2013,5,3849,4051,202
46033,SD,Custer,,2014,4.4,3821,3998,177
46033,SD,Custer,,2015,4.2,3821,3987,166
46033,SD,Custer,,2016,4,3852,4014,162
46033,SD,Custer,,2017,4,3867,4027,160
46033,SD,Custer,,2018,3.8,3834,3984,150
46033,SD,Custer,,2019,3.8,3897,4051,154
46033,SD,Custer,,2020,5.7,3796,4026,230
46033,SD,Custer,,2021,4,3954,4119,165
46035,SD,Davison,,2007,2.5,10852,11125,273
46035,SD,Davison,,2008,2.6,10813,11105,292
46035,SD,Davison,,2009,4.5,10612,11110,498
46035,SD,Davison,,2010,4.4,10499,10978,479
46035,SD,Davison,,2011,3.8,10745,11174,429
46035,SD,Davison,,2012,3.2,10969,11327,358
46035,SD,Davison,,2013,3.1,10963,11309,346
46035,SD,Davison,,2014,2.7,11055,11367,312
46035,SD,Davison,,2015,2.5,11115,11399,284
46035,SD,Davison,,2016,2.4,11021,11294,273
46035,SD,Davison,,2017,2.7,10718,11012,294
46035,SD,Davison,,2018,2.4,10729,10994,265
46035,SD,Davison,,2019,2.5,10733,11008,275
46035,SD,Davison,,2020,3.9,10449,10874,425
46035,SD,Davison,,2021,2.8,10589,10891,302
46037,SD,Day,,2007,4.8,2698,2834,136
46037,SD,Day,,2008,4.4,2740,2865,125
46037,SD,Day,,2009,6.4,2698,2884,186
46037,SD,Day,,2010,6.6,2885,3088,203
46037,SD,Day,,2011,6.3,2883,3078,195
46037,SD,Day,,2012,5.5,2814,2977,163
46037,SD,Day,,2013,5.1,2788,2939,151
46037,SD,Day,,2014,5.2,2745,2895,150
46037,SD,Day,,2015,4.9,2736,2876,140
46037,SD,Day,,2016,4.2,2751,2873,122
46037,SD,Day,,2017,3.8,2715,2821,106
46037,SD,Day,,2018,4,2660,2770,110
46037,SD,Day,,2019,3.9,2614,2721,107
46037,SD,Day,,2020,5.3,2537,2680,143
46037,SD,Day,,2021,4.3,2567,2682,115
46039,SD,Deuel,,2007,3.5,2547,2639,92
46039,SD,Deuel,,2008,3.8,2623,2728,105
46039,SD,Deuel,,2009,5.5,2548,2697,149
46039,SD,Deuel,,2010,6.6,2324,2489,165
46039,SD,Deuel,,2011,5.9,2390,2541,151
46039,SD,Deuel,,2012,5.6,2362,2503,141
46039,SD,Deuel,,2013,5.5,2265,2397,132
46039,SD,Deuel,,2014,5.2,2226,2349,123
46039,SD,Deuel,,2015,4.9,2211,2324,113
46039,SD,Deuel,,2016,4.9,2141,2251,110
46039,SD,Deuel,,2017,4.5,2093,2192,99
46039,SD,Deuel,,2018,4.1,2066,2154,88
46039,SD,Deuel,,2019,4.2,2073,2163,90
46039,SD,Deuel,,2020,5,2198,2313,115
46039,SD,Deuel,,2021,4.2,2197,2293,96
46041,SD,Dewey,,2007,9.6,2242,2481,239
46041,SD,Dewey,,2008,9.3,2243,2472,229
46041,SD,Dewey,,2009,10.2,2360,2629,269
46041,SD,Dewey,,2010,14.7,2018,2367,349
46041,SD,Dewey,,2011,15.8,2044,2428,384
46041,SD,Dewey,,2012,15.3,2053,2423,370
46041,SD,Dewey,,2013,15.3,2061,2432,371
46041,SD,Dewey,,2014,14.2,2043,2382,339
46041,SD,Dewey,,2015,11.3,2043,2304,261
46041,SD,Dewey,,2016,9.1,2059,2266,207
46041,SD,Dewey,,2017,9.4,2026,2235,209
46041,SD,Dewey,,2018,8.1,2025,2204,179
46041,SD,Dewey,,2019,7.1,2041,2197,156
46041,SD,Dewey,,2020,7,2133,2294,161
46041,SD,Dewey,,2021,5.9,2153,2288,135
46043,SD,Douglas,,2007,2.5,1610,1652,42
46043,SD,Douglas,,2008,2.7,1632,1678,46
46043,SD,Douglas,,2009,3.9,1690,1758,68
46043,SD,Douglas,,2010,4.4,1693,1770,77
46043,SD,Douglas,,2011,4,1701,1771,70
46043,SD,Douglas,,2012,3.2,1657,1712,55
46043,SD,Douglas,,2013,3.1,1662,1715,53
46043,SD,Douglas,,2014,2.8,1687,1736,49
46043,SD,Douglas,,2015,2.4,1644,1685,41
46043,SD,Douglas,,2016,2.6,1637,1680,43
46043,SD,Douglas,,2017,2.8,1550,1594,44
46043,SD,Douglas,,2018,2.4,1522,1560,38
46043,SD,Douglas,,2019,2.5,1525,1564,39
46043,SD,Douglas,,2020,2.7,1500,1542,42
46043,SD,Douglas,,2021,2.5,1491,1529,38
46045,SD,Edmunds,,2007,2.6,1982,2034,52
46045,SD,Edmunds,,2008,2.7,1982,2038,56
46045,SD,Edmunds,,2009,3.2,1926,1990,64
46045,SD,Edmunds,,2010,3,2323,2396,73
46045,SD,Edmunds,,2011,3.2,2303,2380,77
46045,SD,Edmunds,,2012,2.8,2265,2331,66
46045,SD,Edmunds,,2013,2.7,2236,2299,63
46045,SD,Edmunds,,2014,2.5,2193,2249,56
46045,SD,Edmunds,,2015,2.5,2180,2235,55
46045,SD,Edmunds,,2016,2.3,2123,2174,51
46045,SD,Edmunds,,2017,2.6,2056,2111,55
46045,SD,Edmunds,,2018,2.4,2005,2055,50
46045,SD,Edmunds,,2019,2.6,1971,2024,53
46045,SD,Edmunds,,2020,2.7,1924,1978,54
46045,SD,Edmunds,,2021,2.7,1959,2013,54
46047,SD,Fall River,,2007,3.2,3581,3701,120
46047,SD,Fall River,,2008,3.4,3569,3695,126
46047,SD,Fall River,,2009,5.6,3558,3768,210
46047,SD,Fall River,,2010,6.1,3077,3277,200
46047,SD,Fall River,,2011,5.8,3033,3220,187
46047,SD,Fall River,,2012,5.4,2981,3151,170
46047,SD,Fall River,,2013,4.9,2908,3058,150
46047,SD,Fall River,,2014,4.6,2890,3029,139
46047,SD,Fall River,,2015,4.4,2861,2992,131
46047,SD,Fall River,,2016,4.4,2905,3039,134
46047,SD,Fall River,,2017,3.7,2863,2974,111
46047,SD,Fall River,,2018,3.5,2887,2991,104
46047,SD,Fall River,,2019,3.6,2859,2967,108
46047,SD,Fall River,,2020,5.6,2828,2996,168
46047,SD,Fall River,,2021,4,2947,3071,124
46049,SD,Faulk,,2007,3.2,1068,1103,35
46049,SD,Faulk,,2008,2.9,1093,1126,33
46049,SD,Faulk,,2009,3.2,1102,1139,37
46049,SD,Faulk,,2010,3.9,1134,1180,46
46049,SD,Faulk,,2011,4.1,1135,1183,48
46049,SD,Faulk,,2012,3.8,1112,1156,44
46049,SD,Faulk,,2013,3.2,1132,1170,38
46049,SD,Faulk,,2014,3,1115,1150,35
46049,SD,Faulk,,2015,2.6,1097,1126,29
46049,SD,Faulk,,2016,2.7,1089,1119,30
46049,SD,Faulk,,2017,2.8,1067,1098,31
46049,SD,Faulk,,2018,2.7,1061,1091,30
46049,SD,Faulk,,2019,2.8,1018,1047,29
46049,SD,Faulk,,2020,3.3,996,1030,34
46049,SD,Faulk,,2021,2.7,1026,1055,29
46051,SD,Grant,,2007,3.4,4027,4167,140
46051,SD,Grant,,2008,3.7,4036,4189,153
46051,SD,Grant,,2009,4.4,3977,4160,183
46051,SD,Grant,,2010,4.6,4600,4821,221
46051,SD,Grant,,2011,4.7,4448,4666,218
46051,SD,Grant,,2012,4.2,4373,4564,191
46051,SD,Grant,,2013,4.1,4483,4675,192
46051,SD,Grant,,2014,3.5,4562,4727,165
46051,SD,Grant,,2015,2.9,4598,4735,137
46051,SD,Grant,,2016,3.2,4335,4480,145
46051,SD,Grant,,2017,3.3,4302,4447,145
46051,SD,Grant,,2018,3,4294,4425,131
46051,SD,Grant,,2019,2.9,4269,4396,127
46051,SD,Grant,,2020,3.8,4181,4344,163
46051,SD,Grant,,2021,3.4,4181,4329,148
46053,SD,Gregory,,2007,3.2,2266,2341,75
46053,SD,Gregory,,2008,3.4,2249,2329,80
46053,SD,Gregory,,2009,3.8,2238,2327,89
46053,SD,Gregory,,2010,4.3,2098,2192,94
46053,SD,Gregory,,2011,4.5,2085,2183,98
46053,SD,Gregory,,2012,4.1,2064,2153,89
46053,SD,Gregory,,2013,3.8,2032,2113,81
46053,SD,Gregory,,2014,3.3,2019,2088,69
46053,SD,Gregory,,2015,3.1,2006,2070,64
46053,SD,Gregory,,2016,3,2023,2086,63
46053,SD,Gregory,,2017,3.2,1983,2049,66
46053,SD,Gregory,,2018,3,1973,2034,61
46053,SD,Gregory,,2019,3,1960,2020,60
46053,SD,Gregory,,2020,3.5,1958,2030,72
46053,SD,Gregory,,2021,2.8,2011,2069,58
46055,SD,Haakon,,2007,2.5,1121,1150,29
46055,SD,Haakon,,2008,2.6,1111,1141,30
46055,SD,Haakon,,2009,3.5,1117,1157,40
46055,SD,Haakon,,2010,3.4,1091,1129,38
46055,SD,Haakon,,2011,3.7,1082,1123,41
46055,SD,Haakon,,2012,3,1076,1109,33
46055,SD,Haakon,,2013,2.8,1057,1088,31
46055,SD,Haakon,,2014,2.6,1068,1097,29
46055,SD,Haakon,,2015,2.3,1080,1105,25
46055,SD,Haakon,,2016,2.4,1084,1111,27
46055,SD,Haakon,,2017,2.6,1073,1102,29
46055,SD,Haakon,,2018,2.4,1041,1067,26
46055,SD,Haakon,,2019,2.6,1017,1044,27
46055,SD,Haakon,,2020,2.4,1026,1051,25
46055,SD,Haakon,,2021,2.8,1012,1041,29
46057,SD,Hamlin,,2007,2.8,2877,2960,83
46057,SD,Hamlin,,2008,3.4,2855,2954,99
46057,SD,Hamlin,,2009,5,2790,2937,147
46057,SD,Hamlin,,2010,4.9,2994,3149,155
46057,SD,Hamlin,,2011,4.3,2994,3129,135
46057,SD,Hamlin,,2012,3.7,3041,3159,118
46057,SD,Hamlin,,2013,3.4,3031,3137,106
46057,SD,Hamlin,,2014,3.3,3044,3149,105
46057,SD,Hamlin,,2015,3.3,3049,3152,103
46057,SD,Hamlin,,2016,3.4,3082,3190,108
46057,SD,Hamlin,,2017,3.4,3039,3145,106
46057,SD,Hamlin,,2018,2.9,3139,3233,94
46057,SD,Hamlin,,2019,2.8,3207,3300,93
46057,SD,Hamlin,,2020,3.2,3236,3344,108
46057,SD,Hamlin,,2021,2.4,3371,3454,83
46059,SD,Hand,,2007,2.8,1796,1847,51
46059,SD,Hand,,2008,2.6,1810,1859,49
46059,SD,Hand,,2009,2.9,1856,1911,55
46059,SD,Hand,,2010,3.2,1852,1914,62
46059,SD,Hand,,2011,3.2,1821,1882,61
46059,SD,Hand,,2012,2.9,1799,1853,54
46059,SD,Hand,,2013,2.7,1790,1840,50
46059,SD,Hand,,2014,2.5,1794,1840,46
46059,SD,Hand,,2015,2.3,1843,1886,43
46059,SD,Hand,,2016,2.2,1801,1841,40
46059,SD,Hand,,2017,2.3,1780,1821,41
46059,SD,Hand,,2018,2.1,1766,1804,38
46059,SD,Hand,,2019,2.3,1721,1762,41
46059,SD,Hand,,2020,2.5,1696,1739,43
46059,SD,Hand,,2021,2.5,1707,1750,43
46061,SD,Hanson,,2007,3,1891,1950,59
46061,SD,Hanson,,2008,3.1,1887,1947,60
46061,SD,Hanson,,2009,4.2,1823,1902,79
46061,SD,Hanson,,2010,5.2,1685,1777,92
46061,SD,Hanson,,2011,4.7,1733,1819,86
46061,SD,Hanson,,2012,4.4,1748,1829,81
46061,SD,Hanson,,2013,4.1,1742,1816,74
46061,SD,Hanson,,2014,3.4,1760,1822,62
46061,SD,Hanson,,2015,3.3,1750,1809,59
46061,SD,Hanson,,2016,3.4,1717,1778,61
46061,SD,Hanson,,2017,3.8,1702,1769,67
46061,SD,Hanson,,2018,4.3,1667,1742,75
46061,SD,Hanson,,2019,4,1695,1766,71
46061,SD,Hanson,,2020,4.8,1665,1749,84
46061,SD,Hanson,,2021,4,1687,1757,70
46063,SD,Harding,,2007,2.6,718,737,19
46063,SD,Harding,,2008,2.7,751,772,21
46063,SD,Harding,,2009,2.9,767,790,23
46063,SD,Harding,,2010,3.5,773,801,28
46063,SD,Harding,,2011,3.9,797,829,32
46063,SD,Harding,,2012,3.4,787,815,28
46063,SD,Harding,,2013,2.8,757,779,22
46063,SD,Harding,,2014,2.3,762,780,18
46063,SD,Harding,,2015,2.4,766,785,19
46063,SD,Harding,,2016,2.9,743,765,22
46063,SD,Harding,,2017,2.8,705,725,20
46063,SD,Harding,,2018,2.2,711,727,16
46063,SD,Harding,,2019,2.3,717,734,17
46063,SD,Harding,,2020,3.4,692,716,24
46063,SD,Harding,,2021,2.8,698,718,20
46065,SD,Hughes,,2007,2.3,9851,10086,235
46065,SD,Hughes,,2008,2.4,9908,10151,243
46065,SD,Hughes,,2009,3,9991,10299,308
46065,SD,Hughes,,2010,3.4,9758,10104,346
46065,SD,Hughes,,2011,3.5,9720,10076,356
46065,SD,Hughes,,2012,3.1,9711,10024,313
46065,SD,Hughes,,2013,2.9,9686,9971,285
46065,SD,Hughes,,2014,2.5,9784,10038,254
46065,SD,Hughes,,2015,2.4,9723,9958,235
46065,SD,Hughes,,2016,2.4,9872,10113,241
46065,SD,Hughes,,2017,2.5,9750,10005,255
46065,SD,Hughes,,2018,2.4,9621,9853,232
46065,SD,Hughes,,2019,2.3,9696,9922,226
46065,SD,Hughes,,2020,3.1,9511,9818,307
46065,SD,Hughes,,2021,2.4,9640,9881,241
46067,SD,Hutchinson,,2007,3,3617,3730,113
46067,SD,Hutchinson,,2008,3.1,3581,3695,114
46067,SD,Hutchinson,,2009,3.9,3625,3771,146
46067,SD,Hutchinson,,2010,3.9,3673,3824,151
46067,SD,Hutchinson,,2011,3.7,3680,3822,142
46067,SD,Hutchinson,,2012,3.3,3630,3753,123
46067,SD,Hutchinson,,2013,3.2,3573,3690,117
46067,SD,Hutchinson,,2014,2.8,3581,3684,103
46067,SD,Hutchinson,,2015,2.4,3607,3697,90
46067,SD,Hutchinson,,2016,2.6,3574,3668,94
46067,SD,Hutchinson,,2017,2.8,3503,3605,102
46067,SD,Hutchinson,,2018,2.5,3471,3561,90
46067,SD,Hutchinson,,2019,2.6,3478,3572,94
46067,SD,Hutchinson,,2020,3.5,3461,3588,127
46067,SD,Hutchinson,,2021,3.1,3492,3604,112
46069,SD,Hyde,,2007,3.3,700,724,24
46069,SD,Hyde,,2008,2.9,705,726,21
46069,SD,Hyde,,2009,3.6,725,752,27
46069,SD,Hyde,,2010,3.8,769,799,30
46069,SD,Hyde,,2011,3.5,765,793,28
46069,SD,Hyde,,2012,3.4,747,773,26
46069,SD,Hyde,,2013,3.3,699,723,24
46069,SD,Hyde,,2014,2.8,697,717,20
46069,SD,Hyde,,2015,2.8,692,712,20
46069,SD,Hyde,,2016,2.7,683,702,19
46069,SD,Hyde,,2017,2.9,663,683,20
46069,SD,Hyde,,2018,2.7,657,675,18
46069,SD,Hyde,,2019,2.9,663,683,20
46069,SD,Hyde,,2020,3,646,666,20
46069,SD,Hyde,,2021,2.6,632,649,17
46071,SD,Jackson,,2007,5.4,1126,1190,64
46071,SD,Jackson,,2008,5.9,1135,1206,71
46071,SD,Jackson,,2009,6.4,1176,1256,80
46071,SD,Jackson,,2010,6.7,1305,1399,94
46071,SD,Jackson,,2011,7.3,1296,1398,102
46071,SD,Jackson,,2012,6.7,1262,1352,90
46071,SD,Jackson,,2013,6.1,1238,1318,80
46071,SD,Jackson,,2014,5.3,1274,1345,71
46071,SD,Jackson,,2015,4.2,1278,1334,56
46071,SD,Jackson,,2016,4.2,1256,1311,55
46071,SD,Jackson,,2017,5.2,1251,1320,69
46071,SD,Jackson,,2018,4.5,1217,1275,58
46071,SD,Jackson,,2019,4.8,1203,1263,60
46071,SD,Jackson,,2020,4,1153,1201,48
46071,SD,Jackson,,2021,4.4,1161,1215,54
46073,SD,Jerauld,,2007,2.4,1326,1359,33
46073,SD,Jerauld,,2008,2.3,1378,1411,33
46073,SD,Jerauld,,2009,2.8,1340,1379,39
46073,SD,Jerauld,,2010,3.6,1161,1204,43
46073,SD,Jerauld,,2011,3.5,1201,1244,43
46073,SD,Jerauld,,2012,2.9,1193,1229,36
46073,SD,Jerauld,,2013,3,1167,1203,36
46073,SD,Jerauld,,2014,2.4,1178,1207,29
46073,SD,Jerauld,,2015,2.2,1108,1133,25
46073,SD,Jerauld,,2016,2.5,1050,1077,27
46073,SD,Jerauld,,2017,2.2,1113,1138,25
46073,SD,Jerauld,,2018,2.2,1087,1112,25
46073,SD,Jerauld,,2019,2.4,1087,1114,27
46073,SD,Jerauld,,2020,2.3,1163,1190,27
46073,SD,Jerauld,,2021,2.2,1302,1331,29
46075,SD,Jones,,2007,2.2,678,693,15
46075,SD,Jones,,2008,2.5,663,680,17
46075,SD,Jones,,2009,2.9,697,718,21
46075,SD,Jones,,2010,2.9,661,681,20
46075,SD,Jones,,2011,3.1,657,678,21
46075,SD,Jones,,2012,3.6,610,633,23
46075,SD,Jones,,2013,3.5,602,624,22
46075,SD,Jones,,2014,3.6,590,612,22
46075,SD,Jones,,2015,2.9,571,588,17
46075,SD,Jones,,2016,2.4,558,572,14
46075,SD,Jones,,2017,2.7,545,560,15
46075,SD,Jones,,2018,2.4,538,551,13
46075,SD,Jones,,2019,2.6,522,536,14
46075,SD,Jones,,2020,3.5,501,519,18
46075,SD,Jones,,2021,3.4,504,522,18
46077,SD,Kingsbury,,2007,2.9,2827,2910,83
46077,SD,Kingsbury,,2008,3.3,2864,2961,97
46077,SD,Kingsbury,,2009,4.9,2797,2942,145
46077,SD,Kingsbury,,2010,5.3,2729,2882,153
46077,SD,Kingsbury,,2011,4.3,2782,2907,125
46077,SD,Kingsbury,,2012,3.4,2902,3003,101
46077,SD,Kingsbury,,2013,3.2,2810,2902,92
46077,SD,Kingsbury,,2014,2.9,2821,2905,84
46077,SD,Kingsbury,,2015,2.9,2691,2771,80
46077,SD,Kingsbury,,2016,2.7,2681,2754,73
46077,SD,Kingsbury,,2017,2.9,2596,2674,78
46077,SD,Kingsbury,,2018,2.6,2578,2648,70
46077,SD,Kingsbury,,2019,2.6,2587,2657,70
46077,SD,Kingsbury,,2020,3.5,2568,2660,92
46077,SD,Kingsbury,,2021,2.9,2623,2701,78
46079,SD,Lake,,2007,2.9,6596,6793,197
46079,SD,Lake,,2008,3.2,6489,6702,213
46079,SD,Lake,,2009,5.9,6265,6658,393
46079,SD,Lake,,2010,5.6,5844,6189,345
46079,SD,Lake,,2011,4.8,5953,6255,302
46079,SD,Lake,,2012,4,6075,6329,254
46079,SD,Lake,,2013,3.8,6114,6355,241
46079,SD,Lake,,2014,3.5,6146,6371,225
46079,SD,Lake,,2015,3.6,6317,6551,234
46079,SD,Lake,,2016,3.4,6268,6491,223
46079,SD,Lake,,2017,3.5,6259,6489,230
46079,SD,Lake,,2018,3.1,6408,6616,208
46079,SD,Lake,,2019,3,6406,6607,201
46079,SD,Lake,,2020,3.6,6196,6426,230
46079,SD,Lake,,2021,3,6349,6548,199
46081,SD,Lawrence,,2007,2.6,12933,13272,339
46081,SD,Lawrence,,2008,2.9,12935,13319,384
46081,SD,Lawrence,,2009,4,12909,13452,543
46081,SD,Lawrence,,2010,4.7,12607,13224,617
46081,SD,Lawrence,,2011,4.7,12342,12950,608
46081,SD,Lawrence,,2012,4.3,12230,12773,543
46081,SD,Lawrence,,2013,3.9,12274,12768,494
46081,SD,Lawrence,,2014,3.4,12300,12733,433
46081,SD,Lawrence,,2015,3.2,12404,12816,412
46081,SD,Lawrence,,2016,3.3,12692,13129,437
46081,SD,Lawrence,,2017,3,12631,13025,394
46081,SD,Lawrence,,2018,2.7,12660,13011,351
46081,SD,Lawrence,,2019,2.7,12958,13322,364
46081,SD,Lawrence,,2020,5.8,12703,13488,785
46081,SD,Lawrence,,2021,3,13370,13789,419
46083,SD,Lincoln,,2007,2.3,20429,20903,474
46083,SD,Lincoln,,2008,2.5,21208,21752,544
46083,SD,Lincoln,,2009,4,21182,22067,885
46083,SD,Lincoln,,2010,3.9,25435,26457,1022
46083,SD,Lincoln,,2011,3.5,26291,27242,951
46083,SD,Lincoln,,2012,3.1,27258,28118,860
46083,SD,Lincoln,,2013,2.7,28029,28795,766
46083,SD,Lincoln,,2014,2.4,29077,29780,703
46083,SD,Lincoln,,2015,2.2,29974,30651,677
46083,SD,Lincoln,,2016,2.2,30908,31596,688
46083,SD,Lincoln,,2017,2.3,32160,32912,752
46083,SD,Lincoln,,2018,2.1,33026,33749,723
46083,SD,Lincoln,,2019,2.2,34744,35520,776
46083,SD,Lincoln,,2020,3.4,34811,36033,1222
46083,SD,Lincoln,,2021,2.4,35841,36741,900
46085,SD,Lyman,,2007,4.3,1859,1943,84
46085,SD,Lyman,,2008,4.6,1865,1954,89
46085,SD,Lyman,,2009,5.6,1885,1997,112
46085,SD,Lyman,,2010,6.4,1832,1957,125
46085,SD,Lyman,,2011,6.2,1805,1925,120
46085,SD,Lyman,,2012,5.6,1791,1898,107
46085,SD,Lyman,,2013,4.7,1784,1872,88
46085,SD,Lyman,,2014,4.1,1741,1816,75
46085,SD,Lyman,,2015,4.6,1721,1804,83
46085,SD,Lyman,,2016,4.7,1700,1784,84
46085,SD,Lyman,,2017,4.6,1662,1743,81
46085,SD,Lyman,,2018,3.8,1625,1690,65
46085,SD,Lyman,,2019,4.1,1601,1669,68
46085,SD,Lyman,,2020,5.4,1568,1658,90
46085,SD,Lyman,,2021,4.4,1617,1691,74
46087,SD,McCook,,2007,2.8,2675,2751,76
46087,SD,McCook,,2008,3.6,2602,2698,96
46087,SD,McCook,,2009,5,2482,2613,131
46087,SD,McCook,,2010,4.9,3099,3257,158
46087,SD,McCook,,2011,4.3,3076,3214,138
46087,SD,McCook,,2012,3.6,3088,3203,115
46087,SD,McCook,,2013,3.2,3092,3193,101
46087,SD,McCook,,2014,2.6,3098,3181,83
46087,SD,McCook,,2015,2.3,3077,3151,74
46087,SD,McCook,,2016,2.5,3070,3149,79
46087,SD,McCook,,2017,2.6,2976,3055,79
46087,SD,McCook,,2018,2.3,2959,3029,70
46087,SD,McCook,,2019,2.5,2990,3066,76
46087,SD,McCook,,2020,3.5,2874,2978,104
46087,SD,McCook,,2021,2.8,2961,3045,84
46089,SD,McPherson,,2007,4.2,1068,1115,47
46089,SD,McPherson,,2008,4.3,1052,1099,47
46089,SD,McPherson,,2009,4.9,1095,1152,57
46089,SD,McPherson,,2010,4.9,1155,1214,59
46089,SD,McPherson,,2011,4.3,1124,1175,51
46089,SD,McPherson,,2012,4.4,1105,1156,51
46089,SD,McPherson,,2013,3.7,1100,1142,42
46089,SD,McPherson,,2014,3.8,1093,1136,43
46089,SD,McPherson,,2015,3.3,1083,1120,37
46089,SD,McPherson,,2016,3.5,1056,1094,38
46089,SD,McPherson,,2017,3.2,1014,1047,33
46089,SD,McPherson,,2018,3.5,982,1018,36
46089,SD,McPherson,,2019,3.6,955,991,36
46089,SD,McPherson,,2020,4.8,942,990,48
46089,SD,McPherson,,2021,4.2,922,962,40
46091,SD,Marshall,,2007,4.2,1954,2040,86
46091,SD,Marshall,,2008,4.4,1984,2075,91
46091,SD,Marshall,,2009,6.1,1954,2082,128
46091,SD,Marshall,,2010,5.3,2348,2479,131
46091,SD,Marshall,,2011,5.4,2385,2522,137
46091,SD,Marshall,,2012,4.5,2410,2524,114
46091,SD,Marshall,,2013,4.3,2449,2559,110
46091,SD,Marshall,,2014,4,2442,2544,102
46091,SD,Marshall,,2015,3.8,2423,2518,95
46091,SD,Marshall,,2016,3.9,2377,2473,96
46091,SD,Marshall,,2017,4.1,2294,2393,99
46091,SD,Marshall,,2018,3.5,2328,2413,85
46091,SD,Marshall,,2019,3.2,2270,2345,75
46091,SD,Marshall,,2020,4.4,2299,2406,107
46091,SD,Marshall,,2021,3.5,2335,2420,85
46093,SD,Meade,,2007,2.8,11946,12295,349
46093,SD,Meade,,2008,3.1,11795,12178,383
46093,SD,Meade,,2009,4.6,11393,11947,554
46093,SD,Meade,,2010,5.2,12530,13215,685
46093,SD,Meade,,2011,4.7,12598,13222,624
46093,SD,Meade,,2012,4.2,12757,13310,553
46093,SD,Meade,,2013,3.7,13143,13653,510
46093,SD,Meade,,2014,3.3,12951,13389,438
46093,SD,Meade,,2015,3.1,13004,13421,417
46093,SD,Meade,,2016,3.2,13310,13746,436
46093,SD,Meade,,2017,3.2,13497,13937,440
46093,SD,Meade,,2018,3.1,13522,13949,427
46093,SD,Meade,,2019,3.1,13468,13898,430
46093,SD,Meade,,2020,4.7,13146,13789,643
46093,SD,Meade,,2021,3,13712,14140,428
46095,SD,Mellette,,2007,4.5,837,876,39
46095,SD,Mellette,,2008,4.4,828,866,38
46095,SD,Mellette,,2009,6.6,808,865,57
46095,SD,Mellette,,2010,6.3,822,877,55
46095,SD,Mellette,,2011,6.2,817,871,54
46095,SD,Mellette,,2012,7.4,799,863,64
46095,SD,Mellette,,2013,7.4,777,839,62
46095,SD,Mellette,,2014,5.9,783,832,49
46095,SD,Mellette,,2015,5.1,762,803,41
46095,SD,Mellette,,2016,4.3,741,774,33
46095,SD,Mellette,,2017,4.6,728,763,35
46095,SD,Mellette,,2018,4.4,711,744,33
46095,SD,Mellette,,2019,4.9,701,737,36
46095,SD,Mellette,,2020,5.9,666,708,42
46095,SD,Mellette,,2021,4.5,696,729,33
46097,SD,Miner,,2007,3.5,1141,1182,41
46097,SD,Miner,,2008,3.5,1190,1233,43
46097,SD,Miner,,2009,5,1202,1265,63
46097,SD,Miner,,2010,5,1310,1379,69
46097,SD,Miner,,2011,4.3,1251,1307,56
46097,SD,Miner,,2012,3.4,1229,1272,43
46097,SD,Miner,,2013,3.5,1199,1243,44
46097,SD,Miner,,2014,3.1,1210,1249,39
46097,SD,Miner,,2015,2.4,1191,1220,29
46097,SD,Miner,,2016,2.7,1174,1206,32
46097,SD,Miner,,2017,2.8,1161,1194,33
46097,SD,Miner,,2018,2.5,1159,1189,30
46097,SD,Miner,,2019,2.7,1137,1168,31
46097,SD,Miner,,2020,4.5,1090,1141,51
46097,SD,Miner,,2021,3.1,1131,1167,36
46099,SD,Minnehaha,,2007,2.5,95554,98022,2468
46099,SD,Minnehaha,,2008,2.9,96438,99268,2830
46099,SD,Minnehaha,,2009,4.7,94805,99450,4645
46099,SD,Minnehaha,,2010,4.9,94792,99686,4894
46099,SD,Minnehaha,,2011,4.4,96100,100479,4379
46099,SD,Minnehaha,,2012,3.8,98148,101974,3826
46099,SD,Minnehaha,,2013,3.2,100107,103466,3359
46099,SD,Minnehaha,,2014,2.9,102263,105348,3085
46099,SD,Minnehaha,,2015,2.7,104148,106985,2837
46099,SD,Minnehaha,,2016,2.6,105446,108249,2803
46099,SD,Minnehaha,,2017,2.6,106265,109127,2862
46099,SD,Minnehaha,,2018,2.4,107551,110228,2677
46099,SD,Minnehaha,,2019,2.5,109061,111816,2755
46099,SD,Minnehaha,,2020,4.3,107919,112711,4792
46099,SD,Minnehaha,,2021,2.9,111108,114373,3265
46101,SD,Moody,,2007,3.7,3854,4004,150
46101,SD,Moody,,2008,4.3,3824,3997,173
46101,SD,Moody,,2009,6.2,3665,3908,243
46101,SD,Moody,,2010,6.9,3886,4175,289
46101,SD,Moody,,2011,6.2,3909,4169,260
46101,SD,Moody,,2012,5.2,3834,4044,210
46101,SD,Moody,,2013,4.5,3843,4025,182
46101,SD,Moody,,2014,4,3840,4000,160
46101,SD,Moody,,2015,3.3,3836,3968,132
46101,SD,Moody,,2016,3.7,3823,3970,147
46101,SD,Moody,,2017,3.4,3840,3976,136
46101,SD,Moody,,2018,2.8,3880,3990,110
46101,SD,Moody,,2019,3.1,3899,4023,124
46101,SD,Moody,,2020,4.9,3806,4000,194
46101,SD,Moody,,2021,2.8,3890,4002,112
46102,SD,Oglala Lakota,,2007,7.9,3451,3746,295
46102,SD,Oglala Lakota,,2008,8.5,3411,3727,316
46102,SD,Oglala Lakota,,2009,10.1,3536,3934,398
46102,SD,Oglala Lakota,,2010,12.8,3253,3731,478
46102,SD,Oglala Lakota,,2011,13.7,3238,3754,516
46102,SD,Oglala Lakota,,2012,13.5,3263,3774,511
46102,SD,Oglala Lakota,,2013,13.3,3202,3694,492
46102,SD,Oglala Lakota,,2014,13,3164,3637,473
46102,SD,Oglala Lakota,,2015,11.3,3197,3604,407
46102,SD,Oglala Lakota,,2016,10.9,3239,3634,395
46102,SD,Oglala Lakota,,2017,10.7,3215,3602,387
46102,SD,Oglala Lakota,,2018,9.6,3200,3540,340
46102,SD,Oglala Lakota,,2019,8.4,3217,3511,294
46102,SD,Oglala Lakota,,2020,9.2,3418,3765,347
46102,SD,Oglala Lakota,,2021,8.7,3649,3998,349
46103,SD,Pennington,,2007,2.7,52138,53589,1451
46103,SD,Pennington,,2008,3,52710,54313,1603
46103,SD,Pennington,,2009,4.5,52267,54752,2485
46103,SD,Pennington,,2010,5.2,50376,53112,2736
46103,SD,Pennington,,2011,4.7,51058,53574,2516
46103,SD,Pennington,,2012,4.2,51602,53841,2239
46103,SD,Pennington,,2013,3.8,51654,53706,2052
46103,SD,Pennington,,2014,3.3,52602,54411,1809
46103,SD,Pennington,,2015,3.1,53010,54705,1695
46103,SD,Pennington,,2016,3.1,53277,54987,1710
46103,SD,Pennington,,2017,3.1,53883,55619,1736
46103,SD,Pennington,,2018,2.8,54285,55871,1586
46103,SD,Pennington,,2019,2.9,55059,56714,1655
46103,SD,Pennington,,2020,5,54232,57063,2831
46103,SD,Pennington,,2021,3.2,56546,58416,1870
46105,SD,Perkins,,2007,3,1575,1623,48
46105,SD,Perkins,,2008,3.1,1543,1593,50
46105,SD,Perkins,,2009,3.8,1556,1618,62
46105,SD,Perkins,,2010,4.1,1554,1620,66
46105,SD,Perkins,,2011,4.2,1520,1586,66
46105,SD,Perkins,,2012,3.8,1491,1550,59
46105,SD,Perkins,,2013,3.6,1490,1546,56
46105,SD,Perkins,,2014,3.3,1511,1562,51
46105,SD,Perkins,,2015,3.1,1536,1585,49
46105,SD,Perkins,,2016,2.9,1539,1585,46
46105,SD,Perkins,,2017,2.6,1548,1590,42
46105,SD,Perkins,,2018,2.6,1399,1437,38
46105,SD,Perkins,,2019,2.6,1370,1407,37
46105,SD,Perkins,,2020,3.4,1318,1365,47
46105,SD,Perkins,,2021,3.1,1349,1392,43
46107,SD,Potter,,2007,3,1250,1288,38
46107,SD,Potter,,2008,3.1,1246,1286,40
46107,SD,Potter,,2009,3.5,1255,1300,45
46107,SD,Potter,,2010,4.8,1221,1282,61
46107,SD,Potter,,2011,5.2,1186,1251,65
46107,SD,Potter,,2012,3.8,1176,1223,47
46107,SD,Potter,,2013,3.8,1165,1211,46
46107,SD,Potter,,2014,3.2,1169,1208,39
46107,SD,Potter,,2015,3.2,1152,1190,38
46107,SD,Potter,,2016,2.8,1131,1163,32
46107,SD,Potter,,2017,3.1,1086,1121,35
46107,SD,Potter,,2018,3.2,1050,1085,35
46107,SD,Potter,,2019,2.7,1000,1028,28
46107,SD,Potter,,2020,3,987,1018,31
46107,SD,Potter,,2021,3,1018,1050,32
46109,SD,Roberts,,2007,4,4615,4809,194
46109,SD,Roberts,,2008,4.2,4579,4780,201
46109,SD,Roberts,,2009,5.6,4483,4748,265
46109,SD,Roberts,,2010,5.7,4785,5075,290
46109,SD,Roberts,,2011,6.5,4751,5083,332
46109,SD,Roberts,,2012,5.4,4700,4970,270
46109,SD,Roberts,,2013,5.1,4621,4869,248
46109,SD,Roberts,,2014,4.7,4662,4891,229
46109,SD,Roberts,,2015,4.3,4686,4895,209
46109,SD,Roberts,,2016,4.2,4663,4865,202
46109,SD,Roberts,,2017,4.4,4595,4809,214
46109,SD,Roberts,,2018,4,4625,4816,191
46109,SD,Roberts,,2019,3.7,4619,4795,176
46109,SD,Roberts,,2020,6,4511,4797,286
46109,SD,Roberts,,2021,4.6,4509,4726,217
46111,SD,Sanborn,,2007,2.5,1415,1451,36
46111,SD,Sanborn,,2008,2.7,1361,1399,38
46111,SD,Sanborn,,2009,3.6,1347,1398,51
46111,SD,Sanborn,,2010,4.1,1297,1353,56
46111,SD,Sanborn,,2011,4.1,1292,1347,55
46111,SD,Sanborn,,2012,3.3,1266,1309,43
46111,SD,Sanborn,,2013,3,1262,1301,39
46111,SD,Sanborn,,2014,2.5,1222,1253,31
46111,SD,Sanborn,,2015,2.5,1204,1235,31
46111,SD,Sanborn,,2016,3,1179,1215,36
46111,SD,Sanborn,,2017,3.3,1134,1173,39
46111,SD,Sanborn,,2018,2.7,1114,1145,31
46111,SD,Sanborn,,2019,2.6,1102,1131,29
46111,SD,Sanborn,,2020,3.8,1110,1154,44
46111,SD,Sanborn,,2021,3,1148,1184,36
46115,SD,Spink,,2007,3.2,3240,3346,106
46115,SD,Spink,,2008,3.3,3188,3298,110
46115,SD,Spink,,2009,3.9,3304,3437,133
46115,SD,Spink,,2010,3.7,3476,3609,133
46115,SD,Spink,,2011,4,3383,3525,142
46115,SD,Spink,,2012,3.9,3300,3433,133
46115,SD,Spink,,2013,3.5,3243,3361,118
46115,SD,Spink,,2014,3.4,3297,3414,117
46115,SD,Spink,,2015,3,3237,3338,101
46115,SD,Spink,,2016,3.1,3199,3302,103
46115,SD,Spink,,2017,3.2,3124,3226,102
46115,SD,Spink,,2018,3.2,3120,3224,104
46115,SD,Spink,,2019,2.9,3062,3154,92
46115,SD,Spink,,2020,3.8,2959,3075,116
46115,SD,Spink,,2021,3.2,2969,3067,98
46117,SD,Stanley,,2007,2.3,1856,1900,44
46117,SD,Stanley,,2008,2.5,1826,1872,46
46117,SD,Stanley,,2009,2.9,1876,1933,57
46117,SD,Stanley,,2010,3.7,1892,1965,73
46117,SD,Stanley,,2011,3.9,1862,1937,75
46117,SD,Stanley,,2012,2.9,1825,1879,54
46117,SD,Stanley,,2013,2.7,1819,1870,51
46117,SD,Stanley,,2014,2.5,1826,1873,47
46117,SD,Stanley,,2015,2.3,1802,1845,43
46117,SD,Stanley,,2016,2.4,1834,1879,45
46117,SD,Stanley,,2017,3.1,1805,1863,58
46117,SD,Stanley,,2018,2.4,1783,1827,44
46117,SD,Stanley,,2019,2.5,1840,1888,48
46117,SD,Stanley,,2020,3.6,1834,1903,69
46117,SD,Stanley,,2021,3,1861,1919,58
46119,SD,Sully,,2007,2.2,956,978,22
46119,SD,Sully,,2008,2.2,963,985,22
46119,SD,Sully,,2009,2.8,964,992,28
46119,SD,Sully,,2010,3.6,859,891,32
46119,SD,Sully,,2011,3.7,851,884,33
46119,SD,Sully,,2012,2.9,864,890,26
46119,SD,Sully,,2013,2.8,863,888,25
46119,SD,Sully,,2014,2.7,867,891,24
46119,SD,Sully,,2015,2.5,854,876,22
46119,SD,Sully,,2016,2.3,843,863,20
46119,SD,Sully,,2017,2.9,809,833,24
46119,SD,Sully,,2018,2.4,783,802,19
46119,SD,Sully,,2019,2.5,776,796,20
46119,SD,Sully,,2020,2.7,766,787,21
46119,SD,Sully,,2021,3.8,779,810,31
46121,SD,Todd,,2007,5.8,3185,3381,196
46121,SD,Todd,,2008,6.4,3165,3382,217
46121,SD,Todd,,2009,6.6,3283,3516,233
46121,SD,Todd,,2010,7.6,3145,3403,258
46121,SD,Todd,,2011,8.3,3120,3403,283
46121,SD,Todd,,2012,9.2,2954,3254,300
46121,SD,Todd,,2013,9.6,2894,3203,309
46121,SD,Todd,,2014,8.5,2862,3127,265
46121,SD,Todd,,2015,7.2,2844,3066,222
46121,SD,Todd,,2016,6.5,2876,3077,201
46121,SD,Todd,,2017,6.1,2934,3126,192
46121,SD,Todd,,2018,5.7,2940,3118,178
46121,SD,Todd,,2019,5.5,2955,3128,173
46121,SD,Todd,,2020,6.1,2858,3043,185
46121,SD,Todd,,2021,4.8,2963,3111,148
46123,SD,Tripp,,2007,2.9,2878,2964,86
46123,SD,Tripp,,2008,3,2838,2926,88
46123,SD,Tripp,,2009,3.3,2842,2938,96
46123,SD,Tripp,,2010,3.6,3184,3302,118
46123,SD,Tripp,,2011,3.7,3163,3283,120
46123,SD,Tripp,,2012,3.5,3067,3179,112
46123,SD,Tripp,,2013,3.4,3012,3118,106
46123,SD,Tripp,,2014,3.1,3052,3150,98
46123,SD,Tripp,,2015,2.6,3019,3100,81
46123,SD,Tripp,,2016,2.2,3009,3078,69
46123,SD,Tripp,,2017,2.6,2953,3032,79
46123,SD,Tripp,,2018,2.3,3019,3090,71
46123,SD,Tripp,,2019,2.5,2976,3051,75
46123,SD,Tripp,,2020,2.9,2897,2984,87
46123,SD,Tripp,,2021,2.4,2933,3004,71
46125,SD,Turner,,2007,2.9,4119,4244,125
46125,SD,Turner,,2008,3.3,4061,4201,140
46125,SD,Turner,,2009,4.8,3847,4040,193
46125,SD,Turner,,2010,4.5,4656,4875,219
46125,SD,Turner,,2011,4,4672,4866,194
46125,SD,Turner,,2012,3.3,4624,4782,158
46125,SD,Turner,,2013,3,4612,4754,142
46125,SD,Turner,,2014,2.8,4569,4702,133
46125,SD,Turner,,2015,2.6,4543,4665,122
46125,SD,Turner,,2016,2.8,4568,4700,132
46125,SD,Turner,,2017,3,4525,4664,139
46125,SD,Turner,,2018,2.5,4517,4634,117
46125,SD,Turner,,2019,2.6,4507,4629,122
46125,SD,Turner,,2020,3.7,4380,4550,170
46125,SD,Turner,,2021,2.7,4519,4643,124
46127,SD,Union,,2007,3,7848,8092,244
46127,SD,Union,,2008,3.5,7994,8281,287
46127,SD,Union,,2009,5.6,7977,8446,469
46127,SD,Union,,2010,5.7,7338,7782,444
46127,SD,Union,,2011,5,7338,7728,390
46127,SD,Union,,2012,4.5,7528,7883,355
46127,SD,Union,,2013,4.1,7614,7938,324
46127,SD,Union,,2014,3.6,7779,8070,291
46127,SD,Union,,2015,3.3,7811,8080,269
46127,SD,Union,,2016,3.1,7836,8090,254
46127,SD,Union,,2017,3.4,7758,8027,269
46127,SD,Union,,2018,2.9,8123,8366,243
46127,SD,Union,,2019,2.9,8327,8575,248
46127,SD,Union,,2020,4.7,8191,8597,406
46127,SD,Union,,2021,3.6,8311,8619,308
46129,SD,Walworth,,2007,3.9,2571,2676,105
46129,SD,Walworth,,2008,4.3,2522,2636,114
46129,SD,Walworth,,2009,4.7,2564,2691,127
46129,SD,Walworth,,2010,6.7,2242,2404,162
46129,SD,Walworth,,2011,6.8,2222,2385,163
46129,SD,Walworth,,2012,5.8,2210,2347,137
46129,SD,Walworth,,2013,5.4,2246,2373,127
46129,SD,Walworth,,2014,5.2,2256,2380,124
46129,SD,Walworth,,2015,5.3,2160,2281,121
46129,SD,Walworth,,2016,5.2,2137,2254,117
46129,SD,Walworth,,2017,4.7,2126,2230,104
46129,SD,Walworth,,2018,4.5,2102,2202,100
46129,SD,Walworth,,2019,4.7,1996,2094,98
46129,SD,Walworth,,2020,5.7,1995,2116,121
46129,SD,Walworth,,2021,5.5,2041,2159,118
46135,SD,Yankton,,2007,2.6,11814,12126,312
46135,SD,Yankton,,2008,2.8,11683,12022,339
46135,SD,Yankton,,2009,5.2,11273,11889,616
46135,SD,Yankton,,2010,4.8,10932,11487,555
46135,SD,Yankton,,2011,4.3,11040,11540,500
46135,SD,Yankton,,2012,3.5,11285,11692,407
46135,SD,Yankton,,2013,3.3,11214,11594,380
46135,SD,Yankton,,2014,2.9,11120,11456,336
46135,SD,Yankton,,2015,2.6,11374,11673,299
46135,SD,Yankton,,2016,2.6,11341,11643,302
46135,SD,Yankton,,2017,2.7,11278,11590,312
46135,SD,Yankton,,2018,2.4,11497,11783,286
46135,SD,Yankton,,2019,2.4,11568,11858,290
46135,SD,Yankton,,2020,4.3,11175,11676,501
46135,SD,Yankton,,2021,2.7,11313,11629,316
46137,SD,Ziebach,,2007,6,802,853,51
46137,SD,Ziebach,,2008,6,783,833,50
46137,SD,Ziebach,,2009,6.5,821,878,57
46137,SD,Ziebach,,2010,5.8,999,1060,61
46137,SD,Ziebach,,2011,6.3,1004,1071,67
46137,SD,Ziebach,,2012,6.6,995,1065,70
46137,SD,Ziebach,,2013,6.1,974,1037,63
46137,SD,Ziebach,,2014,5.7,953,1011,58
46137,SD,Ziebach,,2015,5,940,989,49
46137,SD,Ziebach,,2016,4.6,936,981,45
46137,SD,Ziebach,,2017,4.9,889,935,46
46137,SD,Ziebach,,2018,4.8,873,917,44
46137,SD,Ziebach,,2019,4.7,883,927,44
46137,SD,Ziebach,,2020,4.2,902,942,40
46137,SD,Ziebach,,2021,4.5,909,952,43
47000,TN,Tennessee,,2007,4.6,2901946,3043258,141312
47000,TN,Tennessee,,2008,6.5,2862093,3060778,198685
47000,TN,Tennessee,,2009,10.1,2725134,3032658,307524
47000,TN,Tennessee,,2010,9.8,2789056,3093118,304062
47000,TN,Tennessee,,2011,9.1,2833278,3117492,284214
47000,TN,Tennessee,,2012,8,2849727,3096322,246595
47000,TN,Tennessee,,2013,7.8,2840127,3078892,238765
47000,TN,Tennessee,,2014,6.6,2842540,3043573,201033
47000,TN,Tennessee,,2015,5.6,2902684,3074216,171532
47000,TN,Tennessee,,2016,4.7,2987679,3136399,148720
47000,TN,Tennessee,,2017,3.7,3077515,3197032,119517
47000,TN,Tennessee,,2018,3.5,3147030,3260862,113832
47000,TN,Tennessee,,2019,3.4,3226045,3339543,113498
47000,TN,Tennessee,,2020,7.4,3055830,3299424,243594
47000,TN,Tennessee,,2021,4.3,3185263,3327966,142703
47001,TN,Anderson,,2007,4.2,34152,35650,1498
47001,TN,Anderson,,2008,5.7,33798,35859,2061
47001,TN,Anderson,,2009,9.6,32392,35824,3432
47001,TN,Anderson,,2010,9.5,31642,34950,3308
47001,TN,Anderson,,2011,8.9,31965,35083,3118
47001,TN,Anderson,,2012,8.1,31690,34465,2775
47001,TN,Anderson,,2013,7.9,31128,33798,2670
47001,TN,Anderson,,2014,6.8,30889,33154,2265
47001,TN,Anderson,,2015,5.8,31423,33351,1928
47001,TN,Anderson,,2016,4.9,32045,33693,1648
47001,TN,Anderson,,2017,3.9,32580,33916,1336
47001,TN,Anderson,,2018,3.8,32989,34280,1291
47001,TN,Anderson,,2019,3.6,33563,34803,1240
47001,TN,Anderson,,2020,6.7,32035,34328,2293
47001,TN,Anderson,,2021,3.8,33483,34816,1333
47003,TN,Bedford,,2007,4.8,21749,22837,1088
47003,TN,Bedford,,2008,6.7,21014,22523,1509
47003,TN,Bedford,,2009,11.9,19626,22265,2639
47003,TN,Bedford,,2010,12.8,18417,21113,2696
47003,TN,Bedford,,2011,11.4,18479,20862,2383
47003,TN,Bedford,,2012,9.9,18260,20275,2015
47003,TN,Bedford,,2013,9.2,18241,20080,1839
47003,TN,Bedford,,2014,7.5,18057,19524,1467
47003,TN,Bedford,,2015,6.4,18203,19448,1245
47003,TN,Bedford,,2016,5,18846,19835,989
47003,TN,Bedford,,2017,3.9,19743,20553,810
47003,TN,Bedford,,2018,3.8,20017,20798,781
47003,TN,Bedford,,2019,3.7,20354,21147,793
47003,TN,Bedford,,2020,7.9,19377,21043,1666
47003,TN,Bedford,,2021,4.1,20320,21191,871
47005,TN,Benton,,2007,6.1,6535,6956,421
47005,TN,Benton,,2008,8.6,6458,7068,610
47005,TN,Benton,,2009,13.5,6058,7002,944
47005,TN,Benton,,2010,12.5,6308,7210,902
47005,TN,Benton,,2011,11.6,6294,7116,822
47005,TN,Benton,,2012,10,6262,6956,694
47005,TN,Benton,,2013,9.7,6232,6905,673
47005,TN,Benton,,2014,8.8,6144,6737,593
47005,TN,Benton,,2015,7.6,6261,6778,517
47005,TN,Benton,,2016,7.1,6262,6744,482
47005,TN,Benton,,2017,5.4,6363,6726,363
47005,TN,Benton,,2018,4.9,6568,6905,337
47005,TN,Benton,,2019,4.5,6617,6926,309
47005,TN,Benton,,2020,7.9,6248,6782,534
47005,TN,Benton,,2021,4.8,6462,6786,324
47007,TN,Bledsoe,,2007,5.7,4628,4910,282
47007,TN,Bledsoe,,2008,8.3,4520,4929,409
47007,TN,Bledsoe,,2009,13.6,4229,4895,666
47007,TN,Bledsoe,,2010,13.4,3875,4477,602
47007,TN,Bledsoe,,2011,11.5,3973,4487,514
47007,TN,Bledsoe,,2012,10.6,3851,4307,456
47007,TN,Bledsoe,,2013,10.5,3899,4356,457
47007,TN,Bledsoe,,2014,9,3910,4299,389
47007,TN,Bledsoe,,2015,7.9,3922,4257,335
47007,TN,Bledsoe,,2016,7,4023,4325,302
47007,TN,Bledsoe,,2017,5.9,4048,4301,253
47007,TN,Bledsoe,,2018,5.9,3985,4236,251
47007,TN,Bledsoe,,2019,5.5,4100,4337,237
47007,TN,Bledsoe,,2020,8.4,3931,4290,359
47007,TN,Bledsoe,,2021,5.2,4086,4311,225
47009,TN,Blount,,2007,3.9,60050,62491,2441
47009,TN,Blount,,2008,6.1,59681,63545,3864
47009,TN,Blount,,2009,9.6,57272,63323,6051
47009,TN,Blount,,2010,9.2,55766,61439,5673
47009,TN,Blount,,2011,8.3,56476,61583,5107
47009,TN,Blount,,2012,7.2,56001,60341,4340
47009,TN,Blount,,2013,6.9,55351,59469,4118
47009,TN,Blount,,2014,6,55444,58993,3549
47009,TN,Blount,,2015,5.1,56591,59654,3063
47009,TN,Blount,,2016,4.4,58202,60872,2670
47009,TN,Blount,,2017,3.5,59519,61692,2173
47009,TN,Blount,,2018,3.2,60734,62756,2022
47009,TN,Blount,,2019,3.2,62219,64268,2049
47009,TN,Blount,,2020,6.3,59710,63745,4035
47009,TN,Blount,,2021,3.4,62359,64582,2223
47011,TN,Bradley,,2007,4.4,45873,48006,2133
47011,TN,Bradley,,2008,6.3,44631,47637,3006
47011,TN,Bradley,,2009,9.2,43022,47375,4353
47011,TN,Bradley,,2010,9.6,42041,46481,4440
47011,TN,Bradley,,2011,9,43049,47320,4271
47011,TN,Bradley,,2012,7.5,45054,48700,3646
47011,TN,Bradley,,2013,7.1,46138,49653,3515
47011,TN,Bradley,,2014,6.1,46297,49294,2997
47011,TN,Bradley,,2015,5.2,46975,49544,2569
47011,TN,Bradley,,2016,4.5,47911,50153,2242
47011,TN,Bradley,,2017,3.6,49064,50918,1854
47011,TN,Bradley,,2018,3.6,48796,50606,1810
47011,TN,Bradley,,2019,3.5,50772,52588,1816
47011,TN,Bradley,,2020,6.5,49146,52569,3423
47011,TN,Bradley,,2021,4.1,48732,50805,2073
47013,TN,Campbell,,2007,5.3,16036,16931,895
47013,TN,Campbell,,2008,7.7,15709,17013,1304
47013,TN,Campbell,,2009,12.8,14698,16851,2153
47013,TN,Campbell,,2010,12.7,14100,16153,2053
47013,TN,Campbell,,2011,11.9,14176,16089,1913
47013,TN,Campbell,,2012,11.2,13955,15723,1768
47013,TN,Campbell,,2013,11,13607,15295,1688
47013,TN,Campbell,,2014,9.4,13388,14775,1387
47013,TN,Campbell,,2015,7.9,13504,14657,1153
47013,TN,Campbell,,2016,6.9,13720,14743,1023
47013,TN,Campbell,,2017,5.2,13872,14634,762
47013,TN,Campbell,,2018,4.8,13983,14684,701
47013,TN,Campbell,,2019,4.6,14230,14917,687
47013,TN,Campbell,,2020,7.5,13489,14587,1098
47013,TN,Campbell,,2021,4.8,14092,14796,704
47015,TN,Cannon,,2007,4.8,6095,6403,308
47015,TN,Cannon,,2008,7.3,6124,6605,481
47015,TN,Cannon,,2009,11.6,5785,6544,759
47015,TN,Cannon,,2010,11.3,5399,6089,690
47015,TN,Cannon,,2011,10.5,5443,6081,638
47015,TN,Cannon,,2012,8.6,5501,6021,520
47015,TN,Cannon,,2013,7.9,5457,5923,466
47015,TN,Cannon,,2014,6.4,5434,5804,370
47015,TN,Cannon,,2015,5.7,5533,5869,336
47015,TN,Cannon,,2016,4.6,5744,6024,280
47015,TN,Cannon,,2017,3.5,5986,6206,220
47015,TN,Cannon,,2018,3.2,6232,6435,203
47015,TN,Cannon,,2019,3.1,6468,6673,205
47015,TN,Cannon,,2020,6.5,6102,6525,423
47015,TN,Cannon,,2021,3.4,6432,6657,225
47017,TN,Carroll,,2007,6.3,12887,13747,860
47017,TN,Carroll,,2008,9,12552,13797,1245
47017,TN,Carroll,,2009,15.5,11522,13642,2120
47017,TN,Carroll,,2010,14.9,11800,13861,2061
47017,TN,Carroll,,2011,12.3,11979,13658,1679
47017,TN,Carroll,,2012,11.1,11885,13371,1486
47017,TN,Carroll,,2013,11.8,11593,13149,1556
47017,TN,Carroll,,2014,10.1,11271,12535,1264
47017,TN,Carroll,,2015,8.2,11203,12206,1003
47017,TN,Carroll,,2016,6.7,11219,12031,812
47017,TN,Carroll,,2017,5.1,11332,11947,615
47017,TN,Carroll,,2018,4.9,11463,12057,594
47017,TN,Carroll,,2019,4.8,11473,12055,582
47017,TN,Carroll,,2020,7.4,10583,11426,843
47017,TN,Carroll,,2021,4.6,10915,11437,522
47019,TN,Carter,,2007,4.8,28104,29527,1423
47019,TN,Carter,,2008,6.5,27832,29774,1942
47019,TN,Carter,,2009,10,26307,29226,2919
47019,TN,Carter,,2010,11.1,23334,26253,2919
47019,TN,Carter,,2011,10.2,23549,26229,2680
47019,TN,Carter,,2012,9.1,23158,25473,2315
47019,TN,Carter,,2013,9.2,22580,24864,2284
47019,TN,Carter,,2014,7.7,22036,23880,1844
47019,TN,Carter,,2015,6.4,22069,23575,1506
47019,TN,Carter,,2016,5.7,22342,23685,1343
47019,TN,Carter,,2017,4.6,22813,23902,1089
47019,TN,Carter,,2018,4.1,22907,23898,991
47019,TN,Carter,,2019,4.1,23185,24166,981
47019,TN,Carter,,2020,6.8,22074,23679,1605
47019,TN,Carter,,2021,4.2,23081,24094,1013
47021,TN,Cheatham,,2007,3.8,19629,20405,776
47021,TN,Cheatham,,2008,5.4,19332,20431,1099
47021,TN,Cheatham,,2009,9.1,18409,20262,1853
47021,TN,Cheatham,,2010,9.1,18380,20221,1841
47021,TN,Cheatham,,2011,8.6,18533,20274,1741
47021,TN,Cheatham,,2012,7.3,18667,20144,1477
47021,TN,Cheatham,,2013,6.6,18692,20007,1315
47021,TN,Cheatham,,2014,5.5,18765,19858,1093
47021,TN,Cheatham,,2015,4.8,18953,19908,955
47021,TN,Cheatham,,2016,4,19462,20271,809
47021,TN,Cheatham,,2017,3.1,20229,20868,639
47021,TN,Cheatham,,2018,2.8,20789,21378,589
47021,TN,Cheatham,,2019,2.6,21368,21948,580
47021,TN,Cheatham,,2020,5.6,20160,21366,1206
47021,TN,Cheatham,,2021,3.1,21330,22015,685
47023,TN,Chester,,2007,5.2,7455,7865,410
47023,TN,Chester,,2008,6.9,7415,7961,546
47023,TN,Chester,,2009,10.9,6954,7808,854
47023,TN,Chester,,2010,10.1,7521,8370,849
47023,TN,Chester,,2011,9.2,7725,8510,785
47023,TN,Chester,,2012,8,7697,8364,667
47023,TN,Chester,,2013,8.1,7623,8293,670
47023,TN,Chester,,2014,6.8,7609,8165,556
47023,TN,Chester,,2015,5.8,7762,8242,480
47023,TN,Chester,,2016,5,8028,8450,422
47023,TN,Chester,,2017,4,8011,8343,332
47023,TN,Chester,,2018,3.7,8197,8516,319
47023,TN,Chester,,2019,3.4,8327,8623,296
47023,TN,Chester,,2020,5.5,8007,8473,466
47023,TN,Chester,,2021,3.3,8228,8507,279
47025,TN,Claiborne,,2007,5.3,12456,13156,700
47025,TN,Claiborne,,2008,7.4,12367,13356,989
47025,TN,Claiborne,,2009,11.7,11555,13083,1528
47025,TN,Claiborne,,2010,11,12136,13633,1497
47025,TN,Claiborne,,2011,11.2,12125,13656,1531
47025,TN,Claiborne,,2012,10,11985,13319,1334
47025,TN,Claiborne,,2013,10.7,11656,13052,1396
47025,TN,Claiborne,,2014,8.7,11606,12709,1103
47025,TN,Claiborne,,2015,7.2,11696,12601,905
47025,TN,Claiborne,,2016,6.2,11913,12706,793
47025,TN,Claiborne,,2017,4.7,12120,12721,601
47025,TN,Claiborne,,2018,4.2,12449,13001,552
47025,TN,Claiborne,,2019,4.2,12591,13143,552
47025,TN,Claiborne,,2020,7.4,11840,12786,946
47025,TN,Claiborne,,2021,4.1,12237,12760,523
47027,TN,Clay,,2007,7.9,3227,3503,276
47027,TN,Clay,,2008,10.5,3121,3487,366
47027,TN,Clay,,2009,14.2,2840,3310,470
47027,TN,Clay,,2010,12.3,2909,3317,408
47027,TN,Clay,,2011,10.8,3042,3409,367
47027,TN,Clay,,2012,10.2,2980,3318,338
47027,TN,Clay,,2013,10.7,2773,3106,333
47027,TN,Clay,,2014,9.1,2730,3004,274
47027,TN,Clay,,2015,8.8,2740,3004,264
47027,TN,Clay,,2016,6.6,2844,3044,200
47027,TN,Clay,,2017,5.1,2880,3036,156
47027,TN,Clay,,2018,4.9,2734,2875,141
47027,TN,Clay,,2019,6,2626,2793,167
47027,TN,Clay,,2020,7.7,2495,2704,209
47027,TN,Clay,,2021,5.3,2612,2757,145
47029,TN,Cocke,,2007,6.2,15465,16493,1028
47029,TN,Cocke,,2008,8.7,15096,16527,1431
47029,TN,Cocke,,2009,13.5,14273,16507,2234
47029,TN,Cocke,,2010,13.8,13702,15904,2202
47029,TN,Cocke,,2011,13.4,13645,15751,2106
47029,TN,Cocke,,2012,11.7,13657,15458,1801
47029,TN,Cocke,,2013,10.9,13397,15029,1632
47029,TN,Cocke,,2014,9.1,13248,14569,1321
47029,TN,Cocke,,2015,7.7,13321,14433,1112
47029,TN,Cocke,,2016,6.3,13543,14460,917
47029,TN,Cocke,,2017,5.3,13850,14618,768
47029,TN,Cocke,,2018,4.7,14229,14927,698
47029,TN,Cocke,,2019,4.6,14383,15071,688
47029,TN,Cocke,,2020,10.3,13333,14864,1531
47029,TN,Cocke,,2021,5.5,13952,14771,819
47031,TN,Coffee,,2007,4.5,24665,25828,1163
47031,TN,Coffee,,2008,6.2,24172,25775,1603
47031,TN,Coffee,,2009,10.4,22725,25369,2644
47031,TN,Coffee,,2010,11,21624,24290,2666
47031,TN,Coffee,,2011,10.1,22175,24662,2487
47031,TN,Coffee,,2012,8.4,22558,24620,2062
47031,TN,Coffee,,2013,7.8,22618,24530,1912
47031,TN,Coffee,,2014,6.4,22932,24504,1572
47031,TN,Coffee,,2015,5.5,23004,24345,1341
47031,TN,Coffee,,2016,4.7,23310,24470,1160
47031,TN,Coffee,,2017,3.7,24059,24974,915
47031,TN,Coffee,,2018,3.5,23953,24830,877
47031,TN,Coffee,,2019,3.3,24883,25743,860
47031,TN,Coffee,,2020,7.9,23646,25676,2030
47031,TN,Coffee,,2021,4.1,24192,25220,1028
47033,TN,Crockett,,2007,6.1,6152,6552,400
47033,TN,Crockett,,2008,8.8,5904,6473,569
47033,TN,Crockett,,2009,12.7,5649,6473,824
47033,TN,Crockett,,2010,11.8,6428,7287,859
47033,TN,Crockett,,2011,10.7,6529,7310,781
47033,TN,Crockett,,2012,9.3,6535,7208,673
47033,TN,Crockett,,2013,9.1,6395,7035,640
47033,TN,Crockett,,2014,7.7,6371,6899,528
47033,TN,Crockett,,2015,6.4,6398,6833,435
47033,TN,Crockett,,2016,5.3,6528,6890,362
47033,TN,Crockett,,2017,4.1,6678,6967,289
47033,TN,Crockett,,2018,3.9,6694,6963,269
47033,TN,Crockett,,2019,3.5,6753,6997,244
47033,TN,Crockett,,2020,5.7,6438,6828,390
47033,TN,Crockett,,2021,3.6,6589,6833,244
47035,TN,Cumberland,,2007,5.4,21801,23057,1256
47035,TN,Cumberland,,2008,7.7,21432,23229,1797
47035,TN,Cumberland,,2009,11,20360,22881,2521
47035,TN,Cumberland,,2010,10.9,20583,23106,2523
47035,TN,Cumberland,,2011,10.3,21328,23777,2449
47035,TN,Cumberland,,2012,9.2,21627,23807,2180
47035,TN,Cumberland,,2013,9.3,21340,23517,2177
47035,TN,Cumberland,,2014,8,21296,23142,1846
47035,TN,Cumberland,,2015,7,21363,22976,1613
47035,TN,Cumberland,,2016,5.9,22174,23576,1402
47035,TN,Cumberland,,2017,4.7,22323,23414,1091
47035,TN,Cumberland,,2018,4.4,22348,23370,1022
47035,TN,Cumberland,,2019,4.5,22445,23513,1068
47035,TN,Cumberland,,2020,7.5,21080,22789,1709
47035,TN,Cumberland,,2021,4.8,21539,22618,1079
47037,TN,Davidson,,2007,3.8,310959,323214,12255
47037,TN,Davidson,,2008,5.3,307247,324565,17318
47037,TN,Davidson,,2009,8.6,293471,321139,27668
47037,TN,Davidson,,2010,8.3,314127,342568,28441
47037,TN,Davidson,,2011,7.6,322412,349110,26698
47037,TN,Davidson,,2012,6.3,330509,352777,22268
47037,TN,Davidson,,2013,5.9,334535,355490,20955
47037,TN,Davidson,,2014,5,339010,356981,17971
47037,TN,Davidson,,2015,4.3,349100,364944,15844
47037,TN,Davidson,,2016,3.6,360601,374155,13554
47037,TN,Davidson,,2017,2.8,374319,385091,10772
47037,TN,Davidson,,2018,2.7,384282,394751,10469
47037,TN,Davidson,,2019,2.5,393666,403956,10290
47037,TN,Davidson,,2020,8.2,366706,399262,32556
47037,TN,Davidson,,2021,4.2,387756,404747,16991
47039,TN,Decatur,,2007,5.5,5433,5752,319
47039,TN,Decatur,,2008,8.3,5209,5683,474
47039,TN,Decatur,,2009,13,4928,5663,735
47039,TN,Decatur,,2010,13.3,4598,5306,708
47039,TN,Decatur,,2011,11.8,4692,5320,628
47039,TN,Decatur,,2012,10.5,4663,5209,546
47039,TN,Decatur,,2013,10.6,4561,5101,540
47039,TN,Decatur,,2014,9.6,4346,4806,460
47039,TN,Decatur,,2015,7.8,4352,4721,369
47039,TN,Decatur,,2016,6.9,4341,4663,322
47039,TN,Decatur,,2017,5.2,4431,4675,244
47039,TN,Decatur,,2018,5,4278,4504,226
47039,TN,Decatur,,2019,5.4,4319,4565,246
47039,TN,Decatur,,2020,8.6,4062,4442,380
47039,TN,Decatur,,2021,5.7,4061,4308,247
47041,TN,DeKalb,,2007,4.4,9896,10352,456
47041,TN,DeKalb,,2008,6.6,9519,10190,671
47041,TN,DeKalb,,2009,10.6,8885,9934,1049
47041,TN,DeKalb,,2010,11.9,7198,8169,971
47041,TN,DeKalb,,2011,11.3,7282,8210,928
47041,TN,DeKalb,,2012,9.8,7251,8037,786
47041,TN,DeKalb,,2013,10.1,6951,7731,780
47041,TN,DeKalb,,2014,8.2,6856,7469,613
47041,TN,DeKalb,,2015,6.8,6877,7380,503
47041,TN,DeKalb,,2016,5.6,7131,7553,422
47041,TN,DeKalb,,2017,4.8,7302,7671,369
47041,TN,DeKalb,,2018,4.5,7420,7768,348
47041,TN,DeKalb,,2019,4.4,7474,7816,342
47041,TN,DeKalb,,2020,9,6981,7675,694
47041,TN,DeKalb,,2021,4.5,7409,7758,349
47043,TN,Dickson,,2007,4.1,22269,23226,957
47043,TN,Dickson,,2008,6.8,22012,23623,1611
47043,TN,Dickson,,2009,10.7,20859,23358,2499
47043,TN,Dickson,,2010,10.4,21488,23981,2493
47043,TN,Dickson,,2011,9.7,21913,24270,2357
47043,TN,Dickson,,2012,8.5,22121,24166,2045
47043,TN,Dickson,,2013,7.7,22048,23876,1828
47043,TN,Dickson,,2014,6.3,22142,23628,1486
47043,TN,Dickson,,2015,5.4,22841,24143,1302
47043,TN,Dickson,,2016,4.4,23714,24797,1083
47043,TN,Dickson,,2017,3.4,24697,25555,858
47043,TN,Dickson,,2018,3,25577,26378,801
47043,TN,Dickson,,2019,3,26392,27215,823
47043,TN,Dickson,,2020,5.9,24786,26347,1561
47043,TN,Dickson,,2021,3.4,26174,27087,913
47045,TN,Dyer,,2007,4.9,16579,17435,856
47045,TN,Dyer,,2008,7.4,16322,17634,1312
47045,TN,Dyer,,2009,13.5,15092,17452,2360
47045,TN,Dyer,,2010,12.3,15659,17852,2193
47045,TN,Dyer,,2011,12.6,15438,17665,2227
47045,TN,Dyer,,2012,11.2,15519,17472,1953
47045,TN,Dyer,,2013,10.4,15339,17119,1780
47045,TN,Dyer,,2014,8.3,15256,16631,1375
47045,TN,Dyer,,2015,7.1,15507,16696,1189
47045,TN,Dyer,,2016,6.2,15357,16376,1019
47045,TN,Dyer,,2017,4.8,15325,16106,781
47045,TN,Dyer,,2018,4.6,15477,16218,741
47045,TN,Dyer,,2019,4.9,15663,16465,802
47045,TN,Dyer,,2020,7.9,14659,15910,1251
47045,TN,Dyer,,2021,4.6,15333,16075,742
47047,TN,Fayette,,2007,6,16807,17882,1075
47047,TN,Fayette,,2008,7.3,16873,18208,1335
47047,TN,Fayette,,2009,10.7,16147,18088,1941
47047,TN,Fayette,,2010,10.1,16941,18845,1904
47047,TN,Fayette,,2011,9.6,16919,18726,1807
47047,TN,Fayette,,2012,8.6,16809,18394,1585
47047,TN,Fayette,,2013,8.6,16630,18196,1566
47047,TN,Fayette,,2014,7.2,16568,17862,1294
47047,TN,Fayette,,2015,6.1,16808,17907,1099
47047,TN,Fayette,,2016,5.1,17369,18294,925
47047,TN,Fayette,,2017,4,17861,18606,745
47047,TN,Fayette,,2018,3.7,18310,19017,707
47047,TN,Fayette,,2019,3.6,18882,19593,711
47047,TN,Fayette,,2020,6.2,18015,19197,1182
47047,TN,Fayette,,2021,4.1,18489,19283,794
47049,TN,Fentress,,2007,6.3,7302,7789,487
47049,TN,Fentress,,2008,9.3,7314,8062,748
47049,TN,Fentress,,2009,13,6888,7916,1028
47049,TN,Fentress,,2010,12.6,6482,7417,935
47049,TN,Fentress,,2011,11.6,6621,7488,867
47049,TN,Fentress,,2012,9.9,6727,7467,740
47049,TN,Fentress,,2013,9.7,6714,7438,724
47049,TN,Fentress,,2014,8.5,6455,7057,602
47049,TN,Fentress,,2015,7.2,6508,7016,508
47049,TN,Fentress,,2016,6.2,6671,7111,440
47049,TN,Fentress,,2017,4.5,6774,7096,322
47049,TN,Fentress,,2018,4.1,6909,7208,299
47049,TN,Fentress,,2019,4.2,7215,7532,317
47049,TN,Fentress,,2020,6.2,7052,7520,468
47049,TN,Fentress,,2021,4,7223,7526,303
47051,TN,Franklin,,2007,4.9,19165,20149,984
47051,TN,Franklin,,2008,6.6,18621,19930,1309
47051,TN,Franklin,,2009,10.6,17439,19501,2062
47051,TN,Franklin,,2010,10.3,17338,19324,1986
47051,TN,Franklin,,2011,9.5,17416,19245,1829
47051,TN,Franklin,,2012,7.9,17910,19448,1538
47051,TN,Franklin,,2013,7.2,18252,19672,1420
47051,TN,Franklin,,2014,6.2,18474,19686,1212
47051,TN,Franklin,,2015,5.1,18623,19633,1010
47051,TN,Franklin,,2016,4.9,18884,19851,967
47051,TN,Franklin,,2017,3.8,19106,19858,752
47051,TN,Franklin,,2018,3.4,19229,19902,673
47051,TN,Franklin,,2019,3.4,19597,20280,683
47051,TN,Franklin,,2020,8,18311,19902,1591
47051,TN,Franklin,,2021,3.8,18718,19463,745
47053,TN,Gibson,,2007,6.9,19530,20967,1437
47053,TN,Gibson,,2008,9.3,19246,21231,1985
47053,TN,Gibson,,2009,14.3,18361,21414,3053
47053,TN,Gibson,,2010,12.2,20868,23773,2905
47053,TN,Gibson,,2011,11.6,21044,23802,2758
47053,TN,Gibson,,2012,10.5,20473,22865,2392
47053,TN,Gibson,,2013,11,19710,22141,2431
47053,TN,Gibson,,2014,9,19367,21272,1905
47053,TN,Gibson,,2015,7.3,19528,21069,1541
47053,TN,Gibson,,2016,5.9,20001,21250,1249
47053,TN,Gibson,,2017,4.6,20321,21297,976
47053,TN,Gibson,,2018,4.4,20931,21884,953
47053,TN,Gibson,,2019,4.2,21143,22081,938
47053,TN,Gibson,,2020,6.7,20334,21800,1466
47053,TN,Gibson,,2021,4.3,20600,21522,922
47055,TN,Giles,,2007,6.2,12547,13374,827
47055,TN,Giles,,2008,7.9,12417,13484,1067
47055,TN,Giles,,2009,14.5,11387,13315,1928
47055,TN,Giles,,2010,12.3,12512,14262,1750
47055,TN,Giles,,2011,10.1,12834,14280,1446
47055,TN,Giles,,2012,8.6,12819,14020,1201
47055,TN,Giles,,2013,8.1,12960,14107,1147
47055,TN,Giles,,2014,6.1,13387,14261,874
47055,TN,Giles,,2015,4.9,13861,14582,721
47055,TN,Giles,,2016,4,14665,15282,617
47055,TN,Giles,,2017,3.4,15026,15556,530
47055,TN,Giles,,2018,3.6,14755,15313,558
47055,TN,Giles,,2019,3.8,14504,15083,579
47055,TN,Giles,,2020,8.3,13427,14640,1213
47055,TN,Giles,,2021,4.3,14005,14638,633
47057,TN,Grainger,,2007,5.2,9621,10151,530
47057,TN,Grainger,,2008,7.9,9455,10261,806
47057,TN,Grainger,,2009,13.6,8674,10040,1366
47057,TN,Grainger,,2010,13,8751,10054,1303
47057,TN,Grainger,,2011,11.8,8802,9984,1182
47057,TN,Grainger,,2012,10.5,8665,9678,1013
47057,TN,Grainger,,2013,10,8503,9445,942
47057,TN,Grainger,,2014,8.2,8480,9239,759
47057,TN,Grainger,,2015,6.6,8559,9163,604
47057,TN,Grainger,,2016,5.4,8786,9292,506
47057,TN,Grainger,,2017,4.3,8932,9329,397
47057,TN,Grainger,,2018,4,9017,9388,371
47057,TN,Grainger,,2019,4.1,9191,9580,389
47057,TN,Grainger,,2020,7.1,8818,9491,673
47057,TN,Grainger,,2021,4.2,9198,9603,405
47059,TN,Greene,,2007,6.8,29347,31502,2155
47059,TN,Greene,,2008,9.2,27523,30311,2788
47059,TN,Greene,,2009,15.4,25096,29649,4553
47059,TN,Greene,,2010,13,26983,31031,4048
47059,TN,Greene,,2011,11.6,27100,30645,3545
47059,TN,Greene,,2012,10.3,26948,30051,3103
47059,TN,Greene,,2013,9.6,27536,30465,2929
47059,TN,Greene,,2014,8.1,27790,30239,2449
47059,TN,Greene,,2015,6.4,28707,30671,1964
47059,TN,Greene,,2016,5.5,29202,30893,1691
47059,TN,Greene,,2017,4.6,28988,30377,1389
47059,TN,Greene,,2018,4.6,28500,29882,1382
47059,TN,Greene,,2019,4.6,28532,29923,1391
47059,TN,Greene,,2020,8.1,26558,28894,2336
47059,TN,Greene,,2021,4.4,27552,28818,1266
47061,TN,Grundy,,2007,5.9,5604,5954,350
47061,TN,Grundy,,2008,8.2,5466,5957,491
47061,TN,Grundy,,2009,13.7,5151,5968,817
47061,TN,Grundy,,2010,12.8,4918,5643,725
47061,TN,Grundy,,2011,12.6,4828,5524,696
47061,TN,Grundy,,2012,10.2,4962,5527,565
47061,TN,Grundy,,2013,10,4802,5337,535
47061,TN,Grundy,,2014,9.4,4632,5112,480
47061,TN,Grundy,,2015,7.7,4504,4881,377
47061,TN,Grundy,,2016,6.5,4482,4793,311
47061,TN,Grundy,,2017,5,4591,4833,242
47061,TN,Grundy,,2018,4.4,4687,4903,216
47061,TN,Grundy,,2019,4.2,4815,5024,209
47061,TN,Grundy,,2020,9.9,4620,5127,507
47061,TN,Grundy,,2021,5.4,4757,5030,273
47063,TN,Hamblen,,2007,4.7,28780,30196,1416
47063,TN,Hamblen,,2008,7,28223,30350,2127
47063,TN,Hamblen,,2009,12.3,26093,29751,3658
47063,TN,Hamblen,,2010,11.8,25093,28438,3345
47063,TN,Hamblen,,2011,11,25144,28257,3113
47063,TN,Hamblen,,2012,9.6,24935,27574,2639
47063,TN,Hamblen,,2013,9.1,24599,27056,2457
47063,TN,Hamblen,,2014,7.4,24445,26401,1956
47063,TN,Hamblen,,2015,6.2,24885,26517,1632
47063,TN,Hamblen,,2016,5.1,25489,26867,1378
47063,TN,Hamblen,,2017,4.1,26215,27322,1107
47063,TN,Hamblen,,2018,3.8,26546,27600,1054
47063,TN,Hamblen,,2019,3.9,27167,28259,1092
47063,TN,Hamblen,,2020,7,25970,27937,1967
47063,TN,Hamblen,,2021,4,26771,27883,1112
47065,TN,Hamilton,,2007,3.9,161101,167674,6573
47065,TN,Hamilton,,2008,5.6,158818,168258,9440
47065,TN,Hamilton,,2009,8.7,148986,163228,14242
47065,TN,Hamilton,,2010,8.5,154795,169124,14329
47065,TN,Hamilton,,2011,7.9,157758,171245,13487
47065,TN,Hamilton,,2012,7,158780,170750,11970
47065,TN,Hamilton,,2013,7.2,156817,168976,12159
47065,TN,Hamilton,,2014,6.2,154791,165050,10259
47065,TN,Hamilton,,2015,5.3,158840,167676,8836
47065,TN,Hamilton,,2016,4.6,164062,172011,7949
47065,TN,Hamilton,,2017,3.7,170280,176739,6459
47065,TN,Hamilton,,2018,3.4,175103,181223,6120
47065,TN,Hamilton,,2019,3.2,179605,185626,6021
47065,TN,Hamilton,,2020,7,170177,183042,12865
47065,TN,Hamilton,,2021,4,176741,184161,7420
47067,TN,Hancock,,2007,5.6,2312,2449,137
47067,TN,Hancock,,2008,8.2,2356,2566,210
47067,TN,Hancock,,2009,14.4,2263,2643,380
47067,TN,Hancock,,2010,16.1,2165,2580,415
47067,TN,Hancock,,2011,14.1,2084,2425,341
47067,TN,Hancock,,2012,12,1985,2255,270
47067,TN,Hancock,,2013,11.8,1899,2153,254
47067,TN,Hancock,,2014,9.8,1870,2074,204
47067,TN,Hancock,,2015,9.6,1869,2068,199
47067,TN,Hancock,,2016,8,1873,2035,162
47067,TN,Hancock,,2017,5.8,1928,2047,119
47067,TN,Hancock,,2018,4.8,2025,2128,103
47067,TN,Hancock,,2019,5.9,2007,2132,125
47067,TN,Hancock,,2020,8.2,2016,2195,179
47067,TN,Hancock,,2021,4.8,2144,2253,109
47069,TN,Hardeman,,2007,6.5,10818,11567,749
47069,TN,Hardeman,,2008,8.5,10615,11599,984
47069,TN,Hardeman,,2009,12.3,9864,11247,1383
47069,TN,Hardeman,,2010,13.4,8972,10366,1394
47069,TN,Hardeman,,2011,12.3,8910,10156,1246
47069,TN,Hardeman,,2012,11.1,8883,9989,1106
47069,TN,Hardeman,,2013,11.1,8728,9814,1086
47069,TN,Hardeman,,2014,9.3,8702,9597,895
47069,TN,Hardeman,,2015,7.5,8613,9307,694
47069,TN,Hardeman,,2016,6.2,8633,9201,568
47069,TN,Hardeman,,2017,5.2,8742,9222,480
47069,TN,Hardeman,,2018,4.9,8926,9385,459
47069,TN,Hardeman,,2019,5,9041,9516,475
47069,TN,Hardeman,,2020,7.9,8556,9286,730
47069,TN,Hardeman,,2021,6,8423,8964,541
47071,TN,Hardin,,2007,5.4,11289,11934,645
47071,TN,Hardin,,2008,7.5,11017,11913,896
47071,TN,Hardin,,2009,12.1,10353,11778,1425
47071,TN,Hardin,,2010,12.2,10043,11444,1401
47071,TN,Hardin,,2011,11.4,10126,11431,1305
47071,TN,Hardin,,2012,10.2,9999,11139,1140
47071,TN,Hardin,,2013,10.3,9879,11015,1136
47071,TN,Hardin,,2014,9,9547,10493,946
47071,TN,Hardin,,2015,7.1,9549,10282,733
47071,TN,Hardin,,2016,6,9599,10211,612
47071,TN,Hardin,,2017,4.7,9914,10406,492
47071,TN,Hardin,,2018,4.4,9899,10352,453
47071,TN,Hardin,,2019,4.3,9955,10399,444
47071,TN,Hardin,,2020,6.9,9553,10260,707
47071,TN,Hardin,,2021,4.5,9735,10193,458
47073,TN,Hawkins,,2007,4.6,25037,26231,1194
47073,TN,Hawkins,,2008,6.6,25245,27033,1788
47073,TN,Hawkins,,2009,10.9,24315,27296,2981
47073,TN,Hawkins,,2010,11.1,22757,25587,2830
47073,TN,Hawkins,,2011,10.1,23098,25685,2587
47073,TN,Hawkins,,2012,9,22816,25064,2248
47073,TN,Hawkins,,2013,8.7,22593,24758,2165
47073,TN,Hawkins,,2014,7.4,22158,23916,1758
47073,TN,Hawkins,,2015,6.3,22085,23580,1495
47073,TN,Hawkins,,2016,5.4,22439,23723,1284
47073,TN,Hawkins,,2017,4.3,22678,23691,1013
47073,TN,Hawkins,,2018,4,22846,23793,947
47073,TN,Hawkins,,2019,4.1,22989,23978,989
47073,TN,Hawkins,,2020,7.6,21605,23389,1784
47073,TN,Hawkins,,2021,4.4,22112,23137,1025
47075,TN,Haywood,,2007,6.9,9163,9843,680
47075,TN,Haywood,,2008,10.4,8517,9503,986
47075,TN,Haywood,,2009,15.5,7793,9221,1428
47075,TN,Haywood,,2010,15.9,7554,8978,1424
47075,TN,Haywood,,2011,14,7298,8489,1191
47075,TN,Haywood,,2012,11.7,7258,8223,965
47075,TN,Haywood,,2013,11.8,7172,8127,955
47075,TN,Haywood,,2014,9.9,7009,7776,767
47075,TN,Haywood,,2015,8.3,7009,7644,635
47075,TN,Haywood,,2016,6.5,7181,7681,500
47075,TN,Haywood,,2017,5.2,7396,7803,407
47075,TN,Haywood,,2018,5.3,7332,7743,411
47075,TN,Haywood,,2019,4.8,7364,7738,374
47075,TN,Haywood,,2020,8.6,7107,7775,668
47075,TN,Haywood,,2021,5.9,7175,7624,449
47077,TN,Henderson,,2007,6.4,11310,12084,774
47077,TN,Henderson,,2008,10.1,10887,12109,1222
47077,TN,Henderson,,2009,17.6,9847,11947,2100
47077,TN,Henderson,,2010,14.5,11133,13018,1885
47077,TN,Henderson,,2011,11.3,12022,13555,1533
47077,TN,Henderson,,2012,9.8,11895,13192,1297
47077,TN,Henderson,,2013,10.5,11381,12710,1329
47077,TN,Henderson,,2014,8.7,11176,12236,1060
47077,TN,Henderson,,2015,7.9,11324,12297,973
47077,TN,Henderson,,2016,6.9,11172,11995,823
47077,TN,Henderson,,2017,5.2,11288,11901,613
47077,TN,Henderson,,2018,4.7,11458,12022,564
47077,TN,Henderson,,2019,4.4,11708,12247,539
47077,TN,Henderson,,2020,8,10939,11889,950
47077,TN,Henderson,,2021,4.4,11356,11873,517
47079,TN,Henry,,2007,6.2,13210,14076,866
47079,TN,Henry,,2008,8.6,12747,13947,1200
47079,TN,Henry,,2009,13,11810,13568,1758
47079,TN,Henry,,2010,11.6,12806,14483,1677
47079,TN,Henry,,2011,11,12833,14417,1584
47079,TN,Henry,,2012,9.6,12913,14280,1367
47079,TN,Henry,,2013,9.4,12995,14349,1354
47079,TN,Henry,,2014,8.1,12824,13953,1129
47079,TN,Henry,,2015,6.5,13002,13904,902
47079,TN,Henry,,2016,5.9,13109,13932,823
47079,TN,Henry,,2017,4.5,13352,13988,636
47079,TN,Henry,,2018,4.2,13658,14255,597
47079,TN,Henry,,2019,4.2,13622,14215,593
47079,TN,Henry,,2020,7,13146,14139,993
47079,TN,Henry,,2021,4,13585,14147,562
47081,TN,Hickman,,2007,5.4,9500,10039,539
47081,TN,Hickman,,2008,8.3,9317,10160,843
47081,TN,Hickman,,2009,12.6,8752,10014,1262
47081,TN,Hickman,,2010,11.3,9747,10993,1246
47081,TN,Hickman,,2011,10.4,9738,10869,1131
47081,TN,Hickman,,2012,9,9679,10640,961
47081,TN,Hickman,,2013,8.3,9653,10523,870
47081,TN,Hickman,,2014,6.6,9667,10353,686
47081,TN,Hickman,,2015,5.6,9756,10340,584
47081,TN,Hickman,,2016,4.6,9957,10442,485
47081,TN,Hickman,,2017,3.4,10476,10849,373
47081,TN,Hickman,,2018,3.2,10816,11178,362
47081,TN,Hickman,,2019,3.1,11108,11461,353
47081,TN,Hickman,,2020,5.8,10458,11100,642
47081,TN,Hickman,,2021,3.5,11047,11445,398
47083,TN,Houston,,2007,5.4,3681,3890,209
47083,TN,Houston,,2008,8,3561,3871,310
47083,TN,Houston,,2009,11.7,3437,3894,457
47083,TN,Houston,,2010,12.2,3109,3540,431
47083,TN,Houston,,2011,11.3,3157,3560,403
47083,TN,Houston,,2012,11.4,3116,3515,399
47083,TN,Houston,,2013,10.9,3008,3377,369
47083,TN,Houston,,2014,9.9,2977,3305,328
47083,TN,Houston,,2015,8.6,2929,3203,274
47083,TN,Houston,,2016,7.5,2959,3200,241
47083,TN,Houston,,2017,5.8,3017,3204,187
47083,TN,Houston,,2018,5.5,3067,3244,177
47083,TN,Houston,,2019,4.6,3136,3286,150
47083,TN,Houston,,2020,7.7,2995,3246,251
47083,TN,Houston,,2021,4.8,3053,3208,155
47085,TN,Humphreys,,2007,5.5,8622,9122,500
47085,TN,Humphreys,,2008,8.3,8284,9037,753
47085,TN,Humphreys,,2009,12.4,7857,8965,1108
47085,TN,Humphreys,,2010,11.4,7881,8892,1011
47085,TN,Humphreys,,2011,10.6,7892,8830,938
47085,TN,Humphreys,,2012,9.7,7815,8651,836
47085,TN,Humphreys,,2013,8.8,7915,8676,761
47085,TN,Humphreys,,2014,7.8,7745,8404,659
47085,TN,Humphreys,,2015,6.7,7916,8485,569
47085,TN,Humphreys,,2016,6,8126,8647,521
47085,TN,Humphreys,,2017,4.3,8417,8799,382
47085,TN,Humphreys,,2018,4.3,8470,8848,378
47085,TN,Humphreys,,2019,3.8,8641,8984,343
47085,TN,Humphreys,,2020,6.1,8160,8692,532
47085,TN,Humphreys,,2021,3.9,8316,8650,334
47087,TN,Jackson,,2007,6.8,4621,4957,336
47087,TN,Jackson,,2008,8.5,4564,4988,424
47087,TN,Jackson,,2009,13.3,4308,4967,659
47087,TN,Jackson,,2010,12.8,4180,4795,615
47087,TN,Jackson,,2011,11.9,4177,4739,562
47087,TN,Jackson,,2012,10.6,4096,4583,487
47087,TN,Jackson,,2013,10.3,4115,4586,471
47087,TN,Jackson,,2014,8.8,4086,4481,395
47087,TN,Jackson,,2015,7.8,4124,4472,348
47087,TN,Jackson,,2016,7,4180,4495,315
47087,TN,Jackson,,2017,5.4,4355,4602,247
47087,TN,Jackson,,2018,4.7,4391,4607,216
47087,TN,Jackson,,2019,4.6,4469,4685,216
47087,TN,Jackson,,2020,7.9,4345,4716,371
47087,TN,Jackson,,2021,4.3,4566,4773,207
47089,TN,Jefferson,,2007,5.1,23111,24344,1233
47089,TN,Jefferson,,2008,7,22936,24665,1729
47089,TN,Jefferson,,2009,12.2,21167,24118,2951
47089,TN,Jefferson,,2010,11.7,21589,24442,2853
47089,TN,Jefferson,,2011,10.6,21678,24259,2581
47089,TN,Jefferson,,2012,9.5,21689,23972,2283
47089,TN,Jefferson,,2013,9,21271,23382,2111
47089,TN,Jefferson,,2014,7.4,21374,23091,1717
47089,TN,Jefferson,,2015,6.3,21860,23342,1482
47089,TN,Jefferson,,2016,5.3,22377,23629,1252
47089,TN,Jefferson,,2017,4,22954,23922,968
47089,TN,Jefferson,,2018,3.8,23229,24142,913
47089,TN,Jefferson,,2019,3.7,23852,24771,919
47089,TN,Jefferson,,2020,7.5,23080,24946,1866
47089,TN,Jefferson,,2021,4.1,23796,24817,1021
47091,TN,Johnson,,2007,5.6,6956,7365,409
47091,TN,Johnson,,2008,8.5,6668,7290,622
47091,TN,Johnson,,2009,12.5,6483,7406,923
47091,TN,Johnson,,2010,13,6484,7456,972
47091,TN,Johnson,,2011,11.7,6634,7513,879
47091,TN,Johnson,,2012,9.6,6639,7345,706
47091,TN,Johnson,,2013,9,6696,7357,661
47091,TN,Johnson,,2014,6.9,6660,7152,492
47091,TN,Johnson,,2015,5.6,6915,7324,409
47091,TN,Johnson,,2016,4.8,7182,7546,364
47091,TN,Johnson,,2017,3.9,7303,7602,299
47091,TN,Johnson,,2018,3.5,7322,7585,263
47091,TN,Johnson,,2019,3.5,7484,7754,270
47091,TN,Johnson,,2020,6.2,7202,7682,480
47091,TN,Johnson,,2021,3.5,7488,7761,273
47093,TN,Knox,,2007,3.4,220566,228294,7728
47093,TN,Knox,,2008,4.9,219362,230698,11336
47093,TN,Knox,,2009,7.8,211089,229032,17943
47093,TN,Knox,,2010,7.6,212529,229895,17366
47093,TN,Knox,,2011,7,216377,232694,16317
47093,TN,Knox,,2012,6.2,216171,230548,14377
47093,TN,Knox,,2013,6.3,213611,227983,14372
47093,TN,Knox,,2014,5.5,213912,226266,12354
47093,TN,Knox,,2015,4.6,218294,228904,10610
47093,TN,Knox,,2016,4,224458,233831,9373
47093,TN,Knox,,2017,3.2,230101,237653,7552
47093,TN,Knox,,2018,2.9,233982,241067,7085
47093,TN,Knox,,2019,2.9,239072,246230,7158
47093,TN,Knox,,2020,5.8,229028,243232,14204
47093,TN,Knox,,2021,3.3,239274,247312,8038
47095,TN,Lake,,2007,5.8,2546,2703,157
47095,TN,Lake,,2008,7.5,2476,2678,202
47095,TN,Lake,,2009,10.7,2361,2644,283
47095,TN,Lake,,2010,11.3,1932,2177,245
47095,TN,Lake,,2011,12.2,1926,2194,268
47095,TN,Lake,,2012,10.6,1972,2206,234
47095,TN,Lake,,2013,10.1,1968,2188,220
47095,TN,Lake,,2014,9.3,1912,2107,195
47095,TN,Lake,,2015,8.5,1807,1974,167
47095,TN,Lake,,2016,7.8,1767,1917,150
47095,TN,Lake,,2017,5.6,1739,1842,103
47095,TN,Lake,,2018,5.1,1714,1806,92
47095,TN,Lake,,2019,5.5,1639,1734,95
47095,TN,Lake,,2020,8,1544,1679,135
47095,TN,Lake,,2021,6,1560,1659,99
47097,TN,Lauderdale,,2007,6.5,9727,10407,680
47097,TN,Lauderdale,,2008,12.3,9095,10366,1271
47097,TN,Lauderdale,,2009,18.3,8433,10316,1883
47097,TN,Lauderdale,,2010,14.4,9241,10800,1559
47097,TN,Lauderdale,,2011,12.6,9287,10627,1340
47097,TN,Lauderdale,,2012,11.1,9349,10515,1166
47097,TN,Lauderdale,,2013,11.6,9065,10260,1195
47097,TN,Lauderdale,,2014,9.8,8877,9846,969
47097,TN,Lauderdale,,2015,8.8,8769,9613,844
47097,TN,Lauderdale,,2016,7.8,8710,9442,732
47097,TN,Lauderdale,,2017,5.8,8865,9409,544
47097,TN,Lauderdale,,2018,5.8,9127,9688,561
47097,TN,Lauderdale,,2019,5.4,9225,9753,528
47097,TN,Lauderdale,,2020,8.7,8847,9690,843
47097,TN,Lauderdale,,2021,6,9047,9621,574
47099,TN,Lawrence,,2007,8,15302,16640,1338
47099,TN,Lawrence,,2008,9.7,15041,16649,1608
47099,TN,Lawrence,,2009,15,14227,16730,2503
47099,TN,Lawrence,,2010,12.5,16944,19366,2422
47099,TN,Lawrence,,2011,10.6,17176,19210,2034
47099,TN,Lawrence,,2012,9.7,16878,18690,1812
47099,TN,Lawrence,,2013,9.8,16381,18166,1785
47099,TN,Lawrence,,2014,8.2,16235,17678,1443
47099,TN,Lawrence,,2015,6.5,16593,17756,1163
47099,TN,Lawrence,,2016,5.8,16776,17806,1030
47099,TN,Lawrence,,2017,4.4,17019,17802,783
47099,TN,Lawrence,,2018,4,17749,18494,745
47099,TN,Lawrence,,2019,4.1,18462,19255,793
47099,TN,Lawrence,,2020,7.7,17774,19255,1481
47099,TN,Lawrence,,2021,4.3,18549,19378,829
47101,TN,Lewis,,2007,7.2,5013,5403,390
47101,TN,Lewis,,2008,9.9,4928,5470,542
47101,TN,Lewis,,2009,15.2,4686,5529,843
47101,TN,Lewis,,2010,15.3,4591,5418,827
47101,TN,Lewis,,2011,13.1,4557,5244,687
47101,TN,Lewis,,2012,11,4488,5042,554
47101,TN,Lewis,,2013,10.6,4478,5007,529
47101,TN,Lewis,,2014,9,4428,4866,438
47101,TN,Lewis,,2015,7.2,4465,4814,349
47101,TN,Lewis,,2016,6,4599,4890,291
47101,TN,Lewis,,2017,4.6,4723,4949,226
47101,TN,Lewis,,2018,4.4,4850,5075,225
47101,TN,Lewis,,2019,4.1,5010,5222,212
47101,TN,Lewis,,2020,7.5,4944,5343,399
47101,TN,Lewis,,2021,4.7,5294,5555,261
47103,TN,Lincoln,,2007,3.5,16798,17413,615
47103,TN,Lincoln,,2008,4.9,16414,17252,838
47103,TN,Lincoln,,2009,7,15821,17003,1182
47103,TN,Lincoln,,2010,7.3,14566,15710,1144
47103,TN,Lincoln,,2011,6.8,14663,15727,1064
47103,TN,Lincoln,,2012,6.2,14602,15569,967
47103,TN,Lincoln,,2013,6.2,14637,15609,972
47103,TN,Lincoln,,2014,5.4,14545,15370,825
47103,TN,Lincoln,,2015,4.8,14450,15174,724
47103,TN,Lincoln,,2016,4.1,15318,15974,656
47103,TN,Lincoln,,2017,3.3,15771,16303,532
47103,TN,Lincoln,,2018,3.1,16211,16721,510
47103,TN,Lincoln,,2019,3.6,16247,16856,609
47103,TN,Lincoln,,2020,8.4,14633,15974,1341
47103,TN,Lincoln,,2021,4.1,15500,16155,655
47105,TN,Loudon,,2007,3.9,22254,23146,892
47105,TN,Loudon,,2008,5.6,22295,23612,1317
47105,TN,Loudon,,2009,9.4,21300,23505,2205
47105,TN,Loudon,,2010,9.4,20259,22372,2113
47105,TN,Loudon,,2011,8.8,20551,22541,1990
47105,TN,Loudon,,2012,7.7,20587,22306,1719
47105,TN,Loudon,,2013,7.7,20442,22159,1717
47105,TN,Loudon,,2014,6.7,20378,21840,1462
47105,TN,Loudon,,2015,5.6,20760,21981,1221
47105,TN,Loudon,,2016,4.7,21250,22295,1045
47105,TN,Loudon,,2017,3.7,21827,22663,836
47105,TN,Loudon,,2018,3.4,22389,23174,785
47105,TN,Loudon,,2019,3.4,23083,23893,810
47105,TN,Loudon,,2020,6.2,22242,23711,1469
47105,TN,Loudon,,2021,3.4,23152,23966,814
47107,TN,McMinn,,2007,5.5,23381,24737,1356
47107,TN,McMinn,,2008,8.6,21998,24072,2074
47107,TN,McMinn,,2009,13.6,20193,23362,3169
47107,TN,McMinn,,2010,12.7,19957,22871,2914
47107,TN,McMinn,,2011,11.3,20409,23017,2608
47107,TN,McMinn,,2012,9.3,21400,23595,2195
47107,TN,McMinn,,2013,9,20860,22928,2068
47107,TN,McMinn,,2014,7.6,20740,22437,1697
47107,TN,McMinn,,2015,6.3,21269,22694,1425
47107,TN,McMinn,,2016,5.4,21535,22776,1241
47107,TN,McMinn,,2017,4.4,21694,22688,994
47107,TN,McMinn,,2018,4.1,21831,22762,931
47107,TN,McMinn,,2019,3.8,22747,23645,898
47107,TN,McMinn,,2020,7.8,21510,23319,1809
47107,TN,McMinn,,2021,4.5,21517,22540,1023
47109,TN,McNairy,,2007,5.9,11602,12335,733
47109,TN,McNairy,,2008,9,10507,11540,1033
47109,TN,McNairy,,2009,13.6,9498,10988,1490
47109,TN,McNairy,,2010,13.1,9140,10513,1373
47109,TN,McNairy,,2011,11.5,9189,10381,1192
47109,TN,McNairy,,2012,10.4,8740,9758,1018
47109,TN,McNairy,,2013,11.7,8267,9360,1093
47109,TN,McNairy,,2014,10.6,8013,8968,955
47109,TN,McNairy,,2015,8.4,8036,8776,740
47109,TN,McNairy,,2016,7,8154,8772,618
47109,TN,McNairy,,2017,5.6,8067,8550,483
47109,TN,McNairy,,2018,5.5,7847,8302,455
47109,TN,McNairy,,2019,5.3,8034,8484,450
47109,TN,McNairy,,2020,8.3,7660,8355,695
47109,TN,McNairy,,2021,5.3,7890,8335,445
47111,TN,Macon,,2007,5.9,9876,10499,623
47111,TN,Macon,,2008,8.2,9780,10656,876
47111,TN,Macon,,2009,11.9,9294,10549,1255
47111,TN,Macon,,2010,11.4,9085,10256,1171
47111,TN,Macon,,2011,10.4,9240,10316,1076
47111,TN,Macon,,2012,8.5,9272,10129,857
47111,TN,Macon,,2013,8.2,9271,10094,823
47111,TN,Macon,,2014,6.5,9328,9981,653
47111,TN,Macon,,2015,5.3,9458,9983,525
47111,TN,Macon,,2016,4.4,9795,10243,448
47111,TN,Macon,,2017,3.4,10351,10719,368
47111,TN,Macon,,2018,3.2,10649,11001,352
47111,TN,Macon,,2019,3.1,11049,11404,355
47111,TN,Macon,,2020,6.5,10440,11162,722
47111,TN,Macon,,2021,3.7,10934,11349,415
47113,TN,Madison,,2007,4.9,46312,48695,2383
47113,TN,Madison,,2008,6.6,45529,48769,3240
47113,TN,Madison,,2009,10.3,43104,48058,4954
47113,TN,Madison,,2010,10.2,43316,48244,4928
47113,TN,Madison,,2011,9.5,44320,48949,4629
47113,TN,Madison,,2012,8.3,44456,48464,4008
47113,TN,Madison,,2013,8,43839,47671,3832
47113,TN,Madison,,2014,6.8,43431,46598,3167
47113,TN,Madison,,2015,5.8,43904,46629,2725
47113,TN,Madison,,2016,4.9,45493,47829,2336
47113,TN,Madison,,2017,3.9,46233,48128,1895
47113,TN,Madison,,2018,3.8,46925,48762,1837
47113,TN,Madison,,2019,3.6,47770,49529,1759
47113,TN,Madison,,2020,7.4,45711,49371,3660
47113,TN,Madison,,2021,4.5,47131,49358,2227
47115,TN,Marion,,2007,5.9,12300,13065,765
47115,TN,Marion,,2008,7.6,12075,13062,987
47115,TN,Marion,,2009,11.9,11111,12616,1505
47115,TN,Marion,,2010,11.3,11133,12556,1423
47115,TN,Marion,,2011,10.6,11160,12487,1327
47115,TN,Marion,,2012,9.3,11130,12266,1136
47115,TN,Marion,,2013,9.1,10945,12039,1094
47115,TN,Marion,,2014,7.9,10737,11661,924
47115,TN,Marion,,2015,6.7,10950,11737,787
47115,TN,Marion,,2016,6.3,11176,11929,753
47115,TN,Marion,,2017,4.9,11466,12053,587
47115,TN,Marion,,2018,4.7,11769,12345,576
47115,TN,Marion,,2019,4.3,12095,12636,541
47115,TN,Marion,,2020,7.5,11352,12271,919
47115,TN,Marion,,2021,4.3,11797,12328,531
47117,TN,Marshall,,2007,7.5,12010,12978,968
47117,TN,Marshall,,2008,9.1,11462,12611,1149
47117,TN,Marshall,,2009,16.9,10302,12396,2094
47117,TN,Marshall,,2010,14.2,12369,14424,2055
47117,TN,Marshall,,2011,11.6,12729,14399,1670
47117,TN,Marshall,,2012,9.5,12922,14285,1363
47117,TN,Marshall,,2013,8.1,13202,14371,1169
47117,TN,Marshall,,2014,6.3,13572,14482,910
47117,TN,Marshall,,2015,5.5,13974,14795,821
47117,TN,Marshall,,2016,4.6,14385,15083,698
47117,TN,Marshall,,2017,3.5,14577,15105,528
47117,TN,Marshall,,2018,3.5,14945,15481,536
47117,TN,Marshall,,2019,3.6,15254,15816,562
47117,TN,Marshall,,2020,9.1,14074,15479,1405
47117,TN,Marshall,,2021,4.5,14798,15495,697
47119,TN,Maury,,2007,7.7,33822,36660,2838
47119,TN,Maury,,2008,8,34627,37639,3012
47119,TN,Maury,,2009,13.3,32130,37080,4950
47119,TN,Maury,,2010,12.5,36334,41524,5190
47119,TN,Maury,,2011,10.4,36932,41219,4287
47119,TN,Maury,,2012,8,37379,40617,3238
47119,TN,Maury,,2013,7.1,38029,40928,2899
47119,TN,Maury,,2014,6,38749,41206,2457
47119,TN,Maury,,2015,5.1,40289,42448,2159
47119,TN,Maury,,2016,4.1,42327,44115,1788
47119,TN,Maury,,2017,3.2,44566,46062,1496
47119,TN,Maury,,2018,3.2,46719,48274,1555
47119,TN,Maury,,2019,3.2,48796,50401,1605
47119,TN,Maury,,2020,8,46981,51074,4093
47119,TN,Maury,,2021,4.7,49615,52080,2465
47121,TN,Meigs,,2007,6.2,4593,4896,303
47121,TN,Meigs,,2008,8.7,4540,4975,435
47121,TN,Meigs,,2009,14.1,4374,5094,720
47121,TN,Meigs,,2010,13.3,4316,4979,663
47121,TN,Meigs,,2011,12.1,4371,4974,603
47121,TN,Meigs,,2012,10.5,4529,5058,529
47121,TN,Meigs,,2013,10.2,4532,5047,515
47121,TN,Meigs,,2014,8.7,4457,4883,426
47121,TN,Meigs,,2015,7.6,4498,4866,368
47121,TN,Meigs,,2016,6.9,4565,4901,336
47121,TN,Meigs,,2017,5.2,4741,5003,262
47121,TN,Meigs,,2018,4.6,4842,5074,232
47121,TN,Meigs,,2019,4.5,4974,5210,236
47121,TN,Meigs,,2020,8.6,4745,5193,448
47121,TN,Meigs,,2021,4.9,4911,5162,251
47123,TN,Monroe,,2007,5.8,18364,19496,1132
47123,TN,Monroe,,2008,9.8,17128,18987,1859
47123,TN,Monroe,,2009,17,15436,18594,3158
47123,TN,Monroe,,2010,12.9,16996,19520,2524
47123,TN,Monroe,,2011,11.6,17276,19549,2273
47123,TN,Monroe,,2012,10.1,17489,19458,1969
47123,TN,Monroe,,2013,9.7,17423,19305,1882
47123,TN,Monroe,,2014,7.6,17616,19072,1456
47123,TN,Monroe,,2015,6.2,17895,19085,1190
47123,TN,Monroe,,2016,5.3,18388,19417,1029
47123,TN,Monroe,,2017,4,18877,19668,791
47123,TN,Monroe,,2018,3.7,19275,20014,739
47123,TN,Monroe,,2019,3.6,19619,20361,742
47123,TN,Monroe,,2020,8,18549,20157,1608
47123,TN,Monroe,,2021,3.8,19850,20635,785
47125,TN,Montgomery,,2007,4.7,65228,68424,3196
47125,TN,Montgomery,,2008,6.2,63923,68150,4227
47125,TN,Montgomery,,2009,8.6,62978,68912,5934
47125,TN,Montgomery,,2010,8.7,69106,75676,6570
47125,TN,Montgomery,,2011,8.7,70384,77069,6685
47125,TN,Montgomery,,2012,7.7,71919,77933,6014
47125,TN,Montgomery,,2013,7.5,71766,77615,5849
47125,TN,Montgomery,,2014,6.7,72207,77370,5163
47125,TN,Montgomery,,2015,5.8,74205,78752,4547
47125,TN,Montgomery,,2016,5.1,75931,80018,4087
47125,TN,Montgomery,,2017,4.1,78699,82061,3362
47125,TN,Montgomery,,2018,3.9,80928,84169,3241
47125,TN,Montgomery,,2019,3.8,83519,86807,3288
47125,TN,Montgomery,,2020,7.5,80428,86946,6518
47125,TN,Montgomery,,2021,4.5,83799,87746,3947
47127,TN,Moore,,2007,4.1,3045,3175,130
47127,TN,Moore,,2008,5.5,2998,3172,174
47127,TN,Moore,,2009,9.2,2753,3032,279
47127,TN,Moore,,2010,8,2996,3258,262
47127,TN,Moore,,2011,7,3098,3330,232
47127,TN,Moore,,2012,5.9,3189,3389,200
47127,TN,Moore,,2013,6,3136,3336,200
47127,TN,Moore,,2014,5.1,3127,3295,168
47127,TN,Moore,,2015,4.5,3164,3312,148
47127,TN,Moore,,2016,3.8,3259,3387,128
47127,TN,Moore,,2017,3.1,3374,3483,109
47127,TN,Moore,,2018,3.1,3398,3505,107
47127,TN,Moore,,2019,2.9,3528,3634,106
47127,TN,Moore,,2020,5.3,3421,3613,192
47127,TN,Moore,,2021,2.6,3483,3577,94
47129,TN,Morgan,,2007,5.7,7952,8436,484
47129,TN,Morgan,,2008,7.5,7938,8582,644
47129,TN,Morgan,,2009,11,7790,8751,961
47129,TN,Morgan,,2010,11.6,7440,8413,973
47129,TN,Morgan,,2011,11,7530,8457,927
47129,TN,Morgan,,2012,10.4,7451,8317,866
47129,TN,Morgan,,2013,10.2,7259,8080,821
47129,TN,Morgan,,2014,8.8,7113,7803,690
47129,TN,Morgan,,2015,7.4,7159,7732,573
47129,TN,Morgan,,2016,6.5,7304,7809,505
47129,TN,Morgan,,2017,4.9,7427,7810,383
47129,TN,Morgan,,2018,4.5,7466,7817,351
47129,TN,Morgan,,2019,4.1,7488,7809,321
47129,TN,Morgan,,2020,6.3,7106,7583,477
47129,TN,Morgan,,2021,4.3,7397,7731,334
47131,TN,Obion,,2007,5.5,14772,15632,860
47131,TN,Obion,,2008,6.9,14549,15631,1082
47131,TN,Obion,,2009,10,13596,15101,1505
47131,TN,Obion,,2010,9.8,14036,15561,1525
47131,TN,Obion,,2011,12.3,13381,15262,1881
47131,TN,Obion,,2012,13.6,12386,14343,1957
47131,TN,Obion,,2013,11.6,12121,13706,1585
47131,TN,Obion,,2014,9.6,11625,12858,1233
47131,TN,Obion,,2015,8.6,11430,12499,1069
47131,TN,Obion,,2016,7.1,11691,12580,889
47131,TN,Obion,,2017,5.5,11555,12227,672
47131,TN,Obion,,2018,4.9,11685,12292,607
47131,TN,Obion,,2019,4.9,11903,12514,611
47131,TN,Obion,,2020,6.7,11351,12168,817
47131,TN,Obion,,2021,4.7,11710,12285,575
47133,TN,Overton,,2007,7.2,9395,10119,724
47133,TN,Overton,,2008,8.9,9233,10130,897
47133,TN,Overton,,2009,12.9,8727,10025,1298
47133,TN,Overton,,2010,10.9,9141,10255,1114
47133,TN,Overton,,2011,10.4,8956,9993,1037
47133,TN,Overton,,2012,9.1,8844,9726,882
47133,TN,Overton,,2013,9,8671,9526,855
47133,TN,Overton,,2014,7.9,8418,9142,724
47133,TN,Overton,,2015,7.1,8463,9107,644
47133,TN,Overton,,2016,5.4,8727,9222,495
47133,TN,Overton,,2017,4.1,9140,9535,395
47133,TN,Overton,,2018,3.8,9444,9813,369
47133,TN,Overton,,2019,3.8,9595,9974,379
47133,TN,Overton,,2020,6.3,9129,9740,611
47133,TN,Overton,,2021,3.6,9594,9950,356
47135,TN,Perry,,2007,7.6,2897,3134,237
47135,TN,Perry,,2008,15.8,2510,2982,472
47135,TN,Perry,,2009,22.3,2172,2797,625
47135,TN,Perry,,2010,13.7,2735,3169,434
47135,TN,Perry,,2011,11.8,2665,3023,358
47135,TN,Perry,,2012,9.9,2802,3111,309
47135,TN,Perry,,2013,9.3,2832,3124,292
47135,TN,Perry,,2014,8.1,2805,3053,248
47135,TN,Perry,,2015,6.7,2917,3126,209
47135,TN,Perry,,2016,6.4,2989,3192,203
47135,TN,Perry,,2017,4.8,3084,3240,156
47135,TN,Perry,,2018,4.3,3116,3255,139
47135,TN,Perry,,2019,5,2969,3126,157
47135,TN,Perry,,2020,9.6,2679,2962,283
47135,TN,Perry,,2021,7.2,2682,2889,207
47137,TN,Pickett,,2007,8.1,1769,1924,155
47137,TN,Pickett,,2008,10.6,1695,1896,201
47137,TN,Pickett,,2009,14.6,1543,1806,263
47137,TN,Pickett,,2010,11.3,2137,2410,273
47137,TN,Pickett,,2011,11.4,2150,2428,278
47137,TN,Pickett,,2012,9.5,2211,2444,233
47137,TN,Pickett,,2013,9.5,2106,2327,221
47137,TN,Pickett,,2014,8.9,2081,2285,204
47137,TN,Pickett,,2015,7.6,2222,2405,183
47137,TN,Pickett,,2016,6.7,2173,2328,155
47137,TN,Pickett,,2017,4.4,2342,2450,108
47137,TN,Pickett,,2018,3.8,2348,2442,94
47137,TN,Pickett,,2019,4.7,2243,2353,110
47137,TN,Pickett,,2020,6,2103,2237,134
47137,TN,Pickett,,2021,3.8,2116,2200,84
47139,TN,Polk,,2007,5,6747,7101,354
47139,TN,Polk,,2008,7.9,6491,7051,560
47139,TN,Polk,,2009,12.2,6169,7027,858
47139,TN,Polk,,2010,11.4,6507,7344,837
47139,TN,Polk,,2011,11.3,6573,7411,838
47139,TN,Polk,,2012,10,6733,7479,746
47139,TN,Polk,,2013,9.2,6867,7560,693
47139,TN,Polk,,2014,7.9,6827,7414,587
47139,TN,Polk,,2015,6.5,6862,7341,479
47139,TN,Polk,,2016,5.7,6970,7394,424
47139,TN,Polk,,2017,4.5,7061,7397,336
47139,TN,Polk,,2018,4.2,7006,7313,307
47139,TN,Polk,,2019,4,7169,7469,300
47139,TN,Polk,,2020,6.8,6883,7384,501
47139,TN,Polk,,2021,4.1,6826,7119,293
47141,TN,Putnam,,2007,4.5,33830,35422,1592
47141,TN,Putnam,,2008,6.4,33837,36135,2298
47141,TN,Putnam,,2009,9.4,32424,35788,3364
47141,TN,Putnam,,2010,9.6,30785,34037,3252
47141,TN,Putnam,,2011,9,31202,34301,3099
47141,TN,Putnam,,2012,8.2,30192,32879,2687
47141,TN,Putnam,,2013,8,29982,32583,2601
47141,TN,Putnam,,2014,6.9,29904,32122,2218
47141,TN,Putnam,,2015,5.8,30633,32517,1884
47141,TN,Putnam,,2016,4.9,31644,33282,1638
47141,TN,Putnam,,2017,3.8,32725,34023,1298
47141,TN,Putnam,,2018,3.6,33257,34489,1232
47141,TN,Putnam,,2019,3.5,34004,35243,1239
47141,TN,Putnam,,2020,6.4,32839,35093,2254
47141,TN,Putnam,,2021,3.7,34214,35527,1313
47143,TN,Rhea,,2007,5.8,12332,13085,753
47143,TN,Rhea,,2008,7.9,12409,13469,1060
47143,TN,Rhea,,2009,13.1,11611,13364,1753
47143,TN,Rhea,,2010,12.5,11879,13580,1701
47143,TN,Rhea,,2011,11.4,12245,13825,1580
47143,TN,Rhea,,2012,10.4,12085,13489,1404
47143,TN,Rhea,,2013,10.7,11972,13399,1427
47143,TN,Rhea,,2014,8.5,12176,13301,1125
47143,TN,Rhea,,2015,7.3,12155,13118,963
47143,TN,Rhea,,2016,7.1,12523,13485,962
47143,TN,Rhea,,2017,6.5,12384,13244,860
47143,TN,Rhea,,2018,5.6,12404,13142,738
47143,TN,Rhea,,2019,5.7,12635,13398,763
47143,TN,Rhea,,2020,9.6,11861,13115,1254
47143,TN,Rhea,,2021,4.8,12936,13588,652
47145,TN,Roane,,2007,4.4,25714,26889,1175
47145,TN,Roane,,2008,5.8,25711,27295,1584
47145,TN,Roane,,2009,8.8,24902,27315,2413
47145,TN,Roane,,2010,9.3,22065,24340,2275
47145,TN,Roane,,2011,9.2,22144,24391,2247
47145,TN,Roane,,2012,8.8,21772,23866,2094
47145,TN,Roane,,2013,9,21166,23260,2094
47145,TN,Roane,,2014,7.7,20879,22615,1736
47145,TN,Roane,,2015,6.4,21177,22628,1451
47145,TN,Roane,,2016,5.6,21599,22878,1279
47145,TN,Roane,,2017,4.4,21939,22953,1014
47145,TN,Roane,,2018,4.1,22174,23127,953
47145,TN,Roane,,2019,4.1,22521,23475,954
47145,TN,Roane,,2020,6.3,21521,22969,1448
47145,TN,Roane,,2021,4,22451,23377,926
47147,TN,Robertson,,2007,4.3,31455,32877,1422
47147,TN,Robertson,,2008,6.1,31516,33552,2036
47147,TN,Robertson,,2009,9.9,30419,33758,3339
47147,TN,Robertson,,2010,9.4,30620,33789,3169
47147,TN,Robertson,,2011,8.5,31137,34042,2905
47147,TN,Robertson,,2012,7.2,31281,33692,2411
47147,TN,Robertson,,2013,6.7,31425,33695,2270
47147,TN,Robertson,,2014,5.7,31648,33561,1913
47147,TN,Robertson,,2015,4.8,32250,33891,1641
47147,TN,Robertson,,2016,4.2,33328,34780,1452
47147,TN,Robertson,,2017,3.4,34776,36008,1232
47147,TN,Robertson,,2018,3.1,36000,37169,1169
47147,TN,Robertson,,2019,2.9,37230,38342,1112
47147,TN,Robertson,,2020,6.1,34951,37208,2257
47147,TN,Robertson,,2021,3.3,36806,38067,1261
47149,TN,Rutherford,,2007,3.7,124997,129770,4773
47149,TN,Rutherford,,2008,5.7,126171,133807,7636
47149,TN,Rutherford,,2009,9.3,122404,135027,12623
47149,TN,Rutherford,,2010,9,127659,140300,12641
47149,TN,Rutherford,,2011,8.1,132121,143716,11595
47149,TN,Rutherford,,2012,6.6,135335,144928,9593
47149,TN,Rutherford,,2013,6.2,138387,147539,9152
47149,TN,Rutherford,,2014,5.3,142096,149973,7877
47149,TN,Rutherford,,2015,4.4,148996,155929,6933
47149,TN,Rutherford,,2016,3.7,157663,163741,6078
47149,TN,Rutherford,,2017,2.9,166744,171748,5004
47149,TN,Rutherford,,2018,2.7,174943,179778,4835
47149,TN,Rutherford,,2019,2.6,182901,187745,4844
47149,TN,Rutherford,,2020,6.9,173859,186794,12935
47149,TN,Rutherford,,2021,3.4,183656,190190,6534
47151,TN,Scott,,2007,7,8105,8712,607
47151,TN,Scott,,2008,11.4,7573,8547,974
47151,TN,Scott,,2009,17.8,6936,8439,1503
47151,TN,Scott,,2010,17.3,7671,9275,1604
47151,TN,Scott,,2011,17.8,7508,9133,1625
47151,TN,Scott,,2012,15.8,7389,8773,1384
47151,TN,Scott,,2013,14.4,7369,8611,1242
47151,TN,Scott,,2014,11.7,7303,8272,969
47151,TN,Scott,,2015,9.2,7346,8094,748
47151,TN,Scott,,2016,7.4,7432,8028,596
47151,TN,Scott,,2017,5.1,7759,8176,417
47151,TN,Scott,,2018,4.4,7923,8290,367
47151,TN,Scott,,2019,4.4,8054,8423,369
47151,TN,Scott,,2020,8.4,7467,8149,682
47151,TN,Scott,,2021,5.1,7613,8020,407
47153,TN,Sequatchie,,2007,4.8,5849,6144,295
47153,TN,Sequatchie,,2008,7.5,5810,6280,470
47153,TN,Sequatchie,,2009,12,5514,6265,751
47153,TN,Sequatchie,,2010,12.3,5358,6108,750
47153,TN,Sequatchie,,2011,10.4,5449,6079,630
47153,TN,Sequatchie,,2012,8.5,5444,5952,508
47153,TN,Sequatchie,,2013,8.6,5421,5930,509
47153,TN,Sequatchie,,2014,7.5,5316,5746,430
47153,TN,Sequatchie,,2015,6.4,5432,5806,374
47153,TN,Sequatchie,,2016,5.9,5579,5926,347
47153,TN,Sequatchie,,2017,5,5666,5967,301
47153,TN,Sequatchie,,2018,4.3,5842,6105,263
47153,TN,Sequatchie,,2019,4.2,5996,6260,264
47153,TN,Sequatchie,,2020,7.7,5690,6166,476
47153,TN,Sequatchie,,2021,4.4,5916,6189,273
47155,TN,Sevier,,2007,4.9,45665,48027,2362
47155,TN,Sevier,,2008,7,45181,48557,3376
47155,TN,Sevier,,2009,10.5,43321,48404,5083
47155,TN,Sevier,,2010,10.6,43917,49116,5199
47155,TN,Sevier,,2011,10.2,44566,49602,5036
47155,TN,Sevier,,2012,8.9,45030,49440,4410
47155,TN,Sevier,,2013,8.4,45012,49151,4139
47155,TN,Sevier,,2014,7.2,45496,49012,3516
47155,TN,Sevier,,2015,6,46972,49958,2986
47155,TN,Sevier,,2016,5,48696,51239,2543
47155,TN,Sevier,,2017,4,50105,52208,2103
47155,TN,Sevier,,2018,3.5,51443,53293,1850
47155,TN,Sevier,,2019,3.3,53320,55129,1809
47155,TN,Sevier,,2020,9.7,48842,54099,5257
47155,TN,Sevier,,2021,3.9,52705,54854,2149
47157,TN,Shelby,,2007,5,421526,443787,22261
47157,TN,Shelby,,2008,6.8,410833,440899,30066
47157,TN,Shelby,,2009,9.8,392698,435361,42663
47157,TN,Shelby,,2010,9.9,404611,449117,44506
47157,TN,Shelby,,2011,9.7,406712,450228,43516
47157,TN,Shelby,,2012,8.8,406551,445583,39032
47157,TN,Shelby,,2013,8.8,401636,440270,38634
47157,TN,Shelby,,2014,7.6,397700,430546,32846
47157,TN,Shelby,,2015,6.4,403447,430892,27445
47157,TN,Shelby,,2016,5.4,411215,434502,23287
47157,TN,Shelby,,2017,4.4,418685,437734,19049
47157,TN,Shelby,,2018,4.2,424233,442606,18373
47157,TN,Shelby,,2019,4,431035,449046,18011
47157,TN,Shelby,,2020,9.5,404828,447173,42345
47157,TN,Shelby,,2021,6.8,416969,447442,30473
47159,TN,Smith,,2007,5.3,8604,9086,482
47159,TN,Smith,,2008,8,8530,9276,746
47159,TN,Smith,,2009,13.2,8064,9287,1223
47159,TN,Smith,,2010,12.5,7829,8945,1116
47159,TN,Smith,,2011,10.4,7922,8841,919
47159,TN,Smith,,2012,8.3,7940,8659,719
47159,TN,Smith,,2013,7.8,7880,8544,664
47159,TN,Smith,,2014,6.4,7827,8364,537
47159,TN,Smith,,2015,5.6,8031,8504,473
47159,TN,Smith,,2016,4.6,8288,8687,399
47159,TN,Smith,,2017,3.6,8604,8925,321
47159,TN,Smith,,2018,3,8945,9226,281
47159,TN,Smith,,2019,3,9245,9532,287
47159,TN,Smith,,2020,6,8683,9240,557
47159,TN,Smith,,2021,3.3,9156,9471,315
47161,TN,Stewart,,2007,6.1,5501,5856,355
47161,TN,Stewart,,2008,8.4,5438,5938,500
47161,TN,Stewart,,2009,11.5,5195,5873,678
47161,TN,Stewart,,2010,12.6,4961,5677,716
47161,TN,Stewart,,2011,12.6,4935,5646,711
47161,TN,Stewart,,2012,11.2,4917,5537,620
47161,TN,Stewart,,2013,10.9,4773,5357,584
47161,TN,Stewart,,2014,9.3,4754,5240,486
47161,TN,Stewart,,2015,7.6,4757,5149,392
47161,TN,Stewart,,2016,6.8,4819,5171,352
47161,TN,Stewart,,2017,5.4,4911,5190,279
47161,TN,Stewart,,2018,4.9,5046,5308,262
47161,TN,Stewart,,2019,4.5,5301,5549,248
47161,TN,Stewart,,2020,6.3,5070,5411,341
47161,TN,Stewart,,2021,4.1,5156,5377,221
47163,TN,Sullivan,,2007,3.9,70644,73546,2902
47163,TN,Sullivan,,2008,5.2,70881,74793,3912
47163,TN,Sullivan,,2009,8.5,68195,74546,6351
47163,TN,Sullivan,,2010,9.2,66902,73678,6776
47163,TN,Sullivan,,2011,8.4,68171,74441,6270
47163,TN,Sullivan,,2012,7.7,67252,72833,5581
47163,TN,Sullivan,,2013,7.6,66347,71779,5432
47163,TN,Sullivan,,2014,6.7,65343,70014,4671
47163,TN,Sullivan,,2015,5.7,65319,69296,3977
47163,TN,Sullivan,,2016,5.2,66193,69815,3622
47163,TN,Sullivan,,2017,4,67226,70056,2830
47163,TN,Sullivan,,2018,3.7,67894,70489,2595
47163,TN,Sullivan,,2019,3.7,68302,70928,2626
47163,TN,Sullivan,,2020,7.1,64374,69267,4893
47163,TN,Sullivan,,2021,4.2,65973,68879,2906
47165,TN,Sumner,,2007,4.1,75782,78991,3209
47165,TN,Sumner,,2008,5.9,75433,80148,4715
47165,TN,Sumner,,2009,9.5,72466,80084,7618
47165,TN,Sumner,,2010,9,75786,83281,7495
47165,TN,Sumner,,2011,8,77922,84684,6762
47165,TN,Sumner,,2012,6.6,79265,84887,5622
47165,TN,Sumner,,2013,6.2,80413,85694,5281
47165,TN,Sumner,,2014,5.3,82079,86652,4573
47165,TN,Sumner,,2015,4.6,84723,88780,4057
47165,TN,Sumner,,2016,3.9,88792,92394,3602
47165,TN,Sumner,,2017,3,93026,95897,2871
47165,TN,Sumner,,2018,2.8,97188,99967,2779
47165,TN,Sumner,,2019,2.7,101534,104341,2807
47165,TN,Sumner,,2020,6.5,96746,103421,6675
47165,TN,Sumner,,2021,3.3,102294,105810,3516
47167,TN,Tipton,,2007,5.1,26671,28106,1435
47167,TN,Tipton,,2008,7.8,26550,28786,2236
47167,TN,Tipton,,2009,12,25344,28806,3462
47167,TN,Tipton,,2010,11.5,25733,29087,3354
47167,TN,Tipton,,2011,10.5,25775,28790,3015
47167,TN,Tipton,,2012,9,25736,28284,2548
47167,TN,Tipton,,2013,9.5,25398,28049,2651
47167,TN,Tipton,,2014,8.3,25159,27436,2277
47167,TN,Tipton,,2015,7,25611,27547,1936
47167,TN,Tipton,,2016,5.7,25958,27529,1571
47167,TN,Tipton,,2017,4.4,26401,27625,1224
47167,TN,Tipton,,2018,4.2,26860,28041,1181
47167,TN,Tipton,,2019,3.9,27268,28370,1102
47167,TN,Tipton,,2020,6.6,25795,27619,1824
47167,TN,Tipton,,2021,4.3,26518,27707,1189
47169,TN,Trousdale,,2007,5.6,3455,3661,206
47169,TN,Trousdale,,2008,8.2,3420,3727,307
47169,TN,Trousdale,,2009,11.7,3259,3691,432
47169,TN,Trousdale,,2010,11.1,3332,3746,414
47169,TN,Trousdale,,2011,10.6,3356,3753,397
47169,TN,Trousdale,,2012,8.8,3356,3679,323
47169,TN,Trousdale,,2013,8.4,3353,3662,309
47169,TN,Trousdale,,2014,7.1,3418,3679,261
47169,TN,Trousdale,,2015,5.9,3475,3691,216
47169,TN,Trousdale,,2016,4.9,3662,3849,187
47169,TN,Trousdale,,2017,3.5,4590,4755,165
47169,TN,Trousdale,,2018,3.2,5131,5302,171
47169,TN,Trousdale,,2019,3,5375,5544,169
47169,TN,Trousdale,,2020,6.2,5089,5426,337
47169,TN,Trousdale,,2021,3.7,5367,5571,204
47171,TN,Unicoi,,2007,5.2,7938,8372,434
47171,TN,Unicoi,,2008,7.3,7831,8448,617
47171,TN,Unicoi,,2009,11.2,7467,8413,946
47171,TN,Unicoi,,2010,12.1,6966,7929,963
47171,TN,Unicoi,,2011,11.2,7003,7887,884
47171,TN,Unicoi,,2012,10.5,6896,7703,807
47171,TN,Unicoi,,2013,10.5,6652,7432,780
47171,TN,Unicoi,,2014,9.2,6485,7140,655
47171,TN,Unicoi,,2015,7.9,6488,7045,557
47171,TN,Unicoi,,2016,7.1,6517,7017,500
47171,TN,Unicoi,,2017,5.4,6679,7058,379
47171,TN,Unicoi,,2018,4.9,6705,7051,346
47171,TN,Unicoi,,2019,5,6836,7194,358
47171,TN,Unicoi,,2020,7.9,6468,7020,552
47171,TN,Unicoi,,2021,4.9,6715,7062,347
47173,TN,Union,,2007,4.4,8382,8768,386
47173,TN,Union,,2008,6.2,8274,8820,546
47173,TN,Union,,2009,10.5,7923,8853,930
47173,TN,Union,,2010,10.9,6920,7770,850
47173,TN,Union,,2011,10.3,7020,7828,808
47173,TN,Union,,2012,9.6,6887,7618,731
47173,TN,Union,,2013,9.6,6725,7439,714
47173,TN,Union,,2014,7.9,6669,7243,574
47173,TN,Union,,2015,6.7,6746,7234,488
47173,TN,Union,,2016,5.8,6862,7285,423
47173,TN,Union,,2017,4.4,7061,7385,324
47173,TN,Union,,2018,4.1,7226,7532,306
47173,TN,Union,,2019,4.1,7413,7726,313
47173,TN,Union,,2020,6.8,7110,7628,518
47173,TN,Union,,2021,4,7441,7751,310
47175,TN,Van Buren,,2007,5.9,2341,2488,147
47175,TN,Van Buren,,2008,8.2,2305,2511,206
47175,TN,Van Buren,,2009,14.4,2081,2432,351
47175,TN,Van Buren,,2010,13.4,2031,2345,314
47175,TN,Van Buren,,2011,11.9,2020,2293,273
47175,TN,Van Buren,,2012,11.7,1981,2243,262
47175,TN,Van Buren,,2013,11.5,1947,2199,252
47175,TN,Van Buren,,2014,9.6,1910,2114,204
47175,TN,Van Buren,,2015,7.9,1894,2057,163
47175,TN,Van Buren,,2016,6.2,1912,2038,126
47175,TN,Van Buren,,2017,4.3,2002,2091,89
47175,TN,Van Buren,,2018,4.7,1968,2066,98
47175,TN,Van Buren,,2019,4.6,1971,2065,94
47175,TN,Van Buren,,2020,8.5,1843,2014,171
47175,TN,Van Buren,,2021,5,1914,2014,100
47177,TN,Warren,,2007,6.3,16687,17814,1127
47177,TN,Warren,,2008,8.4,16070,17536,1466
47177,TN,Warren,,2009,13.9,14645,17009,2364
47177,TN,Warren,,2010,11.1,15798,17769,1971
47177,TN,Warren,,2011,10.4,16038,17893,1855
47177,TN,Warren,,2012,8.9,15918,17478,1560
47177,TN,Warren,,2013,8.5,16088,17586,1498
47177,TN,Warren,,2014,6.8,16268,17457,1189
47177,TN,Warren,,2015,5.6,16846,17844,998
47177,TN,Warren,,2016,4.8,16832,17685,853
47177,TN,Warren,,2017,4,16494,17173,679
47177,TN,Warren,,2018,4,16116,16783,667
47177,TN,Warren,,2019,4.1,16299,16994,695
47177,TN,Warren,,2020,8.8,15712,17232,1520
47177,TN,Warren,,2021,4.7,16019,16806,787
47179,TN,Washington,,2007,4,58747,61197,2450
47179,TN,Washington,,2008,5.5,58874,62332,3458
47179,TN,Washington,,2009,8.4,56998,62245,5247
47179,TN,Washington,,2010,8.9,55334,60716,5382
47179,TN,Washington,,2011,8.2,56140,61139,4999
47179,TN,Washington,,2012,7.2,55872,60212,4340
47179,TN,Washington,,2013,7.2,54756,58999,4243
47179,TN,Washington,,2014,6.3,54177,57833,3656
47179,TN,Washington,,2015,5.5,54767,57965,3198
47179,TN,Washington,,2016,4.8,55964,58782,2818
47179,TN,Washington,,2017,3.8,57321,59570,2249
47179,TN,Washington,,2018,3.5,57993,60117,2124
47179,TN,Washington,,2019,3.4,58994,61093,2099
47179,TN,Washington,,2020,6.3,56528,60313,3785
47179,TN,Washington,,2021,3.6,59000,61172,2172
47181,TN,Wayne,,2007,7.3,6141,6626,485
47181,TN,Wayne,,2008,9.9,5990,6650,660
47181,TN,Wayne,,2009,13,5777,6642,865
47181,TN,Wayne,,2010,11.6,6137,6942,805
47181,TN,Wayne,,2011,10.9,6056,6797,741
47181,TN,Wayne,,2012,9.6,6013,6653,640
47181,TN,Wayne,,2013,9.6,5924,6555,631
47181,TN,Wayne,,2014,8.7,5904,6469,565
47181,TN,Wayne,,2015,7.3,5743,6198,455
47181,TN,Wayne,,2016,6.6,5691,6093,402
47181,TN,Wayne,,2017,5.3,5807,6129,322
47181,TN,Wayne,,2018,4.8,5861,6158,297
47181,TN,Wayne,,2019,4.6,6028,6320,292
47181,TN,Wayne,,2020,6.8,5924,6356,432
47181,TN,Wayne,,2021,4.1,6031,6286,255
47183,TN,Weakley,,2007,6.5,14619,15629,1010
47183,TN,Weakley,,2008,8.1,14417,15684,1267
47183,TN,Weakley,,2009,12.1,13921,15835,1914
47183,TN,Weakley,,2010,11.2,15056,16950,1894
47183,TN,Weakley,,2011,11.6,14747,16674,1927
47183,TN,Weakley,,2012,11.1,15051,16928,1877
47183,TN,Weakley,,2013,10.3,14861,16573,1712
47183,TN,Weakley,,2014,8.6,14548,15915,1367
47183,TN,Weakley,,2015,6.7,14570,15624,1054
47183,TN,Weakley,,2016,5.9,14944,15875,931
47183,TN,Weakley,,2017,4.9,15014,15781,767
47183,TN,Weakley,,2018,4.2,15317,15992,675
47183,TN,Weakley,,2019,4,15487,16137,650
47183,TN,Weakley,,2020,5.7,14587,15467,880
47183,TN,Weakley,,2021,3.8,14878,15461,583
47185,TN,White,,2007,6,9908,10540,632
47185,TN,White,,2008,8.3,9762,10640,878
47185,TN,White,,2009,13.7,9142,10596,1454
47185,TN,White,,2010,10.7,11024,12344,1320
47185,TN,White,,2011,10,11209,12454,1245
47185,TN,White,,2012,9.9,10988,12199,1211
47185,TN,White,,2013,9.4,10784,11908,1124
47185,TN,White,,2014,7.4,10609,11461,852
47185,TN,White,,2015,6,10750,11438,688
47185,TN,White,,2016,5,11182,11770,588
47185,TN,White,,2017,4,11440,11915,475
47185,TN,White,,2018,3.6,11840,12282,442
47185,TN,White,,2019,3.7,11866,12322,456
47185,TN,White,,2020,7,11221,12068,847
47185,TN,White,,2021,3.9,11379,11843,464
47187,TN,Williamson,,2007,3.6,84446,87630,3184
47187,TN,Williamson,,2008,4.5,85216,89266,4050
47187,TN,Williamson,,2009,7.3,82689,89196,6507
47187,TN,Williamson,,2010,6.7,88189,94512,6323
47187,TN,Williamson,,2011,5.9,91345,97109,5764
47187,TN,Williamson,,2012,5,93837,98818,4981
47187,TN,Williamson,,2013,5.1,96348,101563,5215
47187,TN,Williamson,,2014,4.5,99185,103910,4725
47187,TN,Williamson,,2015,4,103534,107820,4286
47187,TN,Williamson,,2016,3.4,109736,113631,3895
47187,TN,Williamson,,2017,2.7,116468,119700,3232
47187,TN,Williamson,,2018,2.5,122232,125351,3119
47187,TN,Williamson,,2019,2.4,128542,131762,3220
47187,TN,Williamson,,2020,4.7,123362,129427,6065
47187,TN,Williamson,,2021,2.5,130456,133778,3322
47189,TN,Wilson,,2007,4,54819,57106,2287
47189,TN,Wilson,,2008,5.7,55339,58654,3315
47189,TN,Wilson,,2009,8.7,53283,58384,5101
47189,TN,Wilson,,2010,8.5,53558,58550,4992
47189,TN,Wilson,,2011,7.7,55302,59897,4595
47189,TN,Wilson,,2012,6.5,56643,60587,3944
47189,TN,Wilson,,2013,6.3,57825,61697,3872
47189,TN,Wilson,,2014,5.3,59336,62655,3319
47189,TN,Wilson,,2015,4.5,61820,64763,2943
47189,TN,Wilson,,2016,3.9,65252,67876,2624
47189,TN,Wilson,,2017,3,68930,71042,2112
47189,TN,Wilson,,2018,2.8,72745,74821,2076
47189,TN,Wilson,,2019,2.7,76501,78621,2120
47189,TN,Wilson,,2020,6.3,72992,77895,4903
47189,TN,Wilson,,2021,3.2,77054,79606,2552
48000,TX,Texas,,2007,4.4,10940176,11441054,500878
48000,TX,Texas,,2008,4.9,11110499,11677743,567244
48000,TX,Texas,,2009,7.5,11043167,11944138,900971
48000,TX,Texas,,2010,8.2,11255444,12260100,1004656
48000,TX,Texas,,2011,8,11498869,12499595,1000726
48000,TX,Texas,,2012,6.7,11794975,12639465,844490
48000,TX,Texas,,2013,6.3,12022272,12832035,809763
48000,TX,Texas,,2014,5.2,12333076,13006202,673126
48000,TX,Texas,,2015,4.5,12503464,13090961,587497
48000,TX,Texas,,2016,4.6,12728898,13346836,617938
48000,TX,Texas,,2017,4.3,12888025,13473991,585966
48000,TX,Texas,,2018,3.9,13149672,13684009,534337
48000,TX,Texas,,2019,3.5,13381020,13871780,490760
48000,TX,Texas,,2020,7.7,12808616,13870874,1062258
48000,TX,Texas,,2021,5.7,13413036,14220446,807410
48001,TX,Anderson,,2007,5.1,19022,20053,1031
48001,TX,Anderson,,2008,5.6,19098,20239,1141
48001,TX,Anderson,,2009,8.7,19099,20909,1810
48001,TX,Anderson,,2010,8.1,19975,21744,1769
48001,TX,Anderson,,2011,7.5,20506,22178,1672
48001,TX,Anderson,,2012,6.3,20932,22334,1402
48001,TX,Anderson,,2013,5.8,20711,21997,1286
48001,TX,Anderson,,2014,4.7,20732,21760,1028
48001,TX,Anderson,,2015,4,21948,22853,905
48001,TX,Anderson,,2016,4.3,22499,23518,1019
48001,TX,Anderson,,2017,3.7,22238,23085,847
48001,TX,Anderson,,2018,3.1,22444,23169,725
48001,TX,Anderson,,2019,2.9,22508,23188,680
48001,TX,Anderson,,2020,5.7,21569,22869,1300
48001,TX,Anderson,,2021,4.8,22109,23234,1125
48003,TX,Andrews,,2007,3.2,6464,6681,217
48003,TX,Andrews,,2008,3.4,6645,6876,231
48003,TX,Andrews,,2009,7,6514,7005,491
48003,TX,Andrews,,2010,6.2,6687,7130,443
48003,TX,Andrews,,2011,5.2,7382,7784,402
48003,TX,Andrews,,2012,4,8186,8524,338
48003,TX,Andrews,,2013,3.8,8800,9152,352
48003,TX,Andrews,,2014,3,9223,9512,289
48003,TX,Andrews,,2015,3.5,8977,9303,326
48003,TX,Andrews,,2016,4.7,8282,8693,411
48003,TX,Andrews,,2017,3.1,8656,8934,278
48003,TX,Andrews,,2018,2.4,9095,9321,226
48003,TX,Andrews,,2019,2.3,9570,9794,224
48003,TX,Andrews,,2020,8.2,8378,9127,749
48003,TX,Andrews,,2021,5.9,8465,8992,527
48005,TX,Angelina,,2007,4.4,37901,39659,1758
48005,TX,Angelina,,2008,4.8,37255,39126,1871
48005,TX,Angelina,,2009,8.2,36796,40071,3275
48005,TX,Angelina,,2010,8.6,34858,38119,3261
48005,TX,Angelina,,2011,8.2,34997,38103,3106
48005,TX,Angelina,,2012,6.9,35187,37778,2591
48005,TX,Angelina,,2013,6.5,35420,37892,2472
48005,TX,Angelina,,2014,5.3,35688,37688,2000
48005,TX,Angelina,,2015,5.6,35306,37412,2106
48005,TX,Angelina,,2016,5.9,34888,37081,2193
48005,TX,Angelina,,2017,5.1,34514,36379,1865
48005,TX,Angelina,,2018,4.4,34134,35702,1568
48005,TX,Angelina,,2019,4,33922,35337,1415
48005,TX,Angelina,,2020,7.6,32500,35185,2685
48005,TX,Angelina,,2021,6.5,33431,35754,2323
48007,TX,Aransas,,2007,4.1,10553,11005,452
48007,TX,Aransas,,2008,4.4,10896,11402,506
48007,TX,Aransas,,2009,6.8,10810,11600,790
48007,TX,Aransas,,2010,9.2,8805,9701,896
48007,TX,Aransas,,2011,9,8926,9814,888
48007,TX,Aransas,,2012,6.9,9233,9919,686
48007,TX,Aransas,,2013,6.6,9384,10049,665
48007,TX,Aransas,,2014,5.6,9616,10187,571
48007,TX,Aransas,,2015,5.1,9551,10065,514
48007,TX,Aransas,,2016,5.6,9669,10241,572
48007,TX,Aransas,,2017,6.9,9553,10258,705
48007,TX,Aransas,,2018,6,8910,9478,568
48007,TX,Aransas,,2019,4.3,8780,9173,393
48007,TX,Aransas,,2020,8.4,8342,9103,761
48007,TX,Aransas,,2021,7.3,8584,9256,672
48009,TX,Archer,,2007,3.2,4939,5103,164
48009,TX,Archer,,2008,3.7,4945,5134,189
48009,TX,Archer,,2009,5.9,4720,5016,296
48009,TX,Archer,,2010,6.7,4299,4607,308
48009,TX,Archer,,2011,6.3,4199,4480,281
48009,TX,Archer,,2012,5.5,4123,4361,238
48009,TX,Archer,,2013,5.3,3999,4222,223
48009,TX,Archer,,2014,4.6,4042,4236,194
48009,TX,Archer,,2015,4.5,3941,4125,184
48009,TX,Archer,,2016,4.3,3914,4091,177
48009,TX,Archer,,2017,3.4,3971,4110,139
48009,TX,Archer,,2018,3.1,3975,4101,126
48009,TX,Archer,,2019,2.8,3848,3960,112
48009,TX,Archer,,2020,5.3,3735,3942,207
48009,TX,Archer,,2021,4.2,3808,3975,167
48011,TX,Armstrong,,2007,3.5,1032,1069,37
48011,TX,Armstrong,,2008,3.5,1054,1092,38
48011,TX,Armstrong,,2009,4.5,1015,1063,48
48011,TX,Armstrong,,2010,4.9,963,1013,50
48011,TX,Armstrong,,2011,4.9,984,1035,51
48011,TX,Armstrong,,2012,4.4,980,1025,45
48011,TX,Armstrong,,2013,4,964,1004,40
48011,TX,Armstrong,,2014,3.3,970,1003,33
48011,TX,Armstrong,,2015,2.7,950,976,26
48011,TX,Armstrong,,2016,2.8,908,934,26
48011,TX,Armstrong,,2017,2.6,887,911,24
48011,TX,Armstrong,,2018,2.7,888,913,25
48011,TX,Armstrong,,2019,2.7,894,919,25
48011,TX,Armstrong,,2020,4.3,853,891,38
48011,TX,Armstrong,,2021,3.6,887,920,33
48013,TX,Atascosa,,2007,4.1,17955,18732,777
48013,TX,Atascosa,,2008,4.7,18032,18925,893
48013,TX,Atascosa,,2009,7.4,18034,19474,1440
48013,TX,Atascosa,,2010,8.2,18047,19661,1614
48013,TX,Atascosa,,2011,8.2,18246,19884,1638
48013,TX,Atascosa,,2012,6.7,18681,20022,1341
48013,TX,Atascosa,,2013,6.3,18937,20206,1269
48013,TX,Atascosa,,2014,5,19323,20343,1020
48013,TX,Atascosa,,2015,4.8,19560,20546,986
48013,TX,Atascosa,,2016,5.3,19906,21031,1125
48013,TX,Atascosa,,2017,4.3,19895,20787,892
48013,TX,Atascosa,,2018,3.8,20401,21207,806
48013,TX,Atascosa,,2019,3.6,20710,21483,773
48013,TX,Atascosa,,2020,8.5,19645,21480,1835
48013,TX,Atascosa,,2021,6.2,20550,21901,1351
48015,TX,Austin,,2007,3.8,12341,12829,488
48015,TX,Austin,,2008,4.2,12475,13028,553
48015,TX,Austin,,2009,7.3,12285,13252,967
48015,TX,Austin,,2010,8.1,12813,13939,1126
48015,TX,Austin,,2011,8.1,12995,14147,1152
48015,TX,Austin,,2012,6.4,13166,14060,894
48015,TX,Austin,,2013,5.9,13274,14110,836
48015,TX,Austin,,2014,4.8,13433,14116,683
48015,TX,Austin,,2015,4.6,13397,14047,650
48015,TX,Austin,,2016,5.3,13287,14036,749
48015,TX,Austin,,2017,4.4,13094,13703,609
48015,TX,Austin,,2018,3.7,13223,13730,507
48015,TX,Austin,,2019,3.4,13333,13809,476
48015,TX,Austin,,2020,6.6,12474,13362,888
48015,TX,Austin,,2021,5.5,12940,13696,756
48017,TX,Bailey,,2007,4.4,3137,3280,143
48017,TX,Bailey,,2008,4.1,3205,3343,138
48017,TX,Bailey,,2009,5.6,3172,3360,188
48017,TX,Bailey,,2010,7.9,3004,3262,258
48017,TX,Bailey,,2011,7.7,3034,3287,253
48017,TX,Bailey,,2012,6.9,2957,3175,218
48017,TX,Bailey,,2013,7.2,2823,3042,219
48017,TX,Bailey,,2014,5.1,2803,2954,151
48017,TX,Bailey,,2015,4.3,2680,2801,121
48017,TX,Bailey,,2016,4.4,2600,2719,119
48017,TX,Bailey,,2017,4.3,2527,2641,114
48017,TX,Bailey,,2018,4.4,2479,2594,115
48017,TX,Bailey,,2019,3.7,2379,2470,91
48017,TX,Bailey,,2020,4.8,2256,2369,113
48017,TX,Bailey,,2021,4.9,2292,2411,119
48019,TX,Bandera,,2007,3.8,9218,9585,367
48019,TX,Bandera,,2008,4.4,9245,9671,426
48019,TX,Bandera,,2009,6.5,9205,9845,640
48019,TX,Bandera,,2010,7.8,8468,9188,720
48019,TX,Bandera,,2011,7.7,8465,9176,711
48019,TX,Bandera,,2012,6.5,8513,9106,593
48019,TX,Bandera,,2013,6.1,8504,9054,550
48019,TX,Bandera,,2014,4.8,8672,9112,440
48019,TX,Bandera,,2015,4,8814,9182,368
48019,TX,Bandera,,2016,4.1,9116,9507,391
48019,TX,Bandera,,2017,3.6,9316,9668,352
48019,TX,Bandera,,2018,3.4,9505,9843,338
48019,TX,Bandera,,2019,3.3,9602,9929,327
48019,TX,Bandera,,2020,5.8,9298,9872,574
48019,TX,Bandera,,2021,4.7,9745,10227,482
48021,TX,Bastrop,,2007,4.2,31993,33403,1410
48021,TX,Bastrop,,2008,4.9,32048,33708,1660
48021,TX,Bastrop,,2009,7.9,31633,34343,2710
48021,TX,Bastrop,,2010,8.3,32413,35338,2925
48021,TX,Bastrop,,2011,8.2,32781,35705,2924
48021,TX,Bastrop,,2012,6.6,32878,35216,2338
48021,TX,Bastrop,,2013,6.2,33615,35837,2222
48021,TX,Bastrop,,2014,4.9,34852,36660,1808
48021,TX,Bastrop,,2015,3.9,36083,37553,1470
48021,TX,Bastrop,,2016,3.7,37583,39046,1463
48021,TX,Bastrop,,2017,3.6,38452,39895,1443
48021,TX,Bastrop,,2018,3.4,39866,41270,1404
48021,TX,Bastrop,,2019,3.1,40894,42185,1291
48021,TX,Bastrop,,2020,6,39877,42433,2556
48021,TX,Bastrop,,2021,4.5,43084,45101,2017
48023,TX,Baylor,,2007,3.8,1948,2025,77
48023,TX,Baylor,,2008,3.7,1957,2033,76
48023,TX,Baylor,,2009,5.6,1857,1967,110
48023,TX,Baylor,,2010,7.1,1613,1736,123
48023,TX,Baylor,,2011,6.2,1746,1861,115
48023,TX,Baylor,,2012,5.1,1767,1862,95
48023,TX,Baylor,,2013,5.3,1580,1669,89
48023,TX,Baylor,,2014,4.3,1579,1650,71
48023,TX,Baylor,,2015,3.6,1570,1628,58
48023,TX,Baylor,,2016,3.6,1548,1606,58
48023,TX,Baylor,,2017,3.4,1523,1577,54
48023,TX,Baylor,,2018,3.2,1491,1540,49
48023,TX,Baylor,,2019,2.3,1692,1731,39
48023,TX,Baylor,,2020,3.4,1696,1756,60
48023,TX,Baylor,,2021,3.4,1755,1816,61
48025,TX,Bee,,2007,6,10522,11192,670
48025,TX,Bee,,2008,6.2,10550,11249,699
48025,TX,Bee,,2009,9,10843,11912,1069
48025,TX,Bee,,2010,9,9592,10543,951
48025,TX,Bee,,2011,8.9,9652,10593,941
48025,TX,Bee,,2012,7,10070,10827,757
48025,TX,Bee,,2013,6.6,10550,11298,748
48025,TX,Bee,,2014,5.9,10089,10720,631
48025,TX,Bee,,2015,6.2,9740,10386,646
48025,TX,Bee,,2016,7.5,9537,10314,777
48025,TX,Bee,,2017,6.5,9252,9898,646
48025,TX,Bee,,2018,5.1,9342,9846,504
48025,TX,Bee,,2019,4.4,9280,9708,428
48025,TX,Bee,,2020,9.9,8781,9748,967
48025,TX,Bee,,2021,8.7,8484,9293,809
48027,TX,Bell,,2007,4.5,113296,118680,5384
48027,TX,Bell,,2008,4.9,116501,122506,6005
48027,TX,Bell,,2009,6.6,118800,127238,8438
48027,TX,Bell,,2010,7.8,121787,132031,10244
48027,TX,Bell,,2011,8.3,122377,133430,11053
48027,TX,Bell,,2012,7.4,123945,133801,9856
48027,TX,Bell,,2013,7,125664,135078,9414
48027,TX,Bell,,2014,5.9,126763,134720,7957
48027,TX,Bell,,2015,4.7,129940,136340,6400
48027,TX,Bell,,2016,4.5,133264,139561,6297
48027,TX,Bell,,2017,4.3,135005,141063,6058
48027,TX,Bell,,2018,4.2,135339,141237,5898
48027,TX,Bell,,2019,3.9,136616,142089,5473
48027,TX,Bell,,2020,7,133640,143703,10063
48027,TX,Bell,,2021,5.7,139057,147526,8469
48029,TX,Bexar,,2007,4.2,703389,734071,30682
48029,TX,Bexar,,2008,4.7,714302,749530,35228
48029,TX,Bexar,,2009,6.7,714633,766091,51458
48029,TX,Bexar,,2010,7.3,754040,813648,59608
48029,TX,Bexar,,2011,7.4,767720,829332,61612
48029,TX,Bexar,,2012,6.3,785636,838357,52721
48029,TX,Bexar,,2013,5.9,802913,852897,49984
48029,TX,Bexar,,2014,4.7,824137,865150,41013
48029,TX,Bexar,,2015,3.8,845395,879163,33768
48029,TX,Bexar,,2016,3.8,871855,905846,33991
48029,TX,Bexar,,2017,3.6,884586,917323,32737
48029,TX,Bexar,,2018,3.4,895880,927183,31303
48029,TX,Bexar,,2019,3.2,902782,932179,29397
48029,TX,Bexar,,2020,7.6,856813,927557,70744
48029,TX,Bexar,,2021,5.4,895189,945855,50666
48031,TX,Blanco,,2007,3.3,4609,4767,158
48031,TX,Blanco,,2008,3.7,4698,4876,178
48031,TX,Blanco,,2009,5.2,4819,5081,262
48031,TX,Blanco,,2010,6,5101,5426,325
48031,TX,Blanco,,2011,5.9,5096,5414,318
48031,TX,Blanco,,2012,5.1,5199,5480,281
48031,TX,Blanco,,2013,4.7,5267,5528,261
48031,TX,Blanco,,2014,3.7,5460,5670,210
48031,TX,Blanco,,2015,3.2,5587,5769,182
48031,TX,Blanco,,2016,3.1,5753,5937,184
48031,TX,Blanco,,2017,2.8,6009,6181,172
48031,TX,Blanco,,2018,2.6,6026,6189,163
48031,TX,Blanco,,2019,2.4,6277,6434,157
48031,TX,Blanco,,2020,3.8,6279,6530,251
48031,TX,Blanco,,2021,3.3,6638,6866,228
48033,TX,Borden,,2007,4,357,372,15
48033,TX,Borden,,2008,3.3,384,397,13
48033,TX,Borden,,2009,5.4,402,425,23
48033,TX,Borden,,2010,6.7,335,359,24
48033,TX,Borden,,2011,5.4,367,388,21
48033,TX,Borden,,2012,4.1,400,417,17
48033,TX,Borden,,2013,4.1,399,416,17
48033,TX,Borden,,2014,3.1,410,423,13
48033,TX,Borden,,2015,2.9,400,412,12
48033,TX,Borden,,2016,3.6,353,366,13
48033,TX,Borden,,2017,3.4,309,320,11
48033,TX,Borden,,2018,3.2,329,340,11
48033,TX,Borden,,2019,2.5,390,400,10
48033,TX,Borden,,2020,3.4,423,438,15
48033,TX,Borden,,2021,2.4,567,581,14
48035,TX,Bosque,,2007,4.3,7820,8173,353
48035,TX,Bosque,,2008,4.6,7896,8273,377
48035,TX,Bosque,,2009,7.8,7909,8574,665
48035,TX,Bosque,,2010,8.8,7714,8462,748
48035,TX,Bosque,,2011,8.6,7685,8406,721
48035,TX,Bosque,,2012,7.2,7583,8169,586
48035,TX,Bosque,,2013,6.5,7539,8065,526
48035,TX,Bosque,,2014,5.2,7703,8128,425
48035,TX,Bosque,,2015,4.5,7699,8064,365
48035,TX,Bosque,,2016,4.3,7838,8191,353
48035,TX,Bosque,,2017,4,7808,8135,327
48035,TX,Bosque,,2018,3.7,7833,8137,304
48035,TX,Bosque,,2019,3.4,7933,8214,281
48035,TX,Bosque,,2020,5.5,7738,8185,447
48035,TX,Bosque,,2021,4.6,8044,8429,385
48037,TX,Bowie,,2007,4.8,40893,42948,2055
48037,TX,Bowie,,2008,5,41347,43523,2176
48037,TX,Bowie,,2009,6.6,41387,44310,2923
48037,TX,Bowie,,2010,8.5,38685,42269,3584
48037,TX,Bowie,,2011,8.5,38711,42325,3614
48037,TX,Bowie,,2012,7.4,38388,41452,3064
48037,TX,Bowie,,2013,7.7,37371,40481,3110
48037,TX,Bowie,,2014,6.4,37088,39612,2524
48037,TX,Bowie,,2015,4.8,37274,39171,1897
48037,TX,Bowie,,2016,4.7,37775,39643,1868
48037,TX,Bowie,,2017,4.6,37186,38986,1800
48037,TX,Bowie,,2018,5,37159,39101,1942
48037,TX,Bowie,,2019,4.4,37408,39150,1742
48037,TX,Bowie,,2020,7.4,35569,38412,2843
48037,TX,Bowie,,2021,5.8,36770,39047,2277
48039,TX,Brazoria,,2007,4.4,131878,138019,6141
48039,TX,Brazoria,,2008,5.1,135180,142502,7322
48039,TX,Brazoria,,2009,8.1,134733,146544,11811
48039,TX,Brazoria,,2010,8.5,142179,155443,13264
48039,TX,Brazoria,,2011,8.3,145399,158522,13123
48039,TX,Brazoria,,2012,6.6,150155,160811,10656
48039,TX,Brazoria,,2013,6.2,153913,164015,10102
48039,TX,Brazoria,,2014,5.2,157901,166488,8587
48039,TX,Brazoria,,2015,4.6,159416,167126,7710
48039,TX,Brazoria,,2016,5.2,161111,169940,8829
48039,TX,Brazoria,,2017,5.3,162805,172006,9201
48039,TX,Brazoria,,2018,4.6,166883,174880,7997
48039,TX,Brazoria,,2019,4.2,170069,177569,7500
48039,TX,Brazoria,,2020,8.6,162103,177312,15209
48039,TX,Brazoria,,2021,6.9,167799,180207,12408
48041,TX,Brazos,,2007,3.7,84933,88163,3230
48041,TX,Brazos,,2008,3.9,88213,91793,3580
48041,TX,Brazos,,2009,5.4,91652,96932,5280
48041,TX,Brazos,,2010,6.3,93813,100145,6332
48041,TX,Brazos,,2011,6.2,93461,99668,6207
48041,TX,Brazos,,2012,5.2,94375,99598,5223
48041,TX,Brazos,,2013,4.9,97521,102594,5073
48041,TX,Brazos,,2014,4,99973,104180,4207
48041,TX,Brazos,,2015,3.3,105010,108638,3628
48041,TX,Brazos,,2016,3.5,107481,111338,3857
48041,TX,Brazos,,2017,3.1,108698,112185,3487
48041,TX,Brazos,,2018,2.9,112032,115352,3320
48041,TX,Brazos,,2019,2.7,114136,117312,3176
48041,TX,Brazos,,2020,5.3,110128,116321,6193
48041,TX,Brazos,,2021,4.1,116075,121046,4971
48043,TX,Brewster,,2007,3.4,5046,5221,175
48043,TX,Brewster,,2008,3.7,4917,5106,189
48043,TX,Brewster,,2009,5.1,4907,5168,261
48043,TX,Brewster,,2010,5.5,4649,4919,270
48043,TX,Brewster,,2011,5.7,4577,4856,279
48043,TX,Brewster,,2012,5.1,4322,4552,230
48043,TX,Brewster,,2013,5.6,3914,4146,232
48043,TX,Brewster,,2014,4.7,3871,4062,191
48043,TX,Brewster,,2015,4,3756,3911,155
48043,TX,Brewster,,2016,3.8,3814,3963,149
48043,TX,Brewster,,2017,3.5,3799,3938,139
48043,TX,Brewster,,2018,3.4,3871,4006,135
48043,TX,Brewster,,2019,2.9,4020,4141,121
48043,TX,Brewster,,2020,6.6,3800,4069,269
48043,TX,Brewster,,2021,4.5,3991,4181,190
48045,TX,Briscoe,,2007,4.3,682,713,31
48045,TX,Briscoe,,2008,4.3,674,704,30
48045,TX,Briscoe,,2009,5,680,716,36
48045,TX,Briscoe,,2010,6.1,690,735,45
48045,TX,Briscoe,,2011,6.4,676,722,46
48045,TX,Briscoe,,2012,5.5,607,642,35
48045,TX,Briscoe,,2013,5.7,592,628,36
48045,TX,Briscoe,,2014,4.2,609,636,27
48045,TX,Briscoe,,2015,3.9,572,595,23
48045,TX,Briscoe,,2016,4.4,524,548,24
48045,TX,Briscoe,,2017,4.4,526,550,24
48045,TX,Briscoe,,2018,4,532,554,22
48045,TX,Briscoe,,2019,3.5,551,571,20
48045,TX,Briscoe,,2020,4.7,523,549,26
48045,TX,Briscoe,,2021,4.7,547,574,27
48047,TX,Brooks,,2007,5.4,2917,3084,167
48047,TX,Brooks,,2008,5.3,3098,3272,174
48047,TX,Brooks,,2009,9.3,3009,3318,309
48047,TX,Brooks,,2010,12,2285,2597,312
48047,TX,Brooks,,2011,11,2397,2693,296
48047,TX,Brooks,,2012,8.7,2479,2715,236
48047,TX,Brooks,,2013,9.1,2510,2761,251
48047,TX,Brooks,,2014,7.8,2492,2704,212
48047,TX,Brooks,,2015,10,2344,2604,260
48047,TX,Brooks,,2016,11.8,2152,2441,289
48047,TX,Brooks,,2017,8.3,2214,2415,201
48047,TX,Brooks,,2018,6.5,2272,2429,157
48047,TX,Brooks,,2019,5.1,2454,2586,132
48047,TX,Brooks,,2020,10.7,2297,2571,274
48047,TX,Brooks,,2021,9.2,2268,2499,231
48049,TX,Brown,,2007,4.2,17750,18519,769
48049,TX,Brown,,2008,4.4,17636,18451,815
48049,TX,Brown,,2009,6.8,17772,19067,1295
48049,TX,Brown,,2010,8.3,15098,16457,1359
48049,TX,Brown,,2011,8.3,15019,16377,1358
48049,TX,Brown,,2012,6.7,14951,16032,1081
48049,TX,Brown,,2013,6.5,14868,15904,1036
48049,TX,Brown,,2014,5.2,14998,15828,830
48049,TX,Brown,,2015,4.4,15208,15900,692
48049,TX,Brown,,2016,4.4,15473,16177,704
48049,TX,Brown,,2017,3.9,15347,15971,624
48049,TX,Brown,,2018,3.8,15272,15868,596
48049,TX,Brown,,2019,3.7,14904,15479,575
48049,TX,Brown,,2020,6.5,14143,15123,980
48049,TX,Brown,,2021,5.2,14475,15267,792
48051,TX,Burleson,,2007,3.9,7435,7738,303
48051,TX,Burleson,,2008,4.4,7544,7893,349
48051,TX,Burleson,,2009,6.8,7607,8165,558
48051,TX,Burleson,,2010,7.9,7258,7881,623
48051,TX,Burleson,,2011,7.5,7177,7762,585
48051,TX,Burleson,,2012,6.3,7170,7648,478
48051,TX,Burleson,,2013,6.2,7204,7682,478
48051,TX,Burleson,,2014,4.8,7216,7581,365
48051,TX,Burleson,,2015,4.4,7420,7761,341
48051,TX,Burleson,,2016,4.7,7513,7880,367
48051,TX,Burleson,,2017,4.2,7597,7933,336
48051,TX,Burleson,,2018,3.6,7849,8145,296
48051,TX,Burleson,,2019,3.1,7926,8181,255
48051,TX,Burleson,,2020,6.4,7560,8074,514
48051,TX,Burleson,,2021,5,7977,8396,419
48053,TX,Burnet,,2007,3.5,20968,21732,764
48053,TX,Burnet,,2008,3.9,21318,22186,868
48053,TX,Burnet,,2009,6.1,20935,22287,1352
48053,TX,Burnet,,2010,6.8,18933,20316,1383
48053,TX,Burnet,,2011,7,19204,20642,1438
48053,TX,Burnet,,2012,5.9,19171,20377,1206
48053,TX,Burnet,,2013,5.5,19613,20758,1145
48053,TX,Burnet,,2014,4.4,20531,21468,937
48053,TX,Burnet,,2015,3.7,20406,21184,778
48053,TX,Burnet,,2016,3.5,21241,22004,763
48053,TX,Burnet,,2017,3.2,21398,22106,708
48053,TX,Burnet,,2018,2.9,22038,22698,660
48053,TX,Burnet,,2019,2.7,22671,23308,637
48053,TX,Burnet,,2020,4.8,22399,23517,1118
48053,TX,Burnet,,2021,3.7,23676,24594,918
48055,TX,Caldwell,,2007,4.5,14726,15421,695
48055,TX,Caldwell,,2008,5.3,14579,15391,812
48055,TX,Caldwell,,2009,8.3,14473,15784,1311
48055,TX,Caldwell,,2010,8.7,15239,16684,1445
48055,TX,Caldwell,,2011,8.7,15388,16853,1465
48055,TX,Caldwell,,2012,7.1,15605,16803,1198
48055,TX,Caldwell,,2013,6.6,15961,17092,1131
48055,TX,Caldwell,,2014,5.3,16309,17218,909
48055,TX,Caldwell,,2015,4.4,16669,17431,762
48055,TX,Caldwell,,2016,4.3,17173,17952,779
48055,TX,Caldwell,,2017,4,17645,18371,726
48055,TX,Caldwell,,2018,3.7,18212,18908,696
48055,TX,Caldwell,,2019,3.4,18492,19145,653
48055,TX,Caldwell,,2020,6.5,17593,18814,1221
48055,TX,Caldwell,,2021,4.9,19008,19988,980
48057,TX,Calhoun,,2007,4.5,8836,9253,417
48057,TX,Calhoun,,2008,4.8,8939,9388,449
48057,TX,Calhoun,,2009,8.5,8671,9472,801
48057,TX,Calhoun,,2010,8.8,9294,10196,902
48057,TX,Calhoun,,2011,8.8,9667,10599,932
48057,TX,Calhoun,,2012,7.3,9638,10397,759
48057,TX,Calhoun,,2013,6.2,10146,10822,676
48057,TX,Calhoun,,2014,4.8,10538,11073,535
48057,TX,Calhoun,,2015,4,10877,11333,456
48057,TX,Calhoun,,2016,5.6,10178,10780,602
48057,TX,Calhoun,,2017,5.8,9813,10419,606
48057,TX,Calhoun,,2018,4.1,10644,11103,459
48057,TX,Calhoun,,2019,3.2,11598,11983,385
48057,TX,Calhoun,,2020,5.8,11155,11845,690
48057,TX,Calhoun,,2021,4.9,11625,12224,599
48059,TX,Callahan,,2007,3.4,6691,6929,238
48059,TX,Callahan,,2008,3.6,6851,7109,258
48059,TX,Callahan,,2009,5.8,6700,7112,412
48059,TX,Callahan,,2010,7.3,5572,6010,438
48059,TX,Callahan,,2011,7.4,5569,6014,445
48059,TX,Callahan,,2012,6,5561,5919,358
48059,TX,Callahan,,2013,5.8,5564,5905,341
48059,TX,Callahan,,2014,4.5,5561,5823,262
48059,TX,Callahan,,2015,4.3,5487,5733,246
48059,TX,Callahan,,2016,4.3,5560,5808,248
48059,TX,Callahan,,2017,3.7,5652,5867,215
48059,TX,Callahan,,2018,3.4,5725,5926,201
48059,TX,Callahan,,2019,3.1,5802,5987,185
48059,TX,Callahan,,2020,5.4,5619,5942,323
48059,TX,Callahan,,2021,4.6,5850,6134,284
48061,TX,Cameron,,2007,6,134360,142921,8561
48061,TX,Cameron,,2008,6.7,136353,146091,9738
48061,TX,Cameron,,2009,9.7,137116,151819,14703
48061,TX,Cameron,,2010,11.2,144310,162522,18212
48061,TX,Cameron,,2011,11.8,146311,165944,19633
48061,TX,Cameron,,2012,10.2,148873,165860,16987
48061,TX,Cameron,,2013,10,150060,166810,16750
48061,TX,Cameron,,2014,8.4,152175,166204,14029
48061,TX,Cameron,,2015,7.2,151483,163191,11708
48061,TX,Cameron,,2016,7.2,154169,166111,11942
48061,TX,Cameron,,2017,7,153499,165051,11552
48061,TX,Cameron,,2018,6.2,154162,164356,10194
48061,TX,Cameron,,2019,5.5,155573,164659,9086
48061,TX,Cameron,,2020,10.1,152198,169311,17113
48061,TX,Cameron,,2021,8.2,160786,175073,14287
48063,TX,Camp,,2007,4.6,5299,5555,256
48063,TX,Camp,,2008,4.9,5293,5565,272
48063,TX,Camp,,2009,8.8,5251,5759,508
48063,TX,Camp,,2010,9.2,5186,5709,523
48063,TX,Camp,,2011,9.3,5154,5680,526
48063,TX,Camp,,2012,8,5054,5491,437
48063,TX,Camp,,2013,7.4,5098,5506,408
48063,TX,Camp,,2014,6.2,4889,5211,322
48063,TX,Camp,,2015,6.2,4781,5096,315
48063,TX,Camp,,2016,6.9,4717,5064,347
48063,TX,Camp,,2017,5.7,4706,4991,285
48063,TX,Camp,,2018,4.9,4708,4952,244
48063,TX,Camp,,2019,4.2,4704,4910,206
48063,TX,Camp,,2020,7.4,4586,4952,366
48063,TX,Camp,,2021,5.9,4812,5116,304
48065,TX,Carson,,2007,3.1,3246,3351,105
48065,TX,Carson,,2008,3.3,3179,3289,110
48065,TX,Carson,,2009,5.8,3080,3270,190
48065,TX,Carson,,2010,5.5,3173,3356,183
48065,TX,Carson,,2011,5.1,3244,3420,176
48065,TX,Carson,,2012,4.5,3135,3283,148
48065,TX,Carson,,2013,4.5,3029,3171,142
48065,TX,Carson,,2014,3.4,3038,3145,107
48065,TX,Carson,,2015,3.2,2970,3069,99
48065,TX,Carson,,2016,3.3,2997,3098,101
48065,TX,Carson,,2017,3.3,2909,3007,98
48065,TX,Carson,,2018,2.8,2882,2966,84
48065,TX,Carson,,2019,2.6,2869,2945,76
48065,TX,Carson,,2020,4.2,2734,2854,120
48065,TX,Carson,,2021,3.9,2844,2958,114
48067,TX,Cass,,2007,5.5,12277,12985,708
48067,TX,Cass,,2008,6.1,12113,12904,791
48067,TX,Cass,,2009,11.3,11861,13372,1511
48067,TX,Cass,,2010,11.3,11855,13358,1503
48067,TX,Cass,,2011,11,11851,13316,1465
48067,TX,Cass,,2012,9.1,11627,12795,1168
48067,TX,Cass,,2013,9.3,11408,12574,1166
48067,TX,Cass,,2014,7.7,11321,12270,949
48067,TX,Cass,,2015,6.8,11342,12175,833
48067,TX,Cass,,2016,7.2,11391,12276,885
48067,TX,Cass,,2017,6,11377,12104,727
48067,TX,Cass,,2018,5.1,11561,12180,619
48067,TX,Cass,,2019,4.3,11700,12229,529
48067,TX,Cass,,2020,7.9,11172,12132,960
48067,TX,Cass,,2021,6.7,11556,12386,830
48069,TX,Castro,,2007,3.8,3296,3425,129
48069,TX,Castro,,2008,3.6,3474,3604,130
48069,TX,Castro,,2009,4.8,3527,3704,177
48069,TX,Castro,,2010,5.4,3919,4143,224
48069,TX,Castro,,2011,5.2,3874,4086,212
48069,TX,Castro,,2012,4.3,3874,4050,176
48069,TX,Castro,,2013,4.7,3598,3777,179
48069,TX,Castro,,2014,4,3637,3790,153
48069,TX,Castro,,2015,3.4,3494,3618,124
48069,TX,Castro,,2016,3.1,3389,3497,108
48069,TX,Castro,,2017,3.3,3256,3368,112
48069,TX,Castro,,2018,2.9,3331,3430,99
48069,TX,Castro,,2019,2.8,3285,3378,93
48069,TX,Castro,,2020,3.6,3131,3249,118
48069,TX,Castro,,2021,3.5,3263,3380,117
48071,TX,Chambers,,2007,4.7,13178,13829,651
48071,TX,Chambers,,2008,5.7,13471,14288,817
48071,TX,Chambers,,2009,9.1,13996,15390,1394
48071,TX,Chambers,,2010,9.7,15013,16632,1619
48071,TX,Chambers,,2011,9.6,15194,16806,1612
48071,TX,Chambers,,2012,8,15740,17110,1370
48071,TX,Chambers,,2013,7.4,16161,17451,1290
48071,TX,Chambers,,2014,5.8,16779,17820,1041
48071,TX,Chambers,,2015,5.4,16858,17815,957
48071,TX,Chambers,,2016,6.1,17110,18221,1111
48071,TX,Chambers,,2017,6.6,17554,18785,1231
48071,TX,Chambers,,2018,5.4,18052,19088,1036
48071,TX,Chambers,,2019,4.5,18786,19674,888
48071,TX,Chambers,,2020,9.4,18316,20207,1891
48071,TX,Chambers,,2021,8.3,18967,20681,1714
48073,TX,Cherokee,,2007,4.9,19285,20271,986
48073,TX,Cherokee,,2008,5.9,19151,20351,1200
48073,TX,Cherokee,,2009,8.8,19179,21023,1844
48073,TX,Cherokee,,2010,8.9,19980,21925,1945
48073,TX,Cherokee,,2011,8.4,20340,22202,1862
48073,TX,Cherokee,,2012,7.2,20347,21925,1578
48073,TX,Cherokee,,2013,7,19991,21493,1502
48073,TX,Cherokee,,2014,5.9,19910,21153,1243
48073,TX,Cherokee,,2015,5.2,19820,20908,1088
48073,TX,Cherokee,,2016,5.1,20128,21208,1080
48073,TX,Cherokee,,2017,4.6,19682,20626,944
48073,TX,Cherokee,,2018,4.2,19839,20698,859
48073,TX,Cherokee,,2019,3.8,19975,20760,785
48073,TX,Cherokee,,2020,7.9,19316,20980,1664
48073,TX,Cherokee,,2021,6.4,19527,20864,1337
48075,TX,Childress,,2007,4.9,2864,3012,148
48075,TX,Childress,,2008,5,2901,3055,154
48075,TX,Childress,,2009,6,3107,3307,200
48075,TX,Childress,,2010,5.7,2982,3162,180
48075,TX,Childress,,2011,5.3,2916,3080,164
48075,TX,Childress,,2012,4.4,2832,2962,130
48075,TX,Childress,,2013,4.3,2804,2930,126
48075,TX,Childress,,2014,3.7,2753,2859,106
48075,TX,Childress,,2015,3.1,2780,2870,90
48075,TX,Childress,,2016,3,2872,2961,89
48075,TX,Childress,,2017,3,2802,2888,86
48075,TX,Childress,,2018,2.7,2845,2923,78
48075,TX,Childress,,2019,2.7,2844,2923,79
48075,TX,Childress,,2020,3.7,2884,2995,111
48075,TX,Childress,,2021,3.6,2903,3011,108
48077,TX,Clay,,2007,3.5,5997,6217,220
48077,TX,Clay,,2008,3.9,5807,6045,238
48077,TX,Clay,,2009,6.8,5675,6092,417
48077,TX,Clay,,2010,7.5,5129,5546,417
48077,TX,Clay,,2011,6.7,5142,5511,369
48077,TX,Clay,,2012,5.6,5011,5307,296
48077,TX,Clay,,2013,5.6,4845,5131,286
48077,TX,Clay,,2014,4.6,4780,5012,232
48077,TX,Clay,,2015,4.4,4697,4914,217
48077,TX,Clay,,2016,4.4,4587,4797,210
48077,TX,Clay,,2017,3.6,4694,4867,173
48077,TX,Clay,,2018,3.2,4722,4877,155
48077,TX,Clay,,2019,3.1,4704,4853,149
48077,TX,Clay,,2020,5.5,4508,4772,264
48077,TX,Clay,,2021,4.9,4593,4831,238
48079,TX,Cochran,,2007,5.1,1404,1479,75
48079,TX,Cochran,,2008,4.8,1431,1503,72
48079,TX,Cochran,,2009,6.4,1414,1511,97
48079,TX,Cochran,,2010,8.2,1401,1526,125
48079,TX,Cochran,,2011,8.8,1366,1497,131
48079,TX,Cochran,,2012,7.5,1335,1443,108
48079,TX,Cochran,,2013,6.7,1306,1400,94
48079,TX,Cochran,,2014,5.2,1324,1396,72
48079,TX,Cochran,,2015,5.2,1250,1318,68
48079,TX,Cochran,,2016,5,1115,1174,59
48079,TX,Cochran,,2017,4.6,1073,1125,52
48079,TX,Cochran,,2018,4.4,1041,1089,48
48079,TX,Cochran,,2019,3.4,1075,1113,38
48079,TX,Cochran,,2020,7.1,1026,1105,79
48079,TX,Cochran,,2021,6.3,1004,1072,68
48081,TX,Coke,,2007,5.7,1301,1379,78
48081,TX,Coke,,2008,7.8,1184,1284,100
48081,TX,Coke,,2009,8,1218,1324,106
48081,TX,Coke,,2010,6.1,1480,1576,96
48081,TX,Coke,,2011,5.9,1444,1534,90
48081,TX,Coke,,2012,5,1395,1469,74
48081,TX,Coke,,2013,5.1,1382,1456,74
48081,TX,Coke,,2014,4.4,1373,1436,63
48081,TX,Coke,,2015,4.1,1342,1399,57
48081,TX,Coke,,2016,4.1,1363,1422,59
48081,TX,Coke,,2017,3.7,1338,1390,52
48081,TX,Coke,,2018,3.5,1391,1441,50
48081,TX,Coke,,2019,3.3,1387,1434,47
48081,TX,Coke,,2020,5.5,1279,1353,74
48081,TX,Coke,,2021,4.8,1300,1365,65
48083,TX,Coleman,,2007,3.5,4216,4371,155
48083,TX,Coleman,,2008,4.1,4186,4365,179
48083,TX,Coleman,,2009,6.9,4092,4394,302
48083,TX,Coleman,,2010,9.1,3171,3488,317
48083,TX,Coleman,,2011,9.1,3091,3400,309
48083,TX,Coleman,,2012,7.5,3061,3308,247
48083,TX,Coleman,,2013,7.6,2912,3150,238
48083,TX,Coleman,,2014,6.2,2925,3117,192
48083,TX,Coleman,,2015,5.6,2881,3051,170
48083,TX,Coleman,,2016,5.8,2888,3067,179
48083,TX,Coleman,,2017,4.5,2908,3045,137
48083,TX,Coleman,,2018,4,2796,2911,115
48083,TX,Coleman,,2019,4.1,2711,2826,115
48083,TX,Coleman,,2020,7.3,2635,2844,209
48083,TX,Coleman,,2021,6,2761,2937,176
48085,TX,Collin,,2007,3.9,380761,396115,15354
48085,TX,Collin,,2008,4.5,387806,406181,18375
48085,TX,Collin,,2009,7.2,386087,416163,30076
48085,TX,Collin,,2010,7.3,394975,425945,30970
48085,TX,Collin,,2011,7,407778,438356,30578
48085,TX,Collin,,2012,5.9,419576,445697,26121
48085,TX,Collin,,2013,5.6,431462,456917,25455
48085,TX,Collin,,2014,4.6,451569,473402,21833
48085,TX,Collin,,2015,3.7,470919,488810,17891
48085,TX,Collin,,2016,3.5,495061,513225,18164
48085,TX,Collin,,2017,3.5,509750,528152,18402
48085,TX,Collin,,2018,3.4,527817,546135,18318
48085,TX,Collin,,2019,3.1,547629,565064,17435
48085,TX,Collin,,2020,6.3,539871,575879,36008
48085,TX,Collin,,2021,4.3,573302,599164,25862
48087,TX,Collingsworth,,2007,3.4,1483,1535,52
48087,TX,Collingsworth,,2008,3.9,1418,1476,58
48087,TX,Collingsworth,,2009,5.4,1416,1497,81
48087,TX,Collingsworth,,2010,5.6,1267,1342,75
48087,TX,Collingsworth,,2011,6,1227,1305,78
48087,TX,Collingsworth,,2012,4.9,1183,1244,61
48087,TX,Collingsworth,,2013,5.2,1151,1214,63
48087,TX,Collingsworth,,2014,4.1,1206,1258,52
48087,TX,Collingsworth,,2015,3.7,1224,1271,47
48087,TX,Collingsworth,,2016,3.5,1174,1216,42
48087,TX,Collingsworth,,2017,3.5,1116,1157,41
48087,TX,Collingsworth,,2018,3.2,1134,1171,37
48087,TX,Collingsworth,,2019,3.1,1098,1133,35
48087,TX,Collingsworth,,2020,4.2,1016,1061,45
48087,TX,Collingsworth,,2021,4.3,1043,1090,47
48089,TX,Colorado,,2007,3.6,10069,10449,380
48089,TX,Colorado,,2008,3.9,10511,10943,432
48089,TX,Colorado,,2009,6.3,10089,10773,684
48089,TX,Colorado,,2010,8.2,8824,9610,786
48089,TX,Colorado,,2011,8,9297,10107,810
48089,TX,Colorado,,2012,6.3,9517,10160,643
48089,TX,Colorado,,2013,5.8,9496,10082,586
48089,TX,Colorado,,2014,4.5,9799,10262,463
48089,TX,Colorado,,2015,4,9517,9911,394
48089,TX,Colorado,,2016,4.7,9336,9798,462
48089,TX,Colorado,,2017,4,9285,9674,389
48089,TX,Colorado,,2018,3.3,9264,9583,319
48089,TX,Colorado,,2019,3.1,9427,9729,302
48089,TX,Colorado,,2020,5.6,9070,9604,534
48089,TX,Colorado,,2021,4.8,9436,9907,471
48091,TX,Comal,,2007,3.6,50490,52398,1908
48091,TX,Comal,,2008,4.1,52505,54739,2234
48091,TX,Comal,,2009,6.1,53925,57442,3517
48091,TX,Comal,,2010,7.1,49771,53559,3788
48091,TX,Comal,,2011,7.1,50722,54600,3878
48091,TX,Comal,,2012,6,52429,55784,3355
48091,TX,Comal,,2013,6,54335,57807,3472
48091,TX,Comal,,2014,4.6,57012,59759,2747
48091,TX,Comal,,2015,3.7,59623,61914,2291
48091,TX,Comal,,2016,3.6,63146,65520,2374
48091,TX,Comal,,2017,3.4,65963,68278,2315
48091,TX,Comal,,2018,3.2,69372,71677,2305
48091,TX,Comal,,2019,3,72890,75124,2234
48091,TX,Comal,,2020,6.1,72136,76810,4674
48091,TX,Comal,,2021,4.5,75529,79105,3576
48093,TX,Comanche,,2007,3.8,6218,6466,248
48093,TX,Comanche,,2008,3.8,6286,6534,248
48093,TX,Comanche,,2009,6,6441,6853,412
48093,TX,Comanche,,2010,7.6,5575,6033,458
48093,TX,Comanche,,2011,7.7,5487,5943,456
48093,TX,Comanche,,2012,6.3,5410,5775,365
48093,TX,Comanche,,2013,5.9,5310,5643,333
48093,TX,Comanche,,2014,4.9,5258,5528,270
48093,TX,Comanche,,2015,4.3,5132,5361,229
48093,TX,Comanche,,2016,4.3,5129,5360,231
48093,TX,Comanche,,2017,3.7,5070,5266,196
48093,TX,Comanche,,2018,3.6,5129,5321,192
48093,TX,Comanche,,2019,3.2,5337,5516,179
48093,TX,Comanche,,2020,5.5,5277,5584,307
48093,TX,Comanche,,2021,4.6,5756,6032,276
48095,TX,Concho,,2007,5.1,1250,1317,67
48095,TX,Concho,,2008,5.2,1260,1329,69
48095,TX,Concho,,2009,7.1,1256,1352,96
48095,TX,Concho,,2010,5.8,1477,1568,91
48095,TX,Concho,,2011,4.8,1498,1573,75
48095,TX,Concho,,2012,4.2,1445,1508,63
48095,TX,Concho,,2013,4,1394,1452,58
48095,TX,Concho,,2014,3,1369,1412,43
48095,TX,Concho,,2015,3.3,1329,1374,45
48095,TX,Concho,,2016,3.4,1287,1332,45
48095,TX,Concho,,2017,4.2,1153,1204,51
48095,TX,Concho,,2018,3.7,1047,1087,40
48095,TX,Concho,,2019,3.1,1200,1239,39
48095,TX,Concho,,2020,4.5,1262,1321,59
48095,TX,Concho,,2021,4.2,1293,1350,57
48097,TX,Cooke,,2007,3.6,20876,21659,783
48097,TX,Cooke,,2008,3.5,21693,22478,785
48097,TX,Cooke,,2009,6.5,20465,21882,1417
48097,TX,Cooke,,2010,7.3,18137,19568,1431
48097,TX,Cooke,,2011,6.3,19077,20350,1273
48097,TX,Cooke,,2012,5,19614,20645,1031
48097,TX,Cooke,,2013,5,19414,20443,1029
48097,TX,Cooke,,2014,3.9,19711,20512,801
48097,TX,Cooke,,2015,3.7,19039,19774,735
48097,TX,Cooke,,2016,4,18171,18923,752
48097,TX,Cooke,,2017,3.6,18033,18712,679
48097,TX,Cooke,,2018,3.1,18398,18990,592
48097,TX,Cooke,,2019,2.8,19043,19596,553
48097,TX,Cooke,,2020,7.1,17756,19111,1355
48097,TX,Cooke,,2021,5,18384,19360,976
48099,TX,Coryell,,2007,6,21884,23274,1390
48099,TX,Coryell,,2008,6.3,22014,23482,1468
48099,TX,Coryell,,2009,8.2,22355,24346,1991
48099,TX,Coryell,,2010,7.5,23464,25372,1908
48099,TX,Coryell,,2011,7.9,23613,25647,2034
48099,TX,Coryell,,2012,7.3,23481,25331,1850
48099,TX,Coryell,,2013,7.2,23352,25173,1821
48099,TX,Coryell,,2014,6,23199,24690,1491
48099,TX,Coryell,,2015,4.8,23338,24516,1178
48099,TX,Coryell,,2016,4.7,23285,24428,1143
48099,TX,Coryell,,2017,4.4,23149,24218,1069
48099,TX,Coryell,,2018,4.2,22667,23667,1000
48099,TX,Coryell,,2019,4,22764,23707,943
48099,TX,Coryell,,2020,6.6,22070,23634,1564
48099,TX,Coryell,,2021,5.7,22968,24346,1378
48101,TX,Cottle,,2007,4,786,819,33
48101,TX,Cottle,,2008,4.1,796,830,34
48101,TX,Cottle,,2009,5.5,758,802,44
48101,TX,Cottle,,2010,7,622,669,47
48101,TX,Cottle,,2011,7.8,616,668,52
48101,TX,Cottle,,2012,7.4,615,664,49
48101,TX,Cottle,,2013,6.9,581,624,43
48101,TX,Cottle,,2014,6.3,567,605,38
48101,TX,Cottle,,2015,7.1,507,546,39
48101,TX,Cottle,,2016,5.1,498,525,27
48101,TX,Cottle,,2017,4.3,494,516,22
48101,TX,Cottle,,2018,4.4,503,526,23
48101,TX,Cottle,,2019,4.2,520,543,23
48101,TX,Cottle,,2020,5,536,564,28
48101,TX,Cottle,,2021,4.6,576,604,28
48103,TX,Crane,,2007,4.1,1579,1647,68
48103,TX,Crane,,2008,4.1,1635,1705,70
48103,TX,Crane,,2009,8.7,1622,1776,154
48103,TX,Crane,,2010,7.7,1682,1822,140
48103,TX,Crane,,2011,6.9,1786,1918,132
48103,TX,Crane,,2012,4.9,1956,2056,100
48103,TX,Crane,,2013,4.5,1989,2083,94
48103,TX,Crane,,2014,4.1,1922,2004,82
48103,TX,Crane,,2015,5.8,1731,1838,107
48103,TX,Crane,,2016,8.6,1560,1706,146
48103,TX,Crane,,2017,5.3,1498,1582,84
48103,TX,Crane,,2018,3.9,1695,1763,68
48103,TX,Crane,,2019,4,1486,1548,62
48103,TX,Crane,,2020,13.6,1393,1613,220
48103,TX,Crane,,2021,9.6,1470,1626,156
48105,TX,Crockett,,2007,3,2008,2070,62
48105,TX,Crockett,,2008,2.9,2143,2207,64
48105,TX,Crockett,,2009,8.5,2093,2288,195
48105,TX,Crockett,,2010,8.6,1576,1725,149
48105,TX,Crockett,,2011,6.9,1597,1715,118
48105,TX,Crockett,,2012,5,1681,1769,88
48105,TX,Crockett,,2013,5.2,1783,1880,97
48105,TX,Crockett,,2014,3.8,1856,1930,74
48105,TX,Crockett,,2015,6,1786,1901,115
48105,TX,Crockett,,2016,7.5,1606,1737,131
48105,TX,Crockett,,2017,4.1,1599,1667,68
48105,TX,Crockett,,2018,3,1570,1618,48
48105,TX,Crockett,,2019,2.9,1565,1612,47
48105,TX,Crockett,,2020,8.9,1401,1538,137
48105,TX,Crockett,,2021,6.7,1368,1467,99
48107,TX,Crosby,,2007,4.8,2514,2641,127
48107,TX,Crosby,,2008,5,2474,2603,129
48107,TX,Crosby,,2009,6.9,2410,2588,178
48107,TX,Crosby,,2010,8,2718,2955,237
48107,TX,Crosby,,2011,8.7,2744,3004,260
48107,TX,Crosby,,2012,7.1,2697,2904,207
48107,TX,Crosby,,2013,6,2596,2761,165
48107,TX,Crosby,,2014,4.8,2566,2694,128
48107,TX,Crosby,,2015,4.4,2533,2649,116
48107,TX,Crosby,,2016,4.4,2508,2623,115
48107,TX,Crosby,,2017,4.2,2421,2528,107
48107,TX,Crosby,,2018,4.7,2347,2462,115
48107,TX,Crosby,,2019,4,2333,2429,96
48107,TX,Crosby,,2020,5.3,2156,2277,121
48107,TX,Crosby,,2021,5.6,2243,2376,133
48109,TX,Culberson,,2007,2.7,1705,1753,48
48109,TX,Culberson,,2008,3,1704,1756,52
48109,TX,Culberson,,2009,3.9,1743,1814,71
48109,TX,Culberson,,2010,7.2,960,1034,74
48109,TX,Culberson,,2011,7.2,945,1018,73
48109,TX,Culberson,,2012,6,928,987,59
48109,TX,Culberson,,2013,5.1,965,1017,52
48109,TX,Culberson,,2014,4.2,969,1012,43
48109,TX,Culberson,,2015,4.2,997,1041,44
48109,TX,Culberson,,2016,4.1,959,1000,41
48109,TX,Culberson,,2017,3.7,882,916,34
48109,TX,Culberson,,2018,3.1,936,966,30
48109,TX,Culberson,,2019,4.1,986,1028,42
48109,TX,Culberson,,2020,6.6,1046,1120,74
48109,TX,Culberson,,2021,4.8,1015,1066,51
48111,TX,Dallam,,2007,2.8,3145,3236,91
48111,TX,Dallam,,2008,3,3454,3562,108
48111,TX,Dallam,,2009,4.1,3612,3768,156
48111,TX,Dallam,,2010,5.4,3677,3885,208
48111,TX,Dallam,,2011,4.5,3865,4048,183
48111,TX,Dallam,,2012,3.7,3865,4012,147
48111,TX,Dallam,,2013,3.5,3753,3890,137
48111,TX,Dallam,,2014,3,3780,3896,116
48111,TX,Dallam,,2015,2.2,3920,4008,88
48111,TX,Dallam,,2016,2.2,3912,4001,89
48111,TX,Dallam,,2017,2.2,3942,4029,87
48111,TX,Dallam,,2018,2,3919,4001,82
48111,TX,Dallam,,2019,2,3815,3892,77
48111,TX,Dallam,,2020,2.8,3606,3708,102
48111,TX,Dallam,,2021,2.6,3703,3803,100
48113,TX,Dallas,,2007,4.6,1085305,1138195,52890
48113,TX,Dallas,,2008,5.4,1080697,1142035,61338
48113,TX,Dallas,,2009,8.2,1052348,1146371,94023
48113,TX,Dallas,,2010,8.6,1092540,1195683,103143
48113,TX,Dallas,,2011,8.4,1110079,1211940,101861
48113,TX,Dallas,,2012,7.1,1133951,1220310,86359
48113,TX,Dallas,,2013,6.6,1150663,1232512,81849
48113,TX,Dallas,,2014,5.5,1180636,1249276,68640
48113,TX,Dallas,,2015,4.3,1208806,1263314,54508
48113,TX,Dallas,,2016,4,1246814,1299134,52320
48113,TX,Dallas,,2017,4,1264990,1317061,52071
48113,TX,Dallas,,2018,3.8,1273283,1323950,50667
48113,TX,Dallas,,2019,3.5,1281824,1328465,46641
48113,TX,Dallas,,2020,7.8,1219627,1322606,102979
48113,TX,Dallas,,2021,5.6,1295698,1372277,76579
48115,TX,Dawson,,2007,5.3,4812,5080,268
48115,TX,Dawson,,2008,5.3,4856,5129,273
48115,TX,Dawson,,2009,7.9,4947,5373,426
48115,TX,Dawson,,2010,7.7,4746,5143,397
48115,TX,Dawson,,2011,7.7,4817,5220,403
48115,TX,Dawson,,2012,6.4,4745,5068,323
48115,TX,Dawson,,2013,6.4,4670,4991,321
48115,TX,Dawson,,2014,4.9,4651,4892,241
48115,TX,Dawson,,2015,4.6,4556,4774,218
48115,TX,Dawson,,2016,5,4409,4643,234
48115,TX,Dawson,,2017,4.9,4372,4597,225
48115,TX,Dawson,,2018,4.3,4324,4520,196
48115,TX,Dawson,,2019,3.9,4389,4567,178
48115,TX,Dawson,,2020,8.7,4145,4541,396
48115,TX,Dawson,,2021,7,4276,4598,322
48117,TX,Deaf Smith,,2007,3.6,8397,8711,314
48117,TX,Deaf Smith,,2008,3.8,8602,8941,339
48117,TX,Deaf Smith,,2009,5.2,8689,9165,476
48117,TX,Deaf Smith,,2010,5.8,8965,9515,550
48117,TX,Deaf Smith,,2011,5.6,9081,9621,540
48117,TX,Deaf Smith,,2012,4.7,8869,9304,435
48117,TX,Deaf Smith,,2013,4.5,8726,9136,410
48117,TX,Deaf Smith,,2014,3.7,8760,9093,333
48117,TX,Deaf Smith,,2015,3.2,8518,8797,279
48117,TX,Deaf Smith,,2016,3.1,8344,8614,270
48117,TX,Deaf Smith,,2017,3.1,8032,8287,255
48117,TX,Deaf Smith,,2018,2.8,8108,8343,235
48117,TX,Deaf Smith,,2019,2.7,8106,8334,228
48117,TX,Deaf Smith,,2020,3.6,8126,8430,304
48117,TX,Deaf Smith,,2021,3.7,8429,8749,320
48119,TX,Delta,,2007,4.8,2193,2304,111
48119,TX,Delta,,2008,5.4,2175,2299,124
48119,TX,Delta,,2009,8.6,2065,2260,195
48119,TX,Delta,,2010,8,2394,2601,207
48119,TX,Delta,,2011,8.3,2412,2631,219
48119,TX,Delta,,2012,6.7,2443,2618,175
48119,TX,Delta,,2013,6.4,2463,2631,168
48119,TX,Delta,,2014,6.1,2487,2649,162
48119,TX,Delta,,2015,4.6,2476,2595,119
48119,TX,Delta,,2016,3.8,2508,2607,99
48119,TX,Delta,,2017,3.4,2443,2529,86
48119,TX,Delta,,2018,3.5,2337,2421,84
48119,TX,Delta,,2019,3.4,2330,2412,82
48119,TX,Delta,,2020,5.5,2246,2377,131
48119,TX,Delta,,2021,4.9,2324,2443,119
48121,TX,Denton,,2007,3.9,324568,337816,13248
48121,TX,Denton,,2008,4.4,329513,344843,15330
48121,TX,Denton,,2009,7.1,326721,351698,24977
48121,TX,Denton,,2010,7.1,343301,369649,26348
48121,TX,Denton,,2011,6.8,353534,379268,25734
48121,TX,Denton,,2012,5.7,365619,387634,22015
48121,TX,Denton,,2013,5.4,378005,399562,21557
48121,TX,Denton,,2014,4.5,394926,413525,18599
48121,TX,Denton,,2015,3.6,413303,428668,15365
48121,TX,Denton,,2016,3.4,436615,452147,15532
48121,TX,Denton,,2017,3.4,451897,467636,15739
48121,TX,Denton,,2018,3.2,463617,479070,15453
48121,TX,Denton,,2019,3,482704,497471,14767
48121,TX,Denton,,2020,6.4,475991,508668,32677
48121,TX,Denton,,2021,4.4,505287,528401,23114
48123,TX,DeWitt,,2007,4,8636,8994,358
48123,TX,DeWitt,,2008,4.1,8678,9053,375
48123,TX,DeWitt,,2009,7.5,8513,9203,690
48123,TX,DeWitt,,2010,7.8,8379,9089,710
48123,TX,DeWitt,,2011,6.7,8836,9467,631
48123,TX,DeWitt,,2012,4.8,9256,9718,462
48123,TX,DeWitt,,2013,4.8,9221,9682,461
48123,TX,DeWitt,,2014,3.9,9611,9999,388
48123,TX,DeWitt,,2015,4,9653,10057,404
48123,TX,DeWitt,,2016,5.5,8983,9502,519
48123,TX,DeWitt,,2017,4.4,9091,9511,420
48123,TX,DeWitt,,2018,3.2,9326,9630,304
48123,TX,DeWitt,,2019,2.6,9371,9625,254
48123,TX,DeWitt,,2020,6.1,8575,9128,553
48123,TX,DeWitt,,2021,4.8,8958,9414,456
48125,TX,Dickens,,2007,3.9,1131,1177,46
48125,TX,Dickens,,2008,5.1,945,996,51
48125,TX,Dickens,,2009,7.1,956,1029,73
48125,TX,Dickens,,2010,11.3,774,873,99
48125,TX,Dickens,,2011,15.7,769,912,143
48125,TX,Dickens,,2012,10.6,743,831,88
48125,TX,Dickens,,2013,9.4,698,770,72
48125,TX,Dickens,,2014,6.3,696,743,47
48125,TX,Dickens,,2015,4.7,670,703,33
48125,TX,Dickens,,2016,4.9,658,692,34
48125,TX,Dickens,,2017,4.9,642,675,33
48125,TX,Dickens,,2018,4.3,638,667,29
48125,TX,Dickens,,2019,4.2,638,666,28
48125,TX,Dickens,,2020,6.3,615,656,41
48125,TX,Dickens,,2021,5.1,658,693,35
48127,TX,Dimmit,,2007,6.4,3709,3961,252
48127,TX,Dimmit,,2008,6.6,3708,3970,262
48127,TX,Dimmit,,2009,10,3791,4210,419
48127,TX,Dimmit,,2010,10.6,3453,3861,408
48127,TX,Dimmit,,2011,8,4519,4911,392
48127,TX,Dimmit,,2012,5.8,5418,5751,333
48127,TX,Dimmit,,2013,5.1,6427,6769,342
48127,TX,Dimmit,,2014,3.8,7355,7648,293
48127,TX,Dimmit,,2015,4.7,6830,7164,334
48127,TX,Dimmit,,2016,7.1,5796,6242,446
48127,TX,Dimmit,,2017,5.1,6113,6441,328
48127,TX,Dimmit,,2018,3,7066,7286,220
48127,TX,Dimmit,,2019,2.5,7168,7355,187
48127,TX,Dimmit,,2020,6.4,6019,6428,409
48127,TX,Dimmit,,2021,5.7,5497,5830,333
48129,TX,Donley,,2007,4.4,1726,1806,80
48129,TX,Donley,,2008,4.3,1800,1881,81
48129,TX,Donley,,2009,5.8,1820,1932,112
48129,TX,Donley,,2010,6.9,1686,1811,125
48129,TX,Donley,,2011,6.6,1691,1811,120
48129,TX,Donley,,2012,5.9,1605,1705,100
48129,TX,Donley,,2013,5.1,1882,1984,102
48129,TX,Donley,,2014,4.9,1538,1617,79
48129,TX,Donley,,2015,4.2,1527,1594,67
48129,TX,Donley,,2016,4,1494,1557,63
48129,TX,Donley,,2017,3.7,1438,1493,55
48129,TX,Donley,,2018,3.5,1490,1544,54
48129,TX,Donley,,2019,3.4,1375,1423,48
48129,TX,Donley,,2020,4.4,1343,1405,62
48129,TX,Donley,,2021,4.1,1389,1448,59
48131,TX,Duval,,2007,5,4882,5137,255
48131,TX,Duval,,2008,5.4,4898,5176,278
48131,TX,Duval,,2009,10.9,4695,5269,574
48131,TX,Duval,,2010,11.7,4457,5047,590
48131,TX,Duval,,2011,9.7,4706,5213,507
48131,TX,Duval,,2012,7,5040,5419,379
48131,TX,Duval,,2013,6.4,5175,5531,356
48131,TX,Duval,,2014,5.6,5211,5523,312
48131,TX,Duval,,2015,8.1,4815,5241,426
48131,TX,Duval,,2016,10.9,4352,4887,535
48131,TX,Duval,,2017,7.7,4399,4768,369
48131,TX,Duval,,2018,5.3,4753,5018,265
48131,TX,Duval,,2019,4.5,4676,4894,218
48131,TX,Duval,,2020,12.2,4215,4799,584
48131,TX,Duval,,2021,8.3,5011,5463,452
48133,TX,Eastland,,2007,4.4,7770,8126,356
48133,TX,Eastland,,2008,4.5,8073,8452,379
48133,TX,Eastland,,2009,7.5,7968,8616,648
48133,TX,Eastland,,2010,8.7,7419,8124,705
48133,TX,Eastland,,2011,7.9,7751,8417,666
48133,TX,Eastland,,2012,6.6,7701,8247,546
48133,TX,Eastland,,2013,6.1,7994,8513,519
48133,TX,Eastland,,2014,4.9,7941,8351,410
48133,TX,Eastland,,2015,4.8,7658,8043,385
48133,TX,Eastland,,2016,5.5,7019,7424,405
48133,TX,Eastland,,2017,4.3,7543,7883,340
48133,TX,Eastland,,2018,3.4,8300,8589,289
48133,TX,Eastland,,2019,3.3,7972,8246,274
48133,TX,Eastland,,2020,6.7,6790,7280,490
48133,TX,Eastland,,2021,5.8,6918,7341,423
48135,TX,Ector,,2007,3.4,64365,66638,2273
48135,TX,Ector,,2008,3.4,68259,70677,2418
48135,TX,Ector,,2009,8.1,65874,71664,5790
48135,TX,Ector,,2010,8.4,62584,68321,5737
48135,TX,Ector,,2011,6.3,68142,72757,4615
48135,TX,Ector,,2012,4.6,73375,76887,3512
48135,TX,Ector,,2013,4.4,75148,78582,3434
48135,TX,Ector,,2014,3.5,79378,82249,2871
48135,TX,Ector,,2015,4.7,76071,79803,3732
48135,TX,Ector,,2016,6.4,71389,76245,4856
48135,TX,Ector,,2017,4.1,74754,77980,3226
48135,TX,Ector,,2018,2.7,82497,84807,2310
48135,TX,Ector,,2019,2.7,84942,87269,2327
48135,TX,Ector,,2020,11,73046,82119,9073
48135,TX,Ector,,2021,8.3,73816,80507,6691
48137,TX,Edwards,,2007,4,961,1001,40
48137,TX,Edwards,,2008,3.7,1004,1043,39
48137,TX,Edwards,,2009,7,1003,1079,76
48137,TX,Edwards,,2010,7.1,964,1038,74
48137,TX,Edwards,,2011,6.8,923,990,67
48137,TX,Edwards,,2012,6.4,866,925,59
48137,TX,Edwards,,2013,5.9,849,902,53
48137,TX,Edwards,,2014,4.4,828,866,38
48137,TX,Edwards,,2015,4.6,825,865,40
48137,TX,Edwards,,2016,4.6,827,867,40
48137,TX,Edwards,,2017,3.2,870,899,29
48137,TX,Edwards,,2018,2.9,850,875,25
48137,TX,Edwards,,2019,2.3,1012,1036,24
48137,TX,Edwards,,2020,3.5,1185,1228,43
48137,TX,Edwards,,2021,4.3,1210,1265,55
48139,TX,Ellis,,2007,4.4,66175,69194,3019
48139,TX,Ellis,,2008,5,66754,70283,3529
48139,TX,Ellis,,2009,7.9,65505,71140,5635
48139,TX,Ellis,,2010,8,69678,75778,6100
48139,TX,Ellis,,2011,8,70690,76840,6150
48139,TX,Ellis,,2012,6.7,71457,76603,5146
48139,TX,Ellis,,2013,6.2,72696,77521,4825
48139,TX,Ellis,,2014,5,75034,78971,3937
48139,TX,Ellis,,2015,4,77765,80979,3214
48139,TX,Ellis,,2016,3.8,81835,85025,3190
48139,TX,Ellis,,2017,3.5,84093,87143,3050
48139,TX,Ellis,,2018,3.3,86816,89815,2999
48139,TX,Ellis,,2019,3.1,90096,92979,2883
48139,TX,Ellis,,2020,6,88922,94566,5644
48139,TX,Ellis,,2021,4.5,94460,98901,4441
48141,TX,El Paso,,2007,5.9,274214,291434,17220
48141,TX,El Paso,,2008,6.2,279688,298075,18387
48141,TX,El Paso,,2009,8.8,281253,308412,27159
48141,TX,El Paso,,2010,9.2,309927,341489,31562
48141,TX,El Paso,,2011,9.8,312917,346916,33999
48141,TX,El Paso,,2012,8.5,317204,346680,29476
48141,TX,El Paso,,2013,8,318975,346619,27644
48141,TX,El Paso,,2014,6.5,321731,344136,22405
48141,TX,El Paso,,2015,5.2,323955,341782,17827
48141,TX,El Paso,,2016,5,332601,349935,17334
48141,TX,El Paso,,2017,4.7,335163,351540,16377
48141,TX,El Paso,,2018,4.3,339827,354932,15105
48141,TX,El Paso,,2019,3.8,344465,358155,13690
48141,TX,El Paso,,2020,8.3,329749,359563,29814
48141,TX,El Paso,,2021,6.2,341151,363843,22692
48143,TX,Erath,,2007,3.7,17271,17926,655
48143,TX,Erath,,2008,3.8,17940,18641,701
48143,TX,Erath,,2009,6.3,18041,19251,1210
48143,TX,Erath,,2010,6.5,19197,20527,1330
48143,TX,Erath,,2011,6.2,19377,20668,1291
48143,TX,Erath,,2012,5.5,18904,20010,1106
48143,TX,Erath,,2013,5.4,18733,19811,1078
48143,TX,Erath,,2014,4.3,19205,20070,865
48143,TX,Erath,,2015,4,19371,20168,797
48143,TX,Erath,,2016,4.1,19418,20240,822
48143,TX,Erath,,2017,3.4,19825,20532,707
48143,TX,Erath,,2018,3.1,19912,20552,640
48143,TX,Erath,,2019,3.2,19954,20604,650
48143,TX,Erath,,2020,5.7,18684,19821,1137
48143,TX,Erath,,2021,4.5,19610,20529,919
48145,TX,Falls,,2007,5.3,6442,6803,361
48145,TX,Falls,,2008,5.8,6181,6563,382
48145,TX,Falls,,2009,8.7,6108,6689,581
48145,TX,Falls,,2010,8.6,6633,7254,621
48145,TX,Falls,,2011,8.5,6571,7184,613
48145,TX,Falls,,2012,7.3,6397,6900,503
48145,TX,Falls,,2013,7.1,6283,6766,483
48145,TX,Falls,,2014,5.6,6176,6540,364
48145,TX,Falls,,2015,4.3,6181,6457,276
48145,TX,Falls,,2016,4.4,6321,6613,292
48145,TX,Falls,,2017,4.3,6317,6599,282
48145,TX,Falls,,2018,3.9,6197,6450,253
48145,TX,Falls,,2019,3.3,6196,6406,210
48145,TX,Falls,,2020,6.1,5959,6346,387
48145,TX,Falls,,2021,5.3,6226,6576,350
48147,TX,Fannin,,2007,5.2,12690,13389,699
48147,TX,Fannin,,2008,5.8,12668,13452,784
48147,TX,Fannin,,2009,8.6,12494,13666,1172
48147,TX,Fannin,,2010,8.2,14106,15368,1262
48147,TX,Fannin,,2011,8.5,13972,15275,1303
48147,TX,Fannin,,2012,7,13976,15032,1056
48147,TX,Fannin,,2013,7,14181,15254,1073
48147,TX,Fannin,,2014,5.4,14435,15257,822
48147,TX,Fannin,,2015,4.1,14746,15382,636
48147,TX,Fannin,,2016,3.8,15179,15774,595
48147,TX,Fannin,,2017,3.4,15299,15832,533
48147,TX,Fannin,,2018,3.1,15792,16299,507
48147,TX,Fannin,,2019,2.8,16673,17145,472
48147,TX,Fannin,,2020,4.7,15806,16589,783
48147,TX,Fannin,,2021,4,16478,17165,687
48149,TX,Fayette,,2007,3.2,11669,12058,389
48149,TX,Fayette,,2008,3.5,11908,12334,426
48149,TX,Fayette,,2009,5.4,11626,12296,670
48149,TX,Fayette,,2010,6.1,11305,12044,739
48149,TX,Fayette,,2011,6,11750,12495,745
48149,TX,Fayette,,2012,4.8,11895,12495,600
48149,TX,Fayette,,2013,4.5,12067,12634,567
48149,TX,Fayette,,2014,3.5,12599,13052,453
48149,TX,Fayette,,2015,3.3,12351,12778,427
48149,TX,Fayette,,2016,3.7,12039,12496,457
48149,TX,Fayette,,2017,3.2,12081,12483,402
48149,TX,Fayette,,2018,2.8,12123,12475,352
48149,TX,Fayette,,2019,2.6,11926,12248,322
48149,TX,Fayette,,2020,4.7,11124,11674,550
48149,TX,Fayette,,2021,4.3,11350,11857,507
48151,TX,Fisher,,2007,4,1895,1973,78
48151,TX,Fisher,,2008,3.8,1907,1983,76
48151,TX,Fisher,,2009,6,1905,2026,121
48151,TX,Fisher,,2010,7.1,1792,1928,136
48151,TX,Fisher,,2011,6.9,1807,1940,133
48151,TX,Fisher,,2012,5.4,1801,1903,102
48151,TX,Fisher,,2013,5.5,1779,1882,103
48151,TX,Fisher,,2014,4.6,1776,1861,85
48151,TX,Fisher,,2015,3.9,1731,1801,70
48151,TX,Fisher,,2016,4.3,1684,1760,76
48151,TX,Fisher,,2017,3.6,1630,1691,61
48151,TX,Fisher,,2018,3.2,1581,1634,53
48151,TX,Fisher,,2019,2.9,1564,1611,47
48151,TX,Fisher,,2020,4.5,1513,1584,71
48151,TX,Fisher,,2021,4.2,1538,1606,68
48153,TX,Floyd,,2007,5.3,2970,3135,165
48153,TX,Floyd,,2008,4.7,3063,3215,152
48153,TX,Floyd,,2009,6.5,3020,3230,210
48153,TX,Floyd,,2010,8,3108,3377,269
48153,TX,Floyd,,2011,7.9,3063,3327,264
48153,TX,Floyd,,2012,6.4,2986,3190,204
48153,TX,Floyd,,2013,8.9,2840,3117,277
48153,TX,Floyd,,2014,7.2,2747,2961,214
48153,TX,Floyd,,2015,5.6,2593,2746,153
48153,TX,Floyd,,2016,5,2600,2738,138
48153,TX,Floyd,,2017,5.5,2534,2681,147
48153,TX,Floyd,,2018,5.2,2507,2645,138
48153,TX,Floyd,,2019,4.4,2426,2537,111
48153,TX,Floyd,,2020,6.2,2323,2477,154
48153,TX,Floyd,,2021,5.8,2359,2503,144
48155,TX,Foard,,2007,3.8,661,687,26
48155,TX,Foard,,2008,4.2,683,713,30
48155,TX,Foard,,2009,5.7,681,722,41
48155,TX,Foard,,2010,6.8,619,664,45
48155,TX,Foard,,2011,7.6,616,667,51
48155,TX,Foard,,2012,5.8,585,621,36
48155,TX,Foard,,2013,5.2,547,577,30
48155,TX,Foard,,2014,4.3,553,578,25
48155,TX,Foard,,2015,4.2,529,552,23
48155,TX,Foard,,2016,3.7,520,540,20
48155,TX,Foard,,2017,3.6,569,590,21
48155,TX,Foard,,2018,2.9,562,579,17
48155,TX,Foard,,2019,3,556,573,17
48155,TX,Foard,,2020,4,548,571,23
48155,TX,Foard,,2021,3.4,569,589,20
48157,TX,Fort Bend,,2007,4.1,242821,253156,10335
48157,TX,Fort Bend,,2008,4.4,253918,265673,11755
48157,TX,Fort Bend,,2009,7.1,257850,277586,19736
48157,TX,Fort Bend,,2010,7.7,275718,298655,22937
48157,TX,Fort Bend,,2011,7.3,285580,308200,22620
48157,TX,Fort Bend,,2012,5.9,299516,318351,18835
48157,TX,Fort Bend,,2013,5.5,314182,332589,18407
48157,TX,Fort Bend,,2014,4.6,330674,346538,15864
48157,TX,Fort Bend,,2015,4.3,340720,356003,15283
48157,TX,Fort Bend,,2016,5,348684,367050,18366
48157,TX,Fort Bend,,2017,4.7,355381,372854,17473
48157,TX,Fort Bend,,2018,4,367535,382850,15315
48157,TX,Fort Bend,,2019,3.5,381510,395228,13718
48157,TX,Fort Bend,,2020,7.6,369972,400509,30537
48157,TX,Fort Bend,,2021,5.9,383362,407603,24241
48159,TX,Franklin,,2007,3.9,5222,5433,211
48159,TX,Franklin,,2008,4.2,5083,5307,224
48159,TX,Franklin,,2009,6.8,5109,5481,372
48159,TX,Franklin,,2010,8.7,4401,4818,417
48159,TX,Franklin,,2011,8.4,4355,4756,401
48159,TX,Franklin,,2012,7.4,4279,4619,340
48159,TX,Franklin,,2013,6.6,4373,4681,308
48159,TX,Franklin,,2014,5.2,4409,4652,243
48159,TX,Franklin,,2015,4.9,4335,4559,224
48159,TX,Franklin,,2016,4.9,4290,4512,222
48159,TX,Franklin,,2017,4.7,4299,4510,211
48159,TX,Franklin,,2018,4.2,4334,4522,188
48159,TX,Franklin,,2019,3.6,4444,4611,167
48159,TX,Franklin,,2020,5.4,4529,4785,256
48159,TX,Franklin,,2021,4.4,4994,5223,229
48161,TX,Freestone,,2007,3.7,9532,9897,365
48161,TX,Freestone,,2008,4,9794,10203,409
48161,TX,Freestone,,2009,6.3,9529,10168,639
48161,TX,Freestone,,2010,8.3,7485,8161,676
48161,TX,Freestone,,2011,8.1,7423,8077,654
48161,TX,Freestone,,2012,6.7,7504,8042,538
48161,TX,Freestone,,2013,7,7299,7845,546
48161,TX,Freestone,,2014,5.7,7387,7834,447
48161,TX,Freestone,,2015,5.5,7009,7414,405
48161,TX,Freestone,,2016,6.7,6412,6872,460
48161,TX,Freestone,,2017,6.4,6276,6706,430
48161,TX,Freestone,,2018,5.9,6107,6491,384
48161,TX,Freestone,,2019,4.8,6009,6312,303
48161,TX,Freestone,,2020,8.3,5754,6278,524
48161,TX,Freestone,,2021,7.2,5865,6323,458
48163,TX,Frio,,2007,4.9,6188,6510,322
48163,TX,Frio,,2008,5.4,6499,6869,370
48163,TX,Frio,,2009,7.4,6905,7460,555
48163,TX,Frio,,2010,7.3,7038,7595,557
48163,TX,Frio,,2011,6.7,7432,7966,534
48163,TX,Frio,,2012,5,8219,8652,433
48163,TX,Frio,,2013,4.7,8831,9268,437
48163,TX,Frio,,2014,3.6,9952,10326,374
48163,TX,Frio,,2015,3.9,9427,9806,379
48163,TX,Frio,,2016,4.9,8355,8783,428
48163,TX,Frio,,2017,4,8925,9294,369
48163,TX,Frio,,2018,2.9,9799,10089,290
48163,TX,Frio,,2019,2.6,10039,10310,271
48163,TX,Frio,,2020,5.7,8930,9467,537
48163,TX,Frio,,2021,4.8,8944,9396,452
48165,TX,Gaines,,2007,3.8,6162,6403,241
48165,TX,Gaines,,2008,3.9,6539,6801,262
48165,TX,Gaines,,2009,6.3,6620,7062,442
48165,TX,Gaines,,2010,6,7471,7945,474
48165,TX,Gaines,,2011,5.2,8051,8497,446
48165,TX,Gaines,,2012,4.2,8395,8765,370
48165,TX,Gaines,,2013,4.2,8522,8896,374
48165,TX,Gaines,,2014,3.3,9042,9351,309
48165,TX,Gaines,,2015,3.3,9101,9408,307
48165,TX,Gaines,,2016,3.7,8844,9187,343
48165,TX,Gaines,,2017,3.1,8898,9179,281
48165,TX,Gaines,,2018,2.6,9094,9335,241
48165,TX,Gaines,,2019,2.4,9522,9759,237
48165,TX,Gaines,,2020,5.6,9101,9644,543
48165,TX,Gaines,,2021,4.6,9300,9748,448
48167,TX,Galveston,,2007,4.6,131734,138157,6423
48167,TX,Galveston,,2008,5.7,133953,141992,8039
48167,TX,Galveston,,2009,8.2,129344,140873,11529
48167,TX,Galveston,,2010,9.2,133996,147531,13535
48167,TX,Galveston,,2011,9.1,136198,149843,13645
48167,TX,Galveston,,2012,7.6,141167,152764,11597
48167,TX,Galveston,,2013,6.9,144677,155443,10766
48167,TX,Galveston,,2014,5.7,148465,157411,8946
48167,TX,Galveston,,2015,5,150077,158012,7935
48167,TX,Galveston,,2016,5.3,151625,160171,8546
48167,TX,Galveston,,2017,5.3,152262,160784,8522
48167,TX,Galveston,,2018,4.7,154144,161696,7552
48167,TX,Galveston,,2019,4.1,157262,163900,6638
48167,TX,Galveston,,2020,8.8,148692,162980,14288
48167,TX,Galveston,,2021,6.7,154065,165052,10987
48169,TX,Garza,,2007,3.4,2342,2425,83
48169,TX,Garza,,2008,3.8,2312,2404,92
48169,TX,Garza,,2009,5.2,2337,2464,127
48169,TX,Garza,,2010,5.9,2019,2146,127
48169,TX,Garza,,2011,6.2,2084,2222,138
48169,TX,Garza,,2012,4.9,2082,2189,107
48169,TX,Garza,,2013,4.6,2131,2233,102
48169,TX,Garza,,2014,3.7,2157,2239,82
48169,TX,Garza,,2015,3.7,2053,2132,79
48169,TX,Garza,,2016,3.9,2048,2131,83
48169,TX,Garza,,2017,3.3,2035,2105,70
48169,TX,Garza,,2018,2.9,2053,2115,62
48169,TX,Garza,,2019,2.6,2056,2111,55
48169,TX,Garza,,2020,6.8,1859,1995,136
48169,TX,Garza,,2021,5,1888,1988,100
48171,TX,Gillespie,,2007,2.8,12547,12910,363
48171,TX,Gillespie,,2008,3.1,12793,13199,406
48171,TX,Gillespie,,2009,4.4,13122,13731,609
48171,TX,Gillespie,,2010,5.5,11544,12214,670
48171,TX,Gillespie,,2011,5.5,11748,12431,683
48171,TX,Gillespie,,2012,4.7,11728,12302,574
48171,TX,Gillespie,,2013,4.4,11849,12399,550
48171,TX,Gillespie,,2014,3.6,12053,12499,446
48171,TX,Gillespie,,2015,2.9,12280,12647,367
48171,TX,Gillespie,,2016,2.8,12631,13001,370
48171,TX,Gillespie,,2017,2.6,12695,13036,341
48171,TX,Gillespie,,2018,2.6,12910,13249,339
48171,TX,Gillespie,,2019,2.4,13069,13396,327
48171,TX,Gillespie,,2020,4.8,12527,13152,625
48171,TX,Gillespie,,2021,3.3,13478,13939,461
48173,TX,Glasscock,,2007,3.5,579,600,21
48173,TX,Glasscock,,2008,3.8,606,630,24
48173,TX,Glasscock,,2009,4.6,624,654,30
48173,TX,Glasscock,,2010,5,670,705,35
48173,TX,Glasscock,,2011,4.4,713,746,33
48173,TX,Glasscock,,2012,3.9,731,761,30
48173,TX,Glasscock,,2013,3.6,715,742,27
48173,TX,Glasscock,,2014,2.7,806,828,22
48173,TX,Glasscock,,2015,2.8,799,822,23
48173,TX,Glasscock,,2016,3.9,720,749,29
48173,TX,Glasscock,,2017,2.7,685,704,19
48173,TX,Glasscock,,2018,2.1,826,844,18
48173,TX,Glasscock,,2019,2.2,772,789,17
48173,TX,Glasscock,,2020,3.6,769,798,29
48173,TX,Glasscock,,2021,2.9,791,815,24
48175,TX,Goliad,,2007,3.8,3310,3442,132
48175,TX,Goliad,,2008,3.7,3339,3469,130
48175,TX,Goliad,,2009,6.9,3160,3393,233
48175,TX,Goliad,,2010,7.4,3111,3361,250
48175,TX,Goliad,,2011,6.7,3148,3374,226
48175,TX,Goliad,,2012,5.5,3282,3472,190
48175,TX,Goliad,,2013,5.2,3345,3530,185
48175,TX,Goliad,,2014,4.2,3418,3566,148
48175,TX,Goliad,,2015,4.5,3295,3449,154
48175,TX,Goliad,,2016,5.8,3127,3320,193
48175,TX,Goliad,,2017,5,3091,3252,161
48175,TX,Goliad,,2018,3.8,3126,3251,125
48175,TX,Goliad,,2019,3.4,3121,3230,109
48175,TX,Goliad,,2020,7.8,2865,3107,242
48175,TX,Goliad,,2021,6.6,2946,3153,207
48177,TX,Gonzales,,2007,3.9,9313,9687,374
48177,TX,Gonzales,,2008,3.9,9368,9751,383
48177,TX,Gonzales,,2009,5.5,9598,10155,557
48177,TX,Gonzales,,2010,6.8,8678,9316,638
48177,TX,Gonzales,,2011,6.3,8864,9465,601
48177,TX,Gonzales,,2012,5,8959,9435,476
48177,TX,Gonzales,,2013,5.2,9007,9497,490
48177,TX,Gonzales,,2014,3.9,9534,9922,388
48177,TX,Gonzales,,2015,3.7,9344,9703,359
48177,TX,Gonzales,,2016,4.2,9168,9574,406
48177,TX,Gonzales,,2017,3.5,8976,9303,327
48177,TX,Gonzales,,2018,3.1,9106,9393,287
48177,TX,Gonzales,,2019,2.7,9225,9481,256
48177,TX,Gonzales,,2020,5.4,8931,9442,511
48177,TX,Gonzales,,2021,4.3,9184,9594,410
48179,TX,Gray,,2007,3.4,10779,11161,382
48179,TX,Gray,,2008,3.5,10982,11378,396
48179,TX,Gray,,2009,8.1,10396,11309,913
48179,TX,Gray,,2010,8.7,8493,9299,806
48179,TX,Gray,,2011,7.1,8951,9631,680
48179,TX,Gray,,2012,5.6,9137,9678,541
48179,TX,Gray,,2013,5.2,9259,9766,507
48179,TX,Gray,,2014,4.1,9374,9772,398
48179,TX,Gray,,2015,5.7,8754,9279,525
48179,TX,Gray,,2016,6.9,7903,8489,586
48179,TX,Gray,,2017,5.3,7741,8173,432
48179,TX,Gray,,2018,3.9,7733,8048,315
48179,TX,Gray,,2019,3.6,7667,7951,284
48179,TX,Gray,,2020,8.1,7079,7705,626
48179,TX,Gray,,2021,6.7,7169,7681,512
48181,TX,Grayson,,2007,4.7,52701,55276,2575
48181,TX,Grayson,,2008,5.2,52723,55599,2876
48181,TX,Grayson,,2009,7.9,52423,56932,4509
48181,TX,Grayson,,2010,8.2,54673,59571,4898
48181,TX,Grayson,,2011,8.1,55262,60151,4889
48181,TX,Grayson,,2012,6.8,55801,59875,4074
48181,TX,Grayson,,2013,6.3,56592,60405,3813
48181,TX,Grayson,,2014,4.9,57302,60269,2967
48181,TX,Grayson,,2015,4.1,57580,60020,2440
48181,TX,Grayson,,2016,3.9,58868,61232,2364
48181,TX,Grayson,,2017,3.6,59282,61482,2200
48181,TX,Grayson,,2018,3.3,60581,62655,2074
48181,TX,Grayson,,2019,3.1,61559,63512,1953
48181,TX,Grayson,,2020,5.9,59830,63568,3738
48181,TX,Grayson,,2021,4.6,62721,65711,2990
48183,TX,Gregg,,2007,3.8,60037,62433,2396
48183,TX,Gregg,,2008,4,61483,64029,2546
48183,TX,Gregg,,2009,7.1,60569,65181,4612
48183,TX,Gregg,,2010,8,55621,60467,4846
48183,TX,Gregg,,2011,7.4,56543,61052,4509
48183,TX,Gregg,,2012,6.2,57708,61496,3788
48183,TX,Gregg,,2013,6,57749,61434,3685
48183,TX,Gregg,,2014,4.9,58055,61065,3010
48183,TX,Gregg,,2015,5,56347,59308,2961
48183,TX,Gregg,,2016,6.1,54826,58383,3557
48183,TX,Gregg,,2017,5.2,54016,56982,2966
48183,TX,Gregg,,2018,4.2,54558,56926,2368
48183,TX,Gregg,,2019,3.8,55227,57381,2154
48183,TX,Gregg,,2020,8.3,51319,55968,4649
48183,TX,Gregg,,2021,6.5,52563,56193,3630
48185,TX,Grimes,,2007,4.7,9965,10455,490
48185,TX,Grimes,,2008,5.1,10283,10841,558
48185,TX,Grimes,,2009,8.5,10587,11576,989
48185,TX,Grimes,,2010,9,10322,11349,1027
48185,TX,Grimes,,2011,8.1,10681,11622,941
48185,TX,Grimes,,2012,6.4,11032,11788,756
48185,TX,Grimes,,2013,6.1,11082,11796,714
48185,TX,Grimes,,2014,4.8,11236,11807,571
48185,TX,Grimes,,2015,5.4,10900,11517,617
48185,TX,Grimes,,2016,6.6,10326,11058,732
48185,TX,Grimes,,2017,5.4,10222,10805,583
48185,TX,Grimes,,2018,4.2,10549,11006,457
48185,TX,Grimes,,2019,4,10677,11121,444
48185,TX,Grimes,,2020,8.1,10118,11007,889
48185,TX,Grimes,,2021,6.7,10386,11133,747
48187,TX,Guadalupe,,2007,3.8,53356,55481,2125
48187,TX,Guadalupe,,2008,4.3,55309,57789,2480
48187,TX,Guadalupe,,2009,6.4,56356,60210,3854
48187,TX,Guadalupe,,2010,6.8,60619,65009,4390
48187,TX,Guadalupe,,2011,6.7,62243,66706,4463
48187,TX,Guadalupe,,2012,5.6,64306,68150,3844
48187,TX,Guadalupe,,2013,5.5,66086,69954,3868
48187,TX,Guadalupe,,2014,4.4,68337,71470,3133
48187,TX,Guadalupe,,2015,3.6,70371,72967,2596
48187,TX,Guadalupe,,2016,3.6,73263,75992,2729
48187,TX,Guadalupe,,2017,3.4,75236,77854,2618
48187,TX,Guadalupe,,2018,3.2,77009,79524,2515
48187,TX,Guadalupe,,2019,3,78431,80826,2395
48187,TX,Guadalupe,,2020,6.1,75248,80164,4916
48187,TX,Guadalupe,,2021,4.4,78557,82209,3652
48189,TX,Hale,,2007,4.7,15456,16222,766
48189,TX,Hale,,2008,4.5,16018,16771,753
48189,TX,Hale,,2009,6,16328,17371,1043
48189,TX,Hale,,2010,7.4,14996,16201,1205
48189,TX,Hale,,2011,7.7,14976,16230,1254
48189,TX,Hale,,2012,6.9,14735,15822,1087
48189,TX,Hale,,2013,13.4,12811,14791,1980
48189,TX,Hale,,2014,9.5,12229,13514,1285
48189,TX,Hale,,2015,6.4,12069,12894,825
48189,TX,Hale,,2016,5.6,11887,12596,709
48189,TX,Hale,,2017,5.2,11781,12422,641
48189,TX,Hale,,2018,4.8,11776,12372,596
48189,TX,Hale,,2019,4.5,11504,12041,537
48189,TX,Hale,,2020,6.8,10850,11636,786
48189,TX,Hale,,2021,6.1,11191,11915,724
48191,TX,Hall,,2007,5.4,1324,1400,76
48191,TX,Hall,,2008,5.6,1358,1438,80
48191,TX,Hall,,2009,8.2,1346,1466,120
48191,TX,Hall,,2010,9.1,1293,1423,130
48191,TX,Hall,,2011,8.9,1275,1400,125
48191,TX,Hall,,2012,7.8,1236,1340,104
48191,TX,Hall,,2013,7.1,1196,1288,92
48191,TX,Hall,,2014,6.3,1182,1262,80
48191,TX,Hall,,2015,5.4,1139,1204,65
48191,TX,Hall,,2016,6.7,1088,1166,78
48191,TX,Hall,,2017,6.2,1052,1121,69
48191,TX,Hall,,2018,4.5,1050,1099,49
48191,TX,Hall,,2019,4.2,1012,1056,44
48191,TX,Hall,,2020,5.8,996,1057,61
48191,TX,Hall,,2021,5.4,1028,1087,59
48193,TX,Hamilton,,2007,3.6,3883,4026,143
48193,TX,Hamilton,,2008,3.6,4110,4263,153
48193,TX,Hamilton,,2009,5.6,4121,4365,244
48193,TX,Hamilton,,2010,6.8,3675,3945,270
48193,TX,Hamilton,,2011,6.6,3622,3876,254
48193,TX,Hamilton,,2012,5.8,3525,3742,217
48193,TX,Hamilton,,2013,6,3397,3615,218
48193,TX,Hamilton,,2014,4.7,3395,3562,167
48193,TX,Hamilton,,2015,4.7,3321,3485,164
48193,TX,Hamilton,,2016,4.9,3425,3602,177
48193,TX,Hamilton,,2017,4,3452,3595,143
48193,TX,Hamilton,,2018,3.3,3480,3599,119
48193,TX,Hamilton,,2019,3,3527,3635,108
48193,TX,Hamilton,,2020,4.6,3540,3709,169
48193,TX,Hamilton,,2021,4.1,3638,3792,154
48195,TX,Hansford,,2007,3.1,2430,2507,77
48195,TX,Hansford,,2008,3.2,2563,2649,86
48195,TX,Hansford,,2009,5.2,2647,2793,146
48195,TX,Hansford,,2010,4.4,2902,3034,132
48195,TX,Hansford,,2011,4.2,2913,3041,128
48195,TX,Hansford,,2012,3.4,2945,3048,103
48195,TX,Hansford,,2013,3.3,3019,3122,103
48195,TX,Hansford,,2014,2.6,3153,3236,83
48195,TX,Hansford,,2015,3,3020,3113,93
48195,TX,Hansford,,2016,3.1,2854,2946,92
48195,TX,Hansford,,2017,2.6,2767,2840,73
48195,TX,Hansford,,2018,2.3,2760,2826,66
48195,TX,Hansford,,2019,2.4,2670,2735,65
48195,TX,Hansford,,2020,3.5,2373,2459,86
48195,TX,Hansford,,2021,3,2474,2551,77
48197,TX,Hardeman,,2007,3.6,2238,2322,84
48197,TX,Hardeman,,2008,3.6,2248,2331,83
48197,TX,Hardeman,,2009,7.3,2104,2269,165
48197,TX,Hardeman,,2010,8.4,1781,1944,163
48197,TX,Hardeman,,2011,7.3,1737,1874,137
48197,TX,Hardeman,,2012,5.9,1656,1759,103
48197,TX,Hardeman,,2013,5.8,1596,1695,99
48197,TX,Hardeman,,2014,5,1564,1646,82
48197,TX,Hardeman,,2015,4.9,1541,1621,80
48197,TX,Hardeman,,2016,3.9,1561,1625,64
48197,TX,Hardeman,,2017,4,1580,1646,66
48197,TX,Hardeman,,2018,3.6,1601,1661,60
48197,TX,Hardeman,,2019,3,1649,1700,51
48197,TX,Hardeman,,2020,4.4,1618,1692,74
48197,TX,Hardeman,,2021,4.3,1648,1722,74
48199,TX,Hardin,,2007,4.7,24545,25749,1204
48199,TX,Hardin,,2008,5.3,24771,26159,1388
48199,TX,Hardin,,2009,8.5,24975,27295,2320
48199,TX,Hardin,,2010,10,23305,25901,2596
48199,TX,Hardin,,2011,9.9,23691,26284,2593
48199,TX,Hardin,,2012,8.4,23653,25822,2169
48199,TX,Hardin,,2013,8.1,23208,25255,2047
48199,TX,Hardin,,2014,6.4,23751,25363,1612
48199,TX,Hardin,,2015,5.7,23581,25002,1421
48199,TX,Hardin,,2016,6.1,23636,25170,1534
48199,TX,Hardin,,2017,6.2,23566,25119,1553
48199,TX,Hardin,,2018,5.2,23836,25149,1313
48199,TX,Hardin,,2019,4.6,24120,25272,1152
48199,TX,Hardin,,2020,8.9,22819,25055,2236
48199,TX,Hardin,,2021,8,22791,24760,1969
48201,TX,Harris,,2007,4.3,1817793,1899745,81952
48201,TX,Harris,,2008,4.7,1843580,1935331,91751
48201,TX,Harris,,2009,7.5,1827894,1976914,149020
48201,TX,Harris,,2010,8.3,1894670,2067209,172539
48201,TX,Harris,,2011,8.1,1938837,2109727,170890
48201,TX,Harris,,2012,6.6,2009784,2151642,141858
48201,TX,Harris,,2013,6.1,2061042,2194931,133889
48201,TX,Harris,,2014,5.1,2114484,2226977,112493
48201,TX,Harris,,2015,4.7,2130793,2235393,104600
48201,TX,Harris,,2016,5.3,2131125,2251316,120191
48201,TX,Harris,,2017,5.1,2134095,2249040,114945
48201,TX,Harris,,2018,4.4,2164048,2264623,100575
48201,TX,Harris,,2019,3.9,2186363,2274172,87809
48201,TX,Harris,,2020,9,2060208,2263260,203052
48201,TX,Harris,,2021,6.5,2136470,2283959,147489
48203,TX,Harrison,,2007,4.5,30649,32091,1442
48203,TX,Harrison,,2008,4.7,30836,32342,1506
48203,TX,Harrison,,2009,8.1,30228,32909,2681
48203,TX,Harrison,,2010,9.4,27961,30878,2917
48203,TX,Harrison,,2011,8.8,28758,31536,2778
48203,TX,Harrison,,2012,7.4,29549,31902,2353
48203,TX,Harrison,,2013,6.9,30032,32263,2231
48203,TX,Harrison,,2014,5.6,30358,32151,1793
48203,TX,Harrison,,2015,5.3,29575,31217,1642
48203,TX,Harrison,,2016,6,28159,29961,1802
48203,TX,Harrison,,2017,5.3,27707,29247,1540
48203,TX,Harrison,,2018,4.4,28343,29642,1299
48203,TX,Harrison,,2019,4,27919,29083,1164
48203,TX,Harrison,,2020,7.9,26551,28818,2267
48203,TX,Harrison,,2021,6.6,26757,28650,1893
48205,TX,Hartley,,2007,3.3,2214,2289,75
48205,TX,Hartley,,2008,3.3,2369,2450,81
48205,TX,Hartley,,2009,4,2373,2473,100
48205,TX,Hartley,,2010,4.2,2586,2698,112
48205,TX,Hartley,,2011,4.1,2694,2809,115
48205,TX,Hartley,,2012,3.3,2800,2896,96
48205,TX,Hartley,,2013,3.2,2833,2926,93
48205,TX,Hartley,,2014,2.6,2822,2896,74
48205,TX,Hartley,,2015,2.1,2940,3004,64
48205,TX,Hartley,,2016,2,2901,2961,60
48205,TX,Hartley,,2017,2,2861,2919,58
48205,TX,Hartley,,2018,1.8,2783,2835,52
48205,TX,Hartley,,2019,1.7,2720,2766,46
48205,TX,Hartley,,2020,2,2543,2594,51
48205,TX,Hartley,,2021,2.1,2676,2733,57
48207,TX,Haskell,,2007,3.6,2947,3056,109
48207,TX,Haskell,,2008,3.2,3152,3257,105
48207,TX,Haskell,,2009,5,3085,3249,164
48207,TX,Haskell,,2010,5.5,2834,2998,164
48207,TX,Haskell,,2011,5.5,2867,3035,168
48207,TX,Haskell,,2012,5.3,2622,2768,146
48207,TX,Haskell,,2013,5,2572,2707,135
48207,TX,Haskell,,2014,4,2583,2690,107
48207,TX,Haskell,,2015,3.5,2492,2583,91
48207,TX,Haskell,,2016,4.2,2403,2509,106
48207,TX,Haskell,,2017,4.8,2303,2420,117
48207,TX,Haskell,,2018,3.9,2242,2333,91
48207,TX,Haskell,,2019,3.3,2154,2227,73
48207,TX,Haskell,,2020,4.3,2537,2650,113
48207,TX,Haskell,,2021,3.9,2632,2740,108
48209,TX,Hays,,2007,3.8,70529,73294,2765
48209,TX,Hays,,2008,4.3,73382,76680,3298
48209,TX,Hays,,2009,6.6,73980,79174,5194
48209,TX,Hays,,2010,7.1,74809,80494,5685
48209,TX,Hays,,2011,6.9,77502,83264,5762
48209,TX,Hays,,2012,5.8,80647,85610,4963
48209,TX,Hays,,2013,5.4,84890,89718,4828
48209,TX,Hays,,2014,4.3,89833,93897,4064
48209,TX,Hays,,2015,3.5,95094,98497,3403
48209,TX,Hays,,2016,3.3,101416,104921,3505
48209,TX,Hays,,2017,3.2,106395,109885,3490
48209,TX,Hays,,2018,3,111627,115055,3428
48209,TX,Hays,,2019,2.8,116098,119428,3330
48209,TX,Hays,,2020,6.3,114991,122675,7684
48209,TX,Hays,,2021,4.1,124271,129600,5329
48211,TX,Hemphill,,2007,2.1,2592,2648,56
48211,TX,Hemphill,,2008,1.9,3085,3144,59
48211,TX,Hemphill,,2009,3.4,2535,2625,90
48211,TX,Hemphill,,2010,3.9,2048,2132,84
48211,TX,Hemphill,,2011,3.6,2300,2386,86
48211,TX,Hemphill,,2012,2.9,2468,2542,74
48211,TX,Hemphill,,2013,3,2395,2470,75
48211,TX,Hemphill,,2014,2.4,2479,2540,61
48211,TX,Hemphill,,2015,3.2,2229,2302,73
48211,TX,Hemphill,,2016,3.7,2036,2115,79
48211,TX,Hemphill,,2017,2.5,2240,2298,58
48211,TX,Hemphill,,2018,2.1,2180,2227,47
48211,TX,Hemphill,,2019,2.6,1929,1981,52
48211,TX,Hemphill,,2020,4.6,1699,1780,81
48211,TX,Hemphill,,2021,4.3,1564,1635,71
48213,TX,Henderson,,2007,4.5,32639,34173,1534
48213,TX,Henderson,,2008,5.3,32765,34594,1829
48213,TX,Henderson,,2009,8,32405,35235,2830
48213,TX,Henderson,,2010,8.9,31722,34802,3080
48213,TX,Henderson,,2011,8.8,31967,35046,3079
48213,TX,Henderson,,2012,7.5,31868,34462,2594
48213,TX,Henderson,,2013,7.2,32023,34496,2473
48213,TX,Henderson,,2014,5.7,32729,34692,1963
48213,TX,Henderson,,2015,4.9,32700,34384,1684
48213,TX,Henderson,,2016,4.7,33741,35398,1657
48213,TX,Henderson,,2017,4.2,33885,35374,1489
48213,TX,Henderson,,2018,3.8,34436,35797,1361
48213,TX,Henderson,,2019,3.5,34931,36201,1270
48213,TX,Henderson,,2020,6.4,34432,36798,2366
48213,TX,Henderson,,2021,5.1,36240,38202,1962
48215,TX,Hidalgo,,2007,6.6,254009,272038,18029
48215,TX,Hidalgo,,2008,7.2,262352,282708,20356
48215,TX,Hidalgo,,2009,10.5,266261,297367,31106
48215,TX,Hidalgo,,2010,11.8,281155,318793,37638
48215,TX,Hidalgo,,2011,11.9,287651,326643,38992
48215,TX,Hidalgo,,2012,10.5,292711,327192,34481
48215,TX,Hidalgo,,2013,10.4,296229,330700,34471
48215,TX,Hidalgo,,2014,8.9,302287,331733,29446
48215,TX,Hidalgo,,2015,8,304695,331119,26424
48215,TX,Hidalgo,,2016,7.8,310858,337251,26393
48215,TX,Hidalgo,,2017,7.5,314913,340521,25608
48215,TX,Hidalgo,,2018,6.6,321529,344391,22862
48215,TX,Hidalgo,,2019,6.3,325960,347774,21814
48215,TX,Hidalgo,,2020,11.7,315643,357301,41658
48215,TX,Hidalgo,,2021,9.3,332109,366220,34111
48217,TX,Hill,,2007,4.7,14651,15377,726
48217,TX,Hill,,2008,5,15167,15964,797
48217,TX,Hill,,2009,7.8,15183,16466,1283
48217,TX,Hill,,2010,8.4,14618,15962,1344
48217,TX,Hill,,2011,8.5,14537,15887,1350
48217,TX,Hill,,2012,6.9,14681,15766,1085
48217,TX,Hill,,2013,6.5,14908,15940,1032
48217,TX,Hill,,2014,5.3,15013,15860,847
48217,TX,Hill,,2015,4.6,14907,15623,716
48217,TX,Hill,,2016,4.4,15114,15812,698
48217,TX,Hill,,2017,4,15412,16049,637
48217,TX,Hill,,2018,3.7,15540,16131,591
48217,TX,Hill,,2019,3.3,15663,16202,539
48217,TX,Hill,,2020,6.3,15133,16151,1018
48217,TX,Hill,,2021,5,15980,16822,842
48219,TX,Hockley,,2007,3.7,10968,11384,416
48219,TX,Hockley,,2008,3.7,11504,11948,444
48219,TX,Hockley,,2009,6.7,11411,12231,820
48219,TX,Hockley,,2010,7.1,10261,11046,785
48219,TX,Hockley,,2011,6.6,10607,11352,745
48219,TX,Hockley,,2012,5.3,11145,11764,619
48219,TX,Hockley,,2013,5.1,11297,11900,603
48219,TX,Hockley,,2014,3.9,11599,12071,472
48219,TX,Hockley,,2015,4.2,11232,11723,491
48219,TX,Hockley,,2016,4.7,10656,11176,520
48219,TX,Hockley,,2017,3.7,10759,11177,418
48219,TX,Hockley,,2018,3.1,10969,11323,354
48219,TX,Hockley,,2019,3,10806,11135,329
48219,TX,Hockley,,2020,8,9741,10583,842
48219,TX,Hockley,,2021,6,10015,10657,642
48221,TX,Hood,,2007,4.2,22802,23791,989
48221,TX,Hood,,2008,4.2,24209,25272,1063
48221,TX,Hood,,2009,7.2,24416,26304,1888
48221,TX,Hood,,2010,8.6,21384,23390,2006
48221,TX,Hood,,2011,8.2,21683,23621,1938
48221,TX,Hood,,2012,6.5,22188,23725,1537
48221,TX,Hood,,2013,6.1,22504,23967,1463
48221,TX,Hood,,2014,5,23014,24223,1209
48221,TX,Hood,,2015,4.5,23431,24547,1116
48221,TX,Hood,,2016,4.7,24086,25276,1190
48221,TX,Hood,,2017,4.2,24640,25731,1091
48221,TX,Hood,,2018,3.7,25797,26793,996
48221,TX,Hood,,2019,3.4,26487,27423,936
48221,TX,Hood,,2020,6.6,25945,27778,1833
48221,TX,Hood,,2021,5.2,27325,28814,1489
48223,TX,Hopkins,,2007,3.9,16300,16958,658
48223,TX,Hopkins,,2008,4.1,16833,17558,725
48223,TX,Hopkins,,2009,6,16796,17877,1081
48223,TX,Hopkins,,2010,7.5,15401,16647,1246
48223,TX,Hopkins,,2011,7.6,15575,16853,1278
48223,TX,Hopkins,,2012,6.4,15949,17045,1096
48223,TX,Hopkins,,2013,5.8,16238,17239,1001
48223,TX,Hopkins,,2014,4.8,16635,17465,830
48223,TX,Hopkins,,2015,4.2,16298,17019,721
48223,TX,Hopkins,,2016,4,16639,17331,692
48223,TX,Hopkins,,2017,3.6,16423,17041,618
48223,TX,Hopkins,,2018,3.4,16571,17155,584
48223,TX,Hopkins,,2019,3.1,16805,17336,531
48223,TX,Hopkins,,2020,5.1,16449,17334,885
48223,TX,Hopkins,,2021,4.3,17055,17828,773
48225,TX,Houston,,2007,5.9,7395,7862,467
48225,TX,Houston,,2008,6.5,7463,7979,516
48225,TX,Houston,,2009,9.1,7486,8236,750
48225,TX,Houston,,2010,7.7,9739,10552,813
48225,TX,Houston,,2011,8,9799,10651,852
48225,TX,Houston,,2012,7,9347,10052,705
48225,TX,Houston,,2013,6.3,9215,9830,615
48225,TX,Houston,,2014,5,9297,9788,491
48225,TX,Houston,,2015,4.5,9495,9941,446
48225,TX,Houston,,2016,4.6,9602,10067,465
48225,TX,Houston,,2017,4.4,9859,10310,451
48225,TX,Houston,,2018,3.8,9723,10103,380
48225,TX,Houston,,2019,3.1,9840,10158,318
48225,TX,Houston,,2020,5.2,9477,10001,524
48225,TX,Houston,,2021,4.8,10068,10581,513
48227,TX,Howard,,2007,4.1,13318,13892,574
48227,TX,Howard,,2008,4.6,13349,13989,640
48227,TX,Howard,,2009,7.3,13323,14367,1044
48227,TX,Howard,,2010,7.2,12287,13244,957
48227,TX,Howard,,2011,6.7,12351,13245,894
48227,TX,Howard,,2012,5.6,12625,13370,745
48227,TX,Howard,,2013,5.4,12807,13543,736
48227,TX,Howard,,2014,4.4,12969,13571,602
48227,TX,Howard,,2015,4.6,12742,13362,620
48227,TX,Howard,,2016,5.5,12486,13218,732
48227,TX,Howard,,2017,4.3,12558,13122,564
48227,TX,Howard,,2018,3.3,13018,13465,447
48227,TX,Howard,,2019,3.1,13427,13856,429
48227,TX,Howard,,2020,8.1,12257,13341,1084
48227,TX,Howard,,2021,6.5,12390,13256,866
48229,TX,Hudspeth,,2007,5.1,1449,1527,78
48229,TX,Hudspeth,,2008,4,1531,1594,63
48229,TX,Hudspeth,,2009,5.4,1631,1724,93
48229,TX,Hudspeth,,2010,8,1302,1415,113
48229,TX,Hudspeth,,2011,8.4,1272,1388,116
48229,TX,Hudspeth,,2012,7.4,1225,1323,98
48229,TX,Hudspeth,,2013,7,1201,1292,91
48229,TX,Hudspeth,,2014,6.4,1170,1250,80
48229,TX,Hudspeth,,2015,5.7,1209,1282,73
48229,TX,Hudspeth,,2016,6,1450,1542,92
48229,TX,Hudspeth,,2017,5.8,1556,1652,96
48229,TX,Hudspeth,,2018,4.6,1703,1785,82
48229,TX,Hudspeth,,2019,4.3,1760,1840,80
48229,TX,Hudspeth,,2020,8.1,1685,1834,149
48229,TX,Hudspeth,,2021,5.8,1742,1849,107
48231,TX,Hunt,,2007,4.7,35891,37645,1754
48231,TX,Hunt,,2008,5.3,34993,36966,1973
48231,TX,Hunt,,2009,8.2,33546,36524,2978
48231,TX,Hunt,,2010,9,34765,38184,3419
48231,TX,Hunt,,2011,9.1,34930,38438,3508
48231,TX,Hunt,,2012,8.2,35173,38327,3154
48231,TX,Hunt,,2013,7.5,35251,38109,2858
48231,TX,Hunt,,2014,6,36214,38523,2309
48231,TX,Hunt,,2015,4.8,37071,38927,1856
48231,TX,Hunt,,2016,4.3,38793,40532,1739
48231,TX,Hunt,,2017,4,39423,41075,1652
48231,TX,Hunt,,2018,3.8,40480,42095,1615
48231,TX,Hunt,,2019,3.6,41663,43208,1545
48231,TX,Hunt,,2020,6.6,40114,42940,2826
48231,TX,Hunt,,2021,5.1,42619,44928,2309
48233,TX,Hutchinson,,2007,4,10648,11095,447
48233,TX,Hutchinson,,2008,4.1,10768,11231,463
48233,TX,Hutchinson,,2009,6.7,10618,11386,768
48233,TX,Hutchinson,,2010,8.5,8895,9723,828
48233,TX,Hutchinson,,2011,8.2,9104,9915,811
48233,TX,Hutchinson,,2012,6.5,9171,9805,634
48233,TX,Hutchinson,,2013,6.2,9149,9757,608
48233,TX,Hutchinson,,2014,4.4,10038,10503,465
48233,TX,Hutchinson,,2015,4.4,9365,9801,436
48233,TX,Hutchinson,,2016,5.6,9095,9639,544
48233,TX,Hutchinson,,2017,6.1,8762,9329,567
48233,TX,Hutchinson,,2018,5,8463,8910,447
48233,TX,Hutchinson,,2019,4.4,8182,8562,380
48233,TX,Hutchinson,,2020,7.2,7832,8436,604
48233,TX,Hutchinson,,2021,6,7987,8498,511
48235,TX,Irion,,2007,3,897,925,28
48235,TX,Irion,,2008,3.5,857,888,31
48235,TX,Irion,,2009,5.2,875,923,48
48235,TX,Irion,,2010,5.3,828,874,46
48235,TX,Irion,,2011,5.6,827,876,49
48235,TX,Irion,,2012,4.5,811,849,38
48235,TX,Irion,,2013,4.2,813,849,36
48235,TX,Irion,,2014,3.7,800,831,31
48235,TX,Irion,,2015,3.6,770,799,29
48235,TX,Irion,,2016,3.2,755,780,25
48235,TX,Irion,,2017,3.1,727,750,23
48235,TX,Irion,,2018,3,736,759,23
48235,TX,Irion,,2019,2.4,735,753,18
48235,TX,Irion,,2020,6,707,752,45
48235,TX,Irion,,2021,4.9,735,773,38
48237,TX,Jack,,2007,3.1,4819,4972,153
48237,TX,Jack,,2008,3.2,5277,5449,172
48237,TX,Jack,,2009,6.2,4963,5292,329
48237,TX,Jack,,2010,7.9,3380,3669,289
48237,TX,Jack,,2011,7.2,3446,3712,266
48237,TX,Jack,,2012,5.7,3578,3795,217
48237,TX,Jack,,2013,5.4,3786,4000,214
48237,TX,Jack,,2014,3.8,4137,4300,163
48237,TX,Jack,,2015,4.2,3906,4079,173
48237,TX,Jack,,2016,5,3666,3857,191
48237,TX,Jack,,2017,3.8,3776,3924,148
48237,TX,Jack,,2018,2.5,4226,4335,109
48237,TX,Jack,,2019,3.2,3320,3428,108
48237,TX,Jack,,2020,7,3134,3370,236
48237,TX,Jack,,2021,5.5,3212,3398,186
48239,TX,Jackson,,2007,3.8,6383,6637,254
48239,TX,Jackson,,2008,4.1,6536,6813,277
48239,TX,Jackson,,2009,7.3,6431,6941,510
48239,TX,Jackson,,2010,7.1,6635,7141,506
48239,TX,Jackson,,2011,6.4,6875,7348,473
48239,TX,Jackson,,2012,5.1,7044,7421,377
48239,TX,Jackson,,2013,5,7052,7426,374
48239,TX,Jackson,,2014,4,7317,7620,303
48239,TX,Jackson,,2015,3.8,7092,7371,279
48239,TX,Jackson,,2016,4.7,6936,7277,341
48239,TX,Jackson,,2017,4,7024,7319,295
48239,TX,Jackson,,2018,3.3,7056,7296,240
48239,TX,Jackson,,2019,3,7217,7440,223
48239,TX,Jackson,,2020,5.8,6810,7228,418
48239,TX,Jackson,,2021,5,6752,7108,356
48241,TX,Jasper,,2007,5.7,14612,15495,883
48241,TX,Jasper,,2008,6.3,14503,15484,981
48241,TX,Jasper,,2009,10.1,14368,15977,1609
48241,TX,Jasper,,2010,12.4,13017,14864,1847
48241,TX,Jasper,,2011,12.7,13139,15056,1917
48241,TX,Jasper,,2012,10.6,13302,14877,1575
48241,TX,Jasper,,2013,10.5,12970,14499,1529
48241,TX,Jasper,,2014,8.3,13240,14432,1192
48241,TX,Jasper,,2015,7.5,12841,13887,1046
48241,TX,Jasper,,2016,7.7,12437,13472,1035
48241,TX,Jasper,,2017,7.5,12349,13352,1003
48241,TX,Jasper,,2018,6.6,12249,13110,861
48241,TX,Jasper,,2019,6.1,11900,12676,776
48241,TX,Jasper,,2020,11.2,11320,12751,1431
48241,TX,Jasper,,2021,9.7,11585,12832,1247
48243,TX,Jeff Davis,,2007,3.3,1141,1180,39
48243,TX,Jeff Davis,,2008,3.7,1149,1193,44
48243,TX,Jeff Davis,,2009,4.7,1147,1204,57
48243,TX,Jeff Davis,,2010,4.9,1211,1274,63
48243,TX,Jeff Davis,,2011,5.1,1185,1249,64
48243,TX,Jeff Davis,,2012,4.9,1154,1213,59
48243,TX,Jeff Davis,,2013,4.1,1111,1159,48
48243,TX,Jeff Davis,,2014,3.7,1104,1146,42
48243,TX,Jeff Davis,,2015,3.3,1045,1081,36
48243,TX,Jeff Davis,,2016,3,1042,1074,32
48243,TX,Jeff Davis,,2017,3.2,1025,1059,34
48243,TX,Jeff Davis,,2018,2.9,1027,1058,31
48243,TX,Jeff Davis,,2019,2.9,1004,1034,30
48243,TX,Jeff Davis,,2020,5.1,904,953,49
48243,TX,Jeff Davis,,2021,4.3,979,1023,44
48245,TX,Jefferson,,2007,5.5,106033,112241,6208
48245,TX,Jefferson,,2008,6.6,106376,113930,7554
48245,TX,Jefferson,,2009,9.5,104745,115751,11006
48245,TX,Jefferson,,2010,11.4,100468,113365,12897
48245,TX,Jefferson,,2011,11.7,101984,115547,13563
48245,TX,Jefferson,,2012,11,100854,113297,12443
48245,TX,Jefferson,,2013,11,98920,111085,12165
48245,TX,Jefferson,,2014,8.4,100799,110034,9235
48245,TX,Jefferson,,2015,7,100448,108031,7583
48245,TX,Jefferson,,2016,7,99999,107546,7547
48245,TX,Jefferson,,2017,7.4,98895,106833,7938
48245,TX,Jefferson,,2018,6.4,99407,106205,6798
48245,TX,Jefferson,,2019,5.8,98531,104653,6122
48245,TX,Jefferson,,2020,12,91569,104025,12456
48245,TX,Jefferson,,2021,10,91528,101725,10197
48247,TX,Jim Hogg,,2007,3.8,2633,2738,105
48247,TX,Jim Hogg,,2008,3.8,2666,2771,105
48247,TX,Jim Hogg,,2009,7.7,2785,3017,232
48247,TX,Jim Hogg,,2010,10.3,2091,2332,241
48247,TX,Jim Hogg,,2011,8.9,2122,2330,208
48247,TX,Jim Hogg,,2012,6.5,2191,2344,153
48247,TX,Jim Hogg,,2013,7.2,2155,2321,166
48247,TX,Jim Hogg,,2014,6.1,2061,2196,135
48247,TX,Jim Hogg,,2015,7.2,1882,2029,147
48247,TX,Jim Hogg,,2016,9.6,1759,1945,186
48247,TX,Jim Hogg,,2017,7.3,1753,1892,139
48247,TX,Jim Hogg,,2018,5.7,1754,1861,107
48247,TX,Jim Hogg,,2019,4.8,1770,1859,89
48247,TX,Jim Hogg,,2020,9.6,1685,1863,178
48247,TX,Jim Hogg,,2021,8.8,1695,1859,164
48249,TX,Jim Wells,,2007,4,20285,21133,848
48249,TX,Jim Wells,,2008,4.2,20582,21489,907
48249,TX,Jim Wells,,2009,9,19758,21714,1956
48249,TX,Jim Wells,,2010,10.1,16453,18292,1839
48249,TX,Jim Wells,,2011,8.2,18144,19767,1623
48249,TX,Jim Wells,,2012,6.1,19339,20606,1267
48249,TX,Jim Wells,,2013,6.2,18861,20102,1241
48249,TX,Jim Wells,,2014,5.3,19015,20077,1062
48249,TX,Jim Wells,,2015,7.9,17702,19230,1528
48249,TX,Jim Wells,,2016,10.6,15625,17470,1845
48249,TX,Jim Wells,,2017,7.6,15271,16536,1265
48249,TX,Jim Wells,,2018,5.5,15907,16827,920
48249,TX,Jim Wells,,2019,4.7,15872,16656,784
48249,TX,Jim Wells,,2020,13,13919,15997,2078
48249,TX,Jim Wells,,2021,10.2,14019,15607,1588
48251,TX,Johnson,,2007,4.2,68773,71785,3012
48251,TX,Johnson,,2008,4.6,69840,73218,3378
48251,TX,Johnson,,2009,8.1,69009,75127,6118
48251,TX,Johnson,,2010,8.7,65766,72051,6285
48251,TX,Johnson,,2011,8,66895,72738,5843
48251,TX,Johnson,,2012,6.6,68168,72986,4818
48251,TX,Johnson,,2013,6.2,69006,73541,4535
48251,TX,Johnson,,2014,5.1,70470,74263,3793
48251,TX,Johnson,,2015,4.4,71032,74321,3289
48251,TX,Johnson,,2016,4.4,72753,76072,3319
48251,TX,Johnson,,2017,3.8,74540,77504,2964
48251,TX,Johnson,,2018,3.5,76929,79688,2759
48251,TX,Johnson,,2019,3.2,79720,82364,2644
48251,TX,Johnson,,2020,6.5,77464,82833,5369
48251,TX,Johnson,,2021,4.9,81406,85557,4151
48253,TX,Jones,,2007,4.8,7267,7632,365
48253,TX,Jones,,2008,5,7389,7775,386
48253,TX,Jones,,2009,7.6,7194,7789,595
48253,TX,Jones,,2010,8.8,5626,6169,543
48253,TX,Jones,,2011,8.5,5613,6137,524
48253,TX,Jones,,2012,7.2,5469,5891,422
48253,TX,Jones,,2013,6.8,5442,5838,396
48253,TX,Jones,,2014,5.6,5474,5797,323
48253,TX,Jones,,2015,5.5,5357,5671,314
48253,TX,Jones,,2016,5.8,5300,5627,327
48253,TX,Jones,,2017,5.4,5307,5608,301
48253,TX,Jones,,2018,4.8,5298,5567,269
48253,TX,Jones,,2019,4.3,5474,5717,243
48253,TX,Jones,,2020,7.1,5190,5585,395
48253,TX,Jones,,2021,6.2,5377,5730,353
48255,TX,Karnes,,2007,5.6,4906,5199,293
48255,TX,Karnes,,2008,5.9,4978,5289,311
48255,TX,Karnes,,2009,9,5005,5497,492
48255,TX,Karnes,,2010,9.2,4431,4878,447
48255,TX,Karnes,,2011,8,4494,4887,393
48255,TX,Karnes,,2012,6,4956,5275,319
48255,TX,Karnes,,2013,5.4,5309,5612,303
48255,TX,Karnes,,2014,3.7,6033,6265,232
48255,TX,Karnes,,2015,4.3,6155,6429,274
48255,TX,Karnes,,2016,4.9,5972,6279,307
48255,TX,Karnes,,2017,3.5,6174,6398,224
48255,TX,Karnes,,2018,2.9,6600,6795,195
48255,TX,Karnes,,2019,2.5,6894,7072,178
48255,TX,Karnes,,2020,6.3,6508,6944,436
48255,TX,Karnes,,2021,5.2,6487,6843,356
48257,TX,Kaufman,,2007,4.7,43109,45253,2144
48257,TX,Kaufman,,2008,5.3,43916,46372,2456
48257,TX,Kaufman,,2009,8.2,43137,46998,3861
48257,TX,Kaufman,,2010,8.5,46540,50877,4337
48257,TX,Kaufman,,2011,8.3,47242,51508,4266
48257,TX,Kaufman,,2012,6.9,47941,51497,3556
48257,TX,Kaufman,,2013,6.4,48995,52345,3350
48257,TX,Kaufman,,2014,5.2,50740,53532,2792
48257,TX,Kaufman,,2015,4.1,52824,55084,2260
48257,TX,Kaufman,,2016,3.8,55742,57940,2198
48257,TX,Kaufman,,2017,3.6,57740,59881,2141
48257,TX,Kaufman,,2018,3.5,60348,62530,2182
48257,TX,Kaufman,,2019,3.2,64407,66558,2151
48257,TX,Kaufman,,2020,6.4,64465,68859,4394
48257,TX,Kaufman,,2021,4.9,68423,71942,3519
48259,TX,Kendall,,2007,3.5,14840,15381,541
48259,TX,Kendall,,2008,3.8,15535,16151,616
48259,TX,Kendall,,2009,5.6,15816,16761,945
48259,TX,Kendall,,2010,6.2,15406,16433,1027
48259,TX,Kendall,,2011,6.3,15845,16905,1060
48259,TX,Kendall,,2012,5.4,16498,17435,937
48259,TX,Kendall,,2013,5.1,17277,18207,930
48259,TX,Kendall,,2014,4.1,17886,18651,765
48259,TX,Kendall,,2015,3.3,18533,19167,634
48259,TX,Kendall,,2016,3.2,19702,20353,651
48259,TX,Kendall,,2017,3.1,20286,20935,649
48259,TX,Kendall,,2018,2.9,21011,21646,635
48259,TX,Kendall,,2019,2.7,21781,22390,609
48259,TX,Kendall,,2020,5.1,20900,22016,1116
48259,TX,Kendall,,2021,3.8,21908,22781,873
48261,TX,Kenedy,,2007,3,229,236,7
48261,TX,Kenedy,,2008,3.4,230,238,8
48261,TX,Kenedy,,2009,5.9,222,236,14
48261,TX,Kenedy,,2010,6.8,205,220,15
48261,TX,Kenedy,,2011,6.7,223,239,16
48261,TX,Kenedy,,2012,5.1,240,253,13
48261,TX,Kenedy,,2013,4.1,284,296,12
48261,TX,Kenedy,,2014,3,328,338,10
48261,TX,Kenedy,,2015,3.2,273,282,9
48261,TX,Kenedy,,2016,4.6,207,217,10
48261,TX,Kenedy,,2017,3.3,232,240,8
48261,TX,Kenedy,,2018,3.7,235,244,9
48261,TX,Kenedy,,2019,3.5,220,228,8
48261,TX,Kenedy,,2020,5.6,169,179,10
48261,TX,Kenedy,,2021,6,172,183,11
48263,TX,Kent,,2007,3.3,409,423,14
48263,TX,Kent,,2008,4.1,423,441,18
48263,TX,Kent,,2009,5.2,440,464,24
48263,TX,Kent,,2010,4.8,532,559,27
48263,TX,Kent,,2011,4.9,527,554,27
48263,TX,Kent,,2012,3.8,529,550,21
48263,TX,Kent,,2013,4,509,530,21
48263,TX,Kent,,2014,3.5,494,512,18
48263,TX,Kent,,2015,2.6,484,497,13
48263,TX,Kent,,2016,3,456,470,14
48263,TX,Kent,,2017,2.7,438,450,12
48263,TX,Kent,,2018,2.5,436,447,11
48263,TX,Kent,,2019,2.4,456,467,11
48263,TX,Kent,,2020,3.9,441,459,18
48263,TX,Kent,,2021,2.9,434,447,13
48265,TX,Kerr,,2007,3.5,21756,22546,790
48265,TX,Kerr,,2008,4,22182,23102,920
48265,TX,Kerr,,2009,5.8,22044,23389,1345
48265,TX,Kerr,,2010,6.7,20477,21948,1471
48265,TX,Kerr,,2011,6.9,20311,21812,1501
48265,TX,Kerr,,2012,5.8,20392,21647,1255
48265,TX,Kerr,,2013,5.6,20248,21439,1191
48265,TX,Kerr,,2014,4.4,20448,21399,951
48265,TX,Kerr,,2015,3.7,20403,21188,785
48265,TX,Kerr,,2016,3.6,20597,21366,769
48265,TX,Kerr,,2017,3.4,20448,21176,728
48265,TX,Kerr,,2018,3.3,20886,21589,703
48265,TX,Kerr,,2019,3,21331,21980,649
48265,TX,Kerr,,2020,5.8,20277,21535,1258
48265,TX,Kerr,,2021,4.5,21071,22061,990
48267,TX,Kimble,,2007,3.4,2154,2229,75
48267,TX,Kimble,,2008,3.7,2115,2197,82
48267,TX,Kimble,,2009,5.2,2039,2151,112
48267,TX,Kimble,,2010,6,2142,2279,137
48267,TX,Kimble,,2011,6.4,2088,2231,143
48267,TX,Kimble,,2012,4.9,2078,2184,106
48267,TX,Kimble,,2013,4.9,2051,2156,105
48267,TX,Kimble,,2014,3.9,2027,2110,83
48267,TX,Kimble,,2015,3.7,1927,2000,73
48267,TX,Kimble,,2016,3.8,1879,1953,74
48267,TX,Kimble,,2017,3.6,1810,1877,67
48267,TX,Kimble,,2018,3,1800,1856,56
48267,TX,Kimble,,2019,3,1778,1833,55
48267,TX,Kimble,,2020,5,1727,1818,91
48267,TX,Kimble,,2021,4.1,1826,1905,79
48269,TX,King,,2007,4.6,167,175,8
48269,TX,King,,2008,4.5,170,178,8
48269,TX,King,,2009,5.1,186,196,10
48269,TX,King,,2010,4.3,267,279,12
48269,TX,King,,2011,4.2,276,288,12
48269,TX,King,,2012,4.5,236,247,11
48269,TX,King,,2013,4.6,227,238,11
48269,TX,King,,2014,4,215,224,9
48269,TX,King,,2015,3.5,193,200,7
48269,TX,King,,2016,3.9,171,178,7
48269,TX,King,,2017,3.7,158,164,6
48269,TX,King,,2018,2.9,203,209,6
48269,TX,King,,2019,2.1,228,233,5
48269,TX,King,,2020,1.7,230,234,4
48269,TX,King,,2021,0.9,444,448,4
48271,TX,Kinney,,2007,4.8,1291,1356,65
48271,TX,Kinney,,2008,5.3,1302,1375,73
48271,TX,Kinney,,2009,7.7,1329,1440,111
48271,TX,Kinney,,2010,11.2,1129,1272,143
48271,TX,Kinney,,2011,10.5,1139,1272,133
48271,TX,Kinney,,2012,8.7,1150,1260,110
48271,TX,Kinney,,2013,9.6,1100,1217,117
48271,TX,Kinney,,2014,7.3,1137,1227,90
48271,TX,Kinney,,2015,6.4,1109,1185,76
48271,TX,Kinney,,2016,5.8,1089,1156,67
48271,TX,Kinney,,2017,5.6,1092,1157,65
48271,TX,Kinney,,2018,4.4,1280,1339,59
48271,TX,Kinney,,2019,3.6,1301,1350,49
48271,TX,Kinney,,2020,5.9,1223,1300,77
48271,TX,Kinney,,2021,5.5,1175,1244,69
48273,TX,Kleberg,,2007,4.2,15309,15977,668
48273,TX,Kleberg,,2008,4.3,15830,16533,703
48273,TX,Kleberg,,2009,6.7,15934,17076,1142
48273,TX,Kleberg,,2010,8.4,13787,15055,1268
48273,TX,Kleberg,,2011,8.3,14112,15388,1276
48273,TX,Kleberg,,2012,6.9,14330,15384,1054
48273,TX,Kleberg,,2013,6.5,14408,15414,1006
48273,TX,Kleberg,,2014,5.5,14398,15240,842
48273,TX,Kleberg,,2015,5.9,13548,14405,857
48273,TX,Kleberg,,2016,6.7,13165,14114,949
48273,TX,Kleberg,,2017,6,12506,13299,793
48273,TX,Kleberg,,2018,5,12528,13186,658
48273,TX,Kleberg,,2019,4.3,12751,13325,574
48273,TX,Kleberg,,2020,8.5,12030,13142,1112
48273,TX,Kleberg,,2021,7.1,12261,13202,941
48275,TX,Knox,,2007,3.7,1740,1807,67
48275,TX,Knox,,2008,3.8,1739,1808,69
48275,TX,Knox,,2009,5.8,1731,1837,106
48275,TX,Knox,,2010,5.9,1799,1912,113
48275,TX,Knox,,2011,6,1791,1905,114
48275,TX,Knox,,2012,5.2,1719,1814,95
48275,TX,Knox,,2013,5.4,1655,1749,94
48275,TX,Knox,,2014,4.4,1661,1737,76
48275,TX,Knox,,2015,3.8,1619,1683,64
48275,TX,Knox,,2016,4.2,1494,1560,66
48275,TX,Knox,,2017,4,1414,1473,59
48275,TX,Knox,,2018,3.6,1386,1438,52
48275,TX,Knox,,2019,3.2,1380,1426,46
48275,TX,Knox,,2020,5.6,1357,1438,81
48275,TX,Knox,,2021,4.7,1389,1457,68
48277,TX,Lamar,,2007,4.7,23016,24150,1134
48277,TX,Lamar,,2008,5.4,22249,23517,1268
48277,TX,Lamar,,2009,7.6,21773,23569,1796
48277,TX,Lamar,,2010,9.3,21156,23334,2178
48277,TX,Lamar,,2011,10.1,21028,23388,2360
48277,TX,Lamar,,2012,9.2,20520,22588,2068
48277,TX,Lamar,,2013,8.2,20445,22264,1819
48277,TX,Lamar,,2014,6.2,20749,22116,1367
48277,TX,Lamar,,2015,4.8,21125,22197,1072
48277,TX,Lamar,,2016,4.6,22161,23238,1077
48277,TX,Lamar,,2017,4.2,22581,23578,997
48277,TX,Lamar,,2018,3.8,22641,23538,897
48277,TX,Lamar,,2019,3.4,22853,23653,800
48277,TX,Lamar,,2020,6.4,21875,23378,1503
48277,TX,Lamar,,2021,5.5,23149,24493,1344
48279,TX,Lamb,,2007,4.1,6692,6975,283
48279,TX,Lamb,,2008,4.4,6784,7098,314
48279,TX,Lamb,,2009,7.1,6596,7101,505
48279,TX,Lamb,,2010,7.6,6289,6806,517
48279,TX,Lamb,,2011,7.8,6202,6727,525
48279,TX,Lamb,,2012,7.9,5939,6449,510
48279,TX,Lamb,,2013,6.9,5713,6136,423
48279,TX,Lamb,,2014,5.9,5667,6022,355
48279,TX,Lamb,,2015,9,5017,5513,496
48279,TX,Lamb,,2016,6.5,4908,5249,341
48279,TX,Lamb,,2017,5.2,4885,5153,268
48279,TX,Lamb,,2018,4.4,4931,5160,229
48279,TX,Lamb,,2019,3.8,5006,5204,198
48279,TX,Lamb,,2020,5.2,4897,5166,269
48279,TX,Lamb,,2021,5,4951,5211,260
48281,TX,Lampasas,,2007,3.7,9737,10114,377
48281,TX,Lampasas,,2008,4.1,9877,10299,422
48281,TX,Lampasas,,2009,5.8,9914,10523,609
48281,TX,Lampasas,,2010,7.1,8387,9032,645
48281,TX,Lampasas,,2011,7.8,8421,9134,713
48281,TX,Lampasas,,2012,7.1,8428,9072,644
48281,TX,Lampasas,,2013,7.2,8456,9114,658
48281,TX,Lampasas,,2014,5.7,8446,8955,509
48281,TX,Lampasas,,2015,4.4,8658,9059,401
48281,TX,Lampasas,,2016,4.2,8783,9164,381
48281,TX,Lampasas,,2017,3.8,8800,9145,345
48281,TX,Lampasas,,2018,3.8,8721,9062,341
48281,TX,Lampasas,,2019,3.3,8705,9005,300
48281,TX,Lampasas,,2020,5.4,8483,8963,480
48281,TX,Lampasas,,2021,4.8,8845,9291,446
48283,TX,La Salle,,2007,4.9,2621,2757,136
48283,TX,La Salle,,2008,5.4,2754,2911,157
48283,TX,La Salle,,2009,9.2,2658,2928,270
48283,TX,La Salle,,2010,9.1,2481,2728,247
48283,TX,La Salle,,2011,7,2917,3136,219
48283,TX,La Salle,,2012,4.4,3500,3663,163
48283,TX,La Salle,,2013,3.8,4010,4168,158
48283,TX,La Salle,,2014,3.1,4426,4569,143
48283,TX,La Salle,,2015,4.2,4091,4270,179
48283,TX,La Salle,,2016,5.1,3687,3887,200
48283,TX,La Salle,,2017,3.7,4021,4175,154
48283,TX,La Salle,,2018,2.4,4430,4541,111
48283,TX,La Salle,,2019,2.4,4231,4336,105
48283,TX,La Salle,,2020,6.7,3454,3703,249
48283,TX,La Salle,,2021,4.3,3641,3804,163
48285,TX,Lavaca,,2007,3.2,9790,10110,320
48285,TX,Lavaca,,2008,3.5,9572,9916,344
48285,TX,Lavaca,,2009,5.7,9466,10035,569
48285,TX,Lavaca,,2010,6.9,9041,9715,674
48285,TX,Lavaca,,2011,6.1,9021,9611,590
48285,TX,Lavaca,,2012,4.8,9006,9460,454
48285,TX,Lavaca,,2013,4.7,8775,9210,435
48285,TX,Lavaca,,2014,4,8605,8961,356
48285,TX,Lavaca,,2015,3.8,8472,8808,336
48285,TX,Lavaca,,2016,4.2,8376,8746,370
48285,TX,Lavaca,,2017,3.6,8354,8669,315
48285,TX,Lavaca,,2018,3.1,8427,8700,273
48285,TX,Lavaca,,2019,3,8270,8523,253
48285,TX,Lavaca,,2020,5.2,7905,8341,436
48285,TX,Lavaca,,2021,4.5,8253,8640,387
48287,TX,Lee,,2007,3.5,8559,8871,312
48287,TX,Lee,,2008,3.9,8646,8998,352
48287,TX,Lee,,2009,6.6,8532,9139,607
48287,TX,Lee,,2010,7.3,7637,8237,600
48287,TX,Lee,,2011,6.7,8271,8863,592
48287,TX,Lee,,2012,5.4,8628,9116,488
48287,TX,Lee,,2013,5.1,8652,9121,469
48287,TX,Lee,,2014,4,8950,9326,376
48287,TX,Lee,,2015,3.6,8971,9304,333
48287,TX,Lee,,2016,3.8,8936,9286,350
48287,TX,Lee,,2017,3.3,9153,9467,314
48287,TX,Lee,,2018,3.1,9091,9380,289
48287,TX,Lee,,2019,2.6,9741,10006,265
48287,TX,Lee,,2020,4.9,8637,9086,449
48287,TX,Lee,,2021,4.3,8669,9057,388
48289,TX,Leon,,2007,4.2,7251,7568,317
48289,TX,Leon,,2008,4.3,7468,7804,336
48289,TX,Leon,,2009,7,7695,8273,578
48289,TX,Leon,,2010,8.9,6626,7275,649
48289,TX,Leon,,2011,9,6517,7159,642
48289,TX,Leon,,2012,7.3,6429,6938,509
48289,TX,Leon,,2013,7,6468,6952,484
48289,TX,Leon,,2014,5.4,6822,7210,388
48289,TX,Leon,,2015,5.4,6563,6936,373
48289,TX,Leon,,2016,6.5,6091,6513,422
48289,TX,Leon,,2017,6.4,5752,6144,392
48289,TX,Leon,,2018,5,5764,6070,306
48289,TX,Leon,,2019,4.4,5972,6244,272
48289,TX,Leon,,2020,7.8,5571,6043,472
48289,TX,Leon,,2021,7.1,5746,6184,438
48291,TX,Liberty,,2007,5.3,29029,30648,1619
48291,TX,Liberty,,2008,5.9,29044,30880,1836
48291,TX,Liberty,,2009,10.1,28351,31539,3188
48291,TX,Liberty,,2010,11.7,27066,30668,3602
48291,TX,Liberty,,2011,11.5,27286,30816,3530
48291,TX,Liberty,,2012,9.5,27868,30803,2935
48291,TX,Liberty,,2013,9,28194,30971,2777
48291,TX,Liberty,,2014,7.3,28700,30948,2248
48291,TX,Liberty,,2015,7,28813,30968,2155
48291,TX,Liberty,,2016,7.5,29176,31554,2378
48291,TX,Liberty,,2017,7.2,29470,31751,2281
48291,TX,Liberty,,2018,5.9,30516,32414,1898
48291,TX,Liberty,,2019,5,31416,33077,1661
48291,TX,Liberty,,2020,10.4,30560,34126,3566
48291,TX,Liberty,,2021,9.2,31677,34870,3193
48293,TX,Limestone,,2007,4.3,9890,10330,440
48293,TX,Limestone,,2008,4.3,10269,10736,467
48293,TX,Limestone,,2009,6.3,10561,11266,705
48293,TX,Limestone,,2010,7.9,9164,9953,789
48293,TX,Limestone,,2011,8.6,8755,9575,820
48293,TX,Limestone,,2012,6.8,8927,9583,656
48293,TX,Limestone,,2013,6.8,8822,9465,643
48293,TX,Limestone,,2014,5.9,8646,9189,543
48293,TX,Limestone,,2015,5.1,8150,8584,434
48293,TX,Limestone,,2016,5.6,7862,8329,467
48293,TX,Limestone,,2017,5.6,7791,8255,464
48293,TX,Limestone,,2018,4.7,7938,8327,389
48293,TX,Limestone,,2019,3.9,8175,8503,328
48293,TX,Limestone,,2020,7.1,7662,8250,588
48293,TX,Limestone,,2021,6.2,8001,8528,527
48295,TX,Lipscomb,,2007,2.6,1793,1841,48
48295,TX,Lipscomb,,2008,2.8,1756,1807,51
48295,TX,Lipscomb,,2009,6.7,1618,1735,117
48295,TX,Lipscomb,,2010,5.9,1569,1667,98
48295,TX,Lipscomb,,2011,4.7,1658,1740,82
48295,TX,Lipscomb,,2012,3.8,1687,1754,67
48295,TX,Lipscomb,,2013,4,1649,1717,68
48295,TX,Lipscomb,,2014,3.4,1686,1745,59
48295,TX,Lipscomb,,2015,3.9,1657,1725,68
48295,TX,Lipscomb,,2016,4.4,1579,1652,73
48295,TX,Lipscomb,,2017,3.2,1561,1613,52
48295,TX,Lipscomb,,2018,2.8,1591,1636,45
48295,TX,Lipscomb,,2019,2.7,1567,1610,43
48295,TX,Lipscomb,,2020,4.2,1449,1512,63
48295,TX,Lipscomb,,2021,3.7,1446,1502,56
48297,TX,Live Oak,,2007,3.9,4834,5031,197
48297,TX,Live Oak,,2008,4.3,4894,5112,218
48297,TX,Live Oak,,2009,7,4848,5211,363
48297,TX,Live Oak,,2010,7.4,4296,4638,342
48297,TX,Live Oak,,2011,6.2,4908,5231,323
48297,TX,Live Oak,,2012,4.6,5494,5756,262
48297,TX,Live Oak,,2013,4.4,5755,6020,265
48297,TX,Live Oak,,2014,3.6,5885,6106,221
48297,TX,Live Oak,,2015,4,5654,5892,238
48297,TX,Live Oak,,2016,5.9,4897,5206,309
48297,TX,Live Oak,,2017,4.7,5124,5377,253
48297,TX,Live Oak,,2018,3.8,4936,5133,197
48297,TX,Live Oak,,2019,3.1,5306,5475,169
48297,TX,Live Oak,,2020,7.5,4736,5121,385
48297,TX,Live Oak,,2021,6.8,4601,4937,336
48299,TX,Llano,,2007,4,7828,8157,329
48299,TX,Llano,,2008,4.3,8076,8438,362
48299,TX,Llano,,2009,6.9,7956,8546,590
48299,TX,Llano,,2010,8.1,7357,8005,648
48299,TX,Llano,,2011,8,7371,8011,640
48299,TX,Llano,,2012,6.7,7504,8047,543
48299,TX,Llano,,2013,6.5,7569,8094,525
48299,TX,Llano,,2014,5.2,7654,8077,423
48299,TX,Llano,,2015,4.3,7803,8152,349
48299,TX,Llano,,2016,4.2,7950,8296,346
48299,TX,Llano,,2017,3.8,7985,8304,319
48299,TX,Llano,,2018,3.7,8122,8437,315
48299,TX,Llano,,2019,3.5,8250,8546,296
48299,TX,Llano,,2020,5.7,7911,8393,482
48299,TX,Llano,,2021,4.8,8469,8900,431
48301,TX,Loving,,2007,7.3,38,41,3
48301,TX,Loving,,2008,7,40,43,3
48301,TX,Loving,,2009,9.3,39,43,4
48301,TX,Loving,,2010,5.6,67,71,4
48301,TX,Loving,,2011,6.1,62,66,4
48301,TX,Loving,,2012,6,63,67,4
48301,TX,Loving,,2013,5.3,71,75,4
48301,TX,Loving,,2014,5.1,74,78,4
48301,TX,Loving,,2015,5.2,73,77,4
48301,TX,Loving,,2016,4.7,82,86,4
48301,TX,Loving,,2017,5,95,100,5
48301,TX,Loving,,2018,1.5,261,265,4
48301,TX,Loving,,2019,0.8,494,498,4
48301,TX,Loving,,2020,1.7,290,295,5
48301,TX,Loving,,2021,0.9,434,438,4
48303,TX,Lubbock,,2007,3.6,131168,136111,4943
48303,TX,Lubbock,,2008,3.7,133372,138524,5152
48303,TX,Lubbock,,2009,5.4,134756,142374,7618
48303,TX,Lubbock,,2010,6.3,134500,143521,9021
48303,TX,Lubbock,,2011,6.2,136634,145666,9032
48303,TX,Lubbock,,2012,5.3,137565,145281,7716
48303,TX,Lubbock,,2013,5,139809,147137,7328
48303,TX,Lubbock,,2014,4,141676,147568,5892
48303,TX,Lubbock,,2015,3.4,144499,149630,5131
48303,TX,Lubbock,,2016,3.4,148411,153626,5215
48303,TX,Lubbock,,2017,3.2,149850,154817,4967
48303,TX,Lubbock,,2018,3.1,150231,155010,4779
48303,TX,Lubbock,,2019,2.8,151849,156286,4437
48303,TX,Lubbock,,2020,5.7,146854,155803,8949
48303,TX,Lubbock,,2021,4.5,153092,160338,7246
48305,TX,Lynn,,2007,4.9,2544,2676,132
48305,TX,Lynn,,2008,4.7,2642,2771,129
48305,TX,Lynn,,2009,5.9,2708,2879,171
48305,TX,Lynn,,2010,6.6,2870,3073,203
48305,TX,Lynn,,2011,6.8,2872,3082,210
48305,TX,Lynn,,2012,6,2770,2948,178
48305,TX,Lynn,,2013,5.3,2702,2854,152
48305,TX,Lynn,,2014,4.4,2731,2858,127
48305,TX,Lynn,,2015,4.1,2651,2763,112
48305,TX,Lynn,,2016,4,2622,2731,109
48305,TX,Lynn,,2017,3.8,2649,2753,104
48305,TX,Lynn,,2018,3.3,2632,2721,89
48305,TX,Lynn,,2019,3,2668,2750,82
48305,TX,Lynn,,2020,5.5,2573,2722,149
48305,TX,Lynn,,2021,4.3,2678,2798,120
48307,TX,McCulloch,,2007,3.9,3558,3702,144
48307,TX,McCulloch,,2008,3.9,3826,3983,157
48307,TX,McCulloch,,2009,7.9,3635,3947,312
48307,TX,McCulloch,,2010,7,3813,4102,289
48307,TX,McCulloch,,2011,6.1,4089,4356,267
48307,TX,McCulloch,,2012,5.4,4157,4392,235
48307,TX,McCulloch,,2013,5.3,4037,4264,227
48307,TX,McCulloch,,2014,4.3,3931,4106,175
48307,TX,McCulloch,,2015,4.8,3735,3925,190
48307,TX,McCulloch,,2016,4.5,3545,3712,167
48307,TX,McCulloch,,2017,3.6,3527,3657,130
48307,TX,McCulloch,,2018,3.3,3590,3713,123
48307,TX,McCulloch,,2019,5.2,3257,3435,178
48307,TX,McCulloch,,2020,7.5,2946,3186,240
48307,TX,McCulloch,,2021,6.5,2953,3157,204
48309,TX,McLennan,,2007,4.3,105644,110366,4722
48309,TX,McLennan,,2008,4.5,106017,111042,5025
48309,TX,McLennan,,2009,6.7,106425,114083,7658
48309,TX,McLennan,,2010,7.4,104694,113062,8368
48309,TX,McLennan,,2011,7.7,104616,113321,8705
48309,TX,McLennan,,2012,6.6,104700,112098,7398
48309,TX,McLennan,,2013,6.2,104994,111970,6976
48309,TX,McLennan,,2014,5.1,106974,112751,5777
48309,TX,McLennan,,2015,4.1,107995,112616,4621
48309,TX,McLennan,,2016,4,111548,116150,4602
48309,TX,McLennan,,2017,3.9,112605,117188,4583
48309,TX,McLennan,,2018,3.6,112839,117071,4232
48309,TX,McLennan,,2019,3.3,113863,117785,3922
48309,TX,McLennan,,2020,6.2,111020,118391,7371
48309,TX,McLennan,,2021,4.9,116247,122192,5945
48311,TX,McMullen,,2007,5.1,319,336,17
48311,TX,McMullen,,2008,5.4,315,333,18
48311,TX,McMullen,,2009,6.9,336,361,25
48311,TX,McMullen,,2010,4.3,467,488,21
48311,TX,McMullen,,2011,3.2,638,659,21
48311,TX,McMullen,,2012,2.3,725,742,17
48311,TX,McMullen,,2013,2.7,857,881,24
48311,TX,McMullen,,2014,2,1037,1058,21
48311,TX,McMullen,,2015,2.1,949,969,20
48311,TX,McMullen,,2016,2.1,844,862,18
48311,TX,McMullen,,2017,1.9,729,743,14
48311,TX,McMullen,,2018,1.8,696,709,13
48311,TX,McMullen,,2019,1.6,792,805,13
48311,TX,McMullen,,2020,2.8,692,712,20
48311,TX,McMullen,,2021,2.3,717,734,17
48313,TX,Madison,,2007,4.7,4751,4985,234
48313,TX,Madison,,2008,5.2,4723,4983,260
48313,TX,Madison,,2009,7.4,4949,5343,394
48313,TX,Madison,,2010,8.4,4357,4759,402
48313,TX,Madison,,2011,8.6,4281,4682,401
48313,TX,Madison,,2012,7,4316,4642,326
48313,TX,Madison,,2013,6.5,4497,4811,314
48313,TX,Madison,,2014,4.9,4770,5018,248
48313,TX,Madison,,2015,4.3,4897,5119,222
48313,TX,Madison,,2016,5.1,4527,4770,243
48313,TX,Madison,,2017,4.8,4430,4651,221
48313,TX,Madison,,2018,4.4,4321,4522,201
48313,TX,Madison,,2019,4.2,4292,4480,188
48313,TX,Madison,,2020,7.2,4120,4438,318
48313,TX,Madison,,2021,6.2,4398,4691,293
48315,TX,Marion,,2007,4.6,4841,5076,235
48315,TX,Marion,,2008,5.1,4753,5006,253
48315,TX,Marion,,2009,10.3,4618,5146,528
48315,TX,Marion,,2010,11.9,3975,4510,535
48315,TX,Marion,,2011,10.8,3949,4425,476
48315,TX,Marion,,2012,9.1,3947,4341,394
48315,TX,Marion,,2013,8.1,4164,4532,368
48315,TX,Marion,,2014,6.5,4182,4475,293
48315,TX,Marion,,2015,6.5,4128,4417,289
48315,TX,Marion,,2016,7,4038,4343,305
48315,TX,Marion,,2017,5.7,4058,4304,246
48315,TX,Marion,,2018,4.5,4021,4212,191
48315,TX,Marion,,2019,4.2,4009,4185,176
48315,TX,Marion,,2020,8.3,3855,4204,349
48315,TX,Marion,,2021,6.9,3963,4255,292
48317,TX,Martin,,2007,3.7,2054,2132,78
48317,TX,Martin,,2008,3.5,2157,2236,79
48317,TX,Martin,,2009,4.8,2144,2252,108
48317,TX,Martin,,2010,6,2066,2199,133
48317,TX,Martin,,2011,5.7,2213,2348,135
48317,TX,Martin,,2012,4.5,2302,2410,108
48317,TX,Martin,,2013,4.3,2437,2546,109
48317,TX,Martin,,2014,3.4,2591,2683,92
48317,TX,Martin,,2015,3.5,2493,2584,91
48317,TX,Martin,,2016,4.4,2374,2483,109
48317,TX,Martin,,2017,3.3,2424,2507,83
48317,TX,Martin,,2018,2.5,2675,2744,69
48317,TX,Martin,,2019,2.6,2707,2780,73
48317,TX,Martin,,2020,6.1,2384,2539,155
48317,TX,Martin,,2021,4.8,2480,2605,125
48319,TX,Mason,,2007,2.8,2306,2373,67
48319,TX,Mason,,2008,3,2277,2348,71
48319,TX,Mason,,2009,5,2286,2406,120
48319,TX,Mason,,2010,6.3,1868,1994,126
48319,TX,Mason,,2011,6.2,1841,1963,122
48319,TX,Mason,,2012,5.2,1863,1965,102
48319,TX,Mason,,2013,5.5,1848,1956,108
48319,TX,Mason,,2014,4.6,1806,1894,88
48319,TX,Mason,,2015,3.9,1735,1805,70
48319,TX,Mason,,2016,3.6,1726,1791,65
48319,TX,Mason,,2017,3.4,1739,1800,61
48319,TX,Mason,,2018,3.1,1702,1757,55
48319,TX,Mason,,2019,3.2,1684,1740,56
48319,TX,Mason,,2020,5.5,1619,1714,95
48319,TX,Mason,,2021,4.7,1705,1789,84
48321,TX,Matagorda,,2007,6,15506,16498,992
48321,TX,Matagorda,,2008,6.7,15908,17058,1150
48321,TX,Matagorda,,2009,9.9,16109,17885,1776
48321,TX,Matagorda,,2010,11.5,16091,18186,2095
48321,TX,Matagorda,,2011,12,15683,17813,2130
48321,TX,Matagorda,,2012,10.1,15343,17062,1719
48321,TX,Matagorda,,2013,9.8,15177,16822,1645
48321,TX,Matagorda,,2014,8,15338,16663,1325
48321,TX,Matagorda,,2015,6.8,16020,17187,1167
48321,TX,Matagorda,,2016,7.3,15653,16890,1237
48321,TX,Matagorda,,2017,7.4,15549,16783,1234
48321,TX,Matagorda,,2018,6.2,15619,16645,1026
48321,TX,Matagorda,,2019,5.7,15574,16510,936
48321,TX,Matagorda,,2020,10.5,14647,16369,1722
48321,TX,Matagorda,,2021,8.3,15114,16489,1375
48323,TX,Maverick,,2007,11.6,17574,19877,2303
48323,TX,Maverick,,2008,10.7,18630,20855,2225
48323,TX,Maverick,,2009,14.3,19528,22780,3252
48323,TX,Maverick,,2010,15.2,19979,23566,3587
48323,TX,Maverick,,2011,14.4,20495,23955,3460
48323,TX,Maverick,,2012,12.4,20404,23305,2901
48323,TX,Maverick,,2013,12.6,20659,23632,2973
48323,TX,Maverick,,2014,11.1,20789,23383,2594
48323,TX,Maverick,,2015,10.7,21126,23666,2540
48323,TX,Maverick,,2016,11.3,21519,24249,2730
48323,TX,Maverick,,2017,9.4,21520,23758,2238
48323,TX,Maverick,,2018,8.2,21498,23422,1924
48323,TX,Maverick,,2019,7.6,21589,23363,1774
48323,TX,Maverick,,2020,15.1,20457,24103,3646
48323,TX,Maverick,,2021,12.7,20739,23752,3013
48325,TX,Medina,,2007,4.2,18589,19410,821
48325,TX,Medina,,2008,5.1,18738,19735,997
48325,TX,Medina,,2009,6.6,18611,19934,1323
48325,TX,Medina,,2010,7.6,18526,20045,1519
48325,TX,Medina,,2011,7.7,18674,20235,1561
48325,TX,Medina,,2012,6.5,18846,20158,1312
48325,TX,Medina,,2013,6.1,19043,20286,1243
48325,TX,Medina,,2014,5,19359,20373,1014
48325,TX,Medina,,2015,4.4,19531,20431,900
48325,TX,Medina,,2016,4.4,20073,20999,926
48325,TX,Medina,,2017,3.9,20297,21123,826
48325,TX,Medina,,2018,3.5,20601,21350,749
48325,TX,Medina,,2019,3.2,20844,21528,684
48325,TX,Medina,,2020,6.3,19850,21192,1342
48325,TX,Medina,,2021,5,20744,21832,1088
48327,TX,Menard,,2007,3.6,1029,1067,38
48327,TX,Menard,,2008,4.3,1043,1090,47
48327,TX,Menard,,2009,6.5,1033,1105,72
48327,TX,Menard,,2010,7.5,931,1006,75
48327,TX,Menard,,2011,7.4,874,944,70
48327,TX,Menard,,2012,6.3,909,970,61
48327,TX,Menard,,2013,5.9,863,917,54
48327,TX,Menard,,2014,4.8,842,884,42
48327,TX,Menard,,2015,5.3,812,857,45
48327,TX,Menard,,2016,4.5,781,818,37
48327,TX,Menard,,2017,4.9,761,800,39
48327,TX,Menard,,2018,4.1,786,820,34
48327,TX,Menard,,2019,3.4,825,854,29
48327,TX,Menard,,2020,5.1,813,857,44
48327,TX,Menard,,2021,4.8,797,837,40
48329,TX,Midland,,2007,2.9,69248,71312,2064
48329,TX,Midland,,2008,2.9,73109,75277,2168
48329,TX,Midland,,2009,5.5,70984,75148,4164
48329,TX,Midland,,2010,5.9,67219,71420,4201
48329,TX,Midland,,2011,4.9,72801,76562,3761
48329,TX,Midland,,2012,3.9,78867,82031,3164
48329,TX,Midland,,2013,3.7,82706,85874,3168
48329,TX,Midland,,2014,2.9,88143,90787,2644
48329,TX,Midland,,2015,3.5,85325,88407,3082
48329,TX,Midland,,2016,4.4,81326,85080,3754
48329,TX,Midland,,2017,3,87358,90073,2715
48329,TX,Midland,,2018,2.1,99757,101943,2186
48329,TX,Midland,,2019,2.1,103242,105449,2207
48329,TX,Midland,,2020,8,89972,97848,7876
48329,TX,Midland,,2021,5.7,93631,99301,5670
48331,TX,Milam,,2007,4.2,11711,12228,517
48331,TX,Milam,,2008,5.4,11335,11987,652
48331,TX,Milam,,2009,10.8,10239,11485,1246
48331,TX,Milam,,2010,11.3,9372,10561,1189
48331,TX,Milam,,2011,10.5,9321,10416,1095
48331,TX,Milam,,2012,8.5,9380,10255,875
48331,TX,Milam,,2013,7.9,9311,10109,798
48331,TX,Milam,,2014,6.3,9573,10216,643
48331,TX,Milam,,2015,5.3,9591,10126,535
48331,TX,Milam,,2016,5.2,9742,10272,530
48331,TX,Milam,,2017,5.1,9511,10020,509
48331,TX,Milam,,2018,5.5,9252,9795,543
48331,TX,Milam,,2019,5,9160,9641,481
48331,TX,Milam,,2020,7.2,8926,9616,690
48331,TX,Milam,,2021,5.8,9606,10199,593
48333,TX,Mills,,2007,3.7,2208,2293,85
48333,TX,Mills,,2008,3.9,2248,2340,92
48333,TX,Mills,,2009,5.3,2326,2457,131
48333,TX,Mills,,2010,6.4,2053,2193,140
48333,TX,Mills,,2011,6.5,2029,2170,141
48333,TX,Mills,,2012,5.4,1983,2096,113
48333,TX,Mills,,2013,5.3,1957,2067,110
48333,TX,Mills,,2014,4.4,1955,2045,90
48333,TX,Mills,,2015,3.7,1917,1991,74
48333,TX,Mills,,2016,4.2,1845,1925,80
48333,TX,Mills,,2017,3.6,1830,1898,68
48333,TX,Mills,,2018,3.5,1786,1851,65
48333,TX,Mills,,2019,3.3,1806,1867,61
48333,TX,Mills,,2020,4.1,1789,1865,76
48333,TX,Mills,,2021,4.4,1822,1905,83
48335,TX,Mitchell,,2007,5.2,3105,3277,172
48335,TX,Mitchell,,2008,5.5,3121,3301,180
48335,TX,Mitchell,,2009,8.3,3217,3507,290
48335,TX,Mitchell,,2010,8.3,2729,2976,247
48335,TX,Mitchell,,2011,7.8,2713,2941,228
48335,TX,Mitchell,,2012,5.9,2700,2870,170
48335,TX,Mitchell,,2013,5.6,2713,2873,160
48335,TX,Mitchell,,2014,4.3,2775,2900,125
48335,TX,Mitchell,,2015,5.7,2590,2746,156
48335,TX,Mitchell,,2016,7,2427,2610,183
48335,TX,Mitchell,,2017,5.5,2343,2479,136
48335,TX,Mitchell,,2018,4.2,2207,2304,97
48335,TX,Mitchell,,2019,3.7,2222,2308,86
48335,TX,Mitchell,,2020,7.9,2142,2326,184
48335,TX,Mitchell,,2021,7.1,2179,2346,167
48337,TX,Montague,,2007,3.6,9897,10262,365
48337,TX,Montague,,2008,3.6,10278,10659,381
48337,TX,Montague,,2009,7.1,9965,10725,760
48337,TX,Montague,,2010,8.1,8678,9439,761
48337,TX,Montague,,2011,6.7,8950,9596,646
48337,TX,Montague,,2012,5.4,9300,9828,528
48337,TX,Montague,,2013,5,9832,10345,513
48337,TX,Montague,,2014,4,9713,10120,407
48337,TX,Montague,,2015,4.3,9292,9707,415
48337,TX,Montague,,2016,5,8587,9035,448
48337,TX,Montague,,2017,4,8657,9021,364
48337,TX,Montague,,2018,3.2,8760,9051,291
48337,TX,Montague,,2019,2.9,8918,9182,264
48337,TX,Montague,,2020,6.6,8404,9001,597
48337,TX,Montague,,2021,5.1,8789,9265,476
48339,TX,Montgomery,,2007,3.9,194957,202873,7916
48339,TX,Montgomery,,2008,4.2,203512,212533,9021
48339,TX,Montgomery,,2009,6.9,205646,220860,15214
48339,TX,Montgomery,,2010,7.6,207696,224728,17032
48339,TX,Montgomery,,2011,7.3,214730,231622,16892
48339,TX,Montgomery,,2012,5.9,224554,238639,14085
48339,TX,Montgomery,,2013,5.5,232431,245832,13401
48339,TX,Montgomery,,2014,4.5,242097,253442,11345
48339,TX,Montgomery,,2015,4.3,247267,258314,11047
48339,TX,Montgomery,,2016,4.9,252941,265996,13055
48339,TX,Montgomery,,2017,4.4,256420,268206,11786
48339,TX,Montgomery,,2018,3.8,266516,276970,10454
48339,TX,Montgomery,,2019,3.4,275842,285534,9692
48339,TX,Montgomery,,2020,7.5,266622,288088,21466
48339,TX,Montgomery,,2021,5.8,276611,293629,17018
48341,TX,Moore,,2007,2.9,10336,10650,314
48341,TX,Moore,,2008,3.1,10898,11247,349
48341,TX,Moore,,2009,4.6,11011,11545,534
48341,TX,Moore,,2010,5.4,10940,11563,623
48341,TX,Moore,,2011,5,11157,11742,585
48341,TX,Moore,,2012,4.3,11066,11563,497
48341,TX,Moore,,2013,4.3,10926,11416,490
48341,TX,Moore,,2014,3.5,10882,11279,397
48341,TX,Moore,,2015,3.1,10765,11115,350
48341,TX,Moore,,2016,3,10864,11197,333
48341,TX,Moore,,2017,2.9,10668,10987,319
48341,TX,Moore,,2018,2.7,10475,10763,288
48341,TX,Moore,,2019,2.3,10443,10690,247
48341,TX,Moore,,2020,3.7,10098,10490,392
48341,TX,Moore,,2021,3.3,10616,10983,367
48343,TX,Morris,,2007,5.3,5729,6050,321
48343,TX,Morris,,2008,6,5706,6071,365
48343,TX,Morris,,2009,14.8,5193,6095,902
48343,TX,Morris,,2010,13.8,4980,5779,799
48343,TX,Morris,,2011,12.4,5100,5820,720
48343,TX,Morris,,2012,9.7,5257,5821,564
48343,TX,Morris,,2013,9.7,5268,5831,563
48343,TX,Morris,,2014,7.9,5174,5619,445
48343,TX,Morris,,2015,8.9,4847,5318,471
48343,TX,Morris,,2016,10.9,4359,4895,536
48343,TX,Morris,,2017,8.7,4242,4645,403
48343,TX,Morris,,2018,6.6,4356,4665,309
48343,TX,Morris,,2019,5.3,4501,4753,252
48343,TX,Morris,,2020,11.2,4280,4821,541
48343,TX,Morris,,2021,10.5,4140,4624,484
48345,TX,Motley,,2007,4,656,683,27
48345,TX,Motley,,2008,4.3,662,692,30
48345,TX,Motley,,2009,5.4,651,688,37
48345,TX,Motley,,2010,6.3,585,624,39
48345,TX,Motley,,2011,7.1,551,593,42
48345,TX,Motley,,2012,6,490,521,31
48345,TX,Motley,,2013,6,471,501,30
48345,TX,Motley,,2014,4.2,475,496,21
48345,TX,Motley,,2015,3.7,475,493,18
48345,TX,Motley,,2016,3.5,490,508,18
48345,TX,Motley,,2017,3.7,473,491,18
48345,TX,Motley,,2018,3.7,441,458,17
48345,TX,Motley,,2019,3.4,451,467,16
48345,TX,Motley,,2020,4.4,410,429,19
48345,TX,Motley,,2021,5.1,430,453,23
48347,TX,Nacogdoches,,2007,4.2,29003,30273,1270
48347,TX,Nacogdoches,,2008,4.3,29501,30842,1341
48347,TX,Nacogdoches,,2009,6.5,29859,31918,2059
48347,TX,Nacogdoches,,2010,7.1,28621,30824,2203
48347,TX,Nacogdoches,,2011,7.2,28398,30605,2207
48347,TX,Nacogdoches,,2012,6.6,27554,29501,1947
48347,TX,Nacogdoches,,2013,6.6,27256,29171,1915
48347,TX,Nacogdoches,,2014,5.4,27041,28588,1547
48347,TX,Nacogdoches,,2015,4.7,26811,28142,1331
48347,TX,Nacogdoches,,2016,4.7,27375,28722,1347
48347,TX,Nacogdoches,,2017,4.3,27131,28346,1215
48347,TX,Nacogdoches,,2018,3.9,27267,28381,1114
48347,TX,Nacogdoches,,2019,3.7,26795,27831,1036
48347,TX,Nacogdoches,,2020,6.6,25828,27645,1817
48347,TX,Nacogdoches,,2021,5.5,26714,28255,1541
48349,TX,Navarro,,2007,5,19627,20652,1025
48349,TX,Navarro,,2008,5.5,19767,20917,1150
48349,TX,Navarro,,2009,7.8,19706,21378,1672
48349,TX,Navarro,,2010,8.4,20898,22807,1909
48349,TX,Navarro,,2011,8.4,21149,23078,1929
48349,TX,Navarro,,2012,7.2,21517,23191,1674
48349,TX,Navarro,,2013,6.6,21808,23345,1537
48349,TX,Navarro,,2014,5.3,21888,23110,1222
48349,TX,Navarro,,2015,4.2,21926,22898,972
48349,TX,Navarro,,2016,4.2,21822,22775,953
48349,TX,Navarro,,2017,4,21750,22648,898
48349,TX,Navarro,,2018,3.7,22552,23424,872
48349,TX,Navarro,,2019,3.3,22988,23763,775
48349,TX,Navarro,,2020,6.2,21711,23142,1431
48349,TX,Navarro,,2021,5.1,22479,23685,1206
48351,TX,Newton,,2007,6.5,5381,5758,377
48351,TX,Newton,,2008,7.4,5307,5729,422
48351,TX,Newton,,2009,11.4,5198,5868,670
48351,TX,Newton,,2010,12.8,5190,5950,760
48351,TX,Newton,,2011,13.1,5255,6050,795
48351,TX,Newton,,2012,11,5153,5789,636
48351,TX,Newton,,2013,10.8,4990,5596,606
48351,TX,Newton,,2014,8.4,5089,5555,466
48351,TX,Newton,,2015,7.6,4964,5371,407
48351,TX,Newton,,2016,7.9,4930,5355,425
48351,TX,Newton,,2017,8,4818,5239,421
48351,TX,Newton,,2018,6.8,4791,5139,348
48351,TX,Newton,,2019,6.3,4763,5084,321
48351,TX,Newton,,2020,11.1,4394,4945,551
48351,TX,Newton,,2021,10.4,4387,4897,510
48353,TX,Nolan,,2007,3.7,7259,7540,281
48353,TX,Nolan,,2008,3.9,7417,7716,299
48353,TX,Nolan,,2009,6.2,7387,7879,492
48353,TX,Nolan,,2010,7.5,6788,7341,553
48353,TX,Nolan,,2011,7.3,6816,7350,534
48353,TX,Nolan,,2012,5.9,6659,7077,418
48353,TX,Nolan,,2013,5.7,6554,6953,399
48353,TX,Nolan,,2014,4.3,6731,7037,306
48353,TX,Nolan,,2015,4.1,6633,6915,282
48353,TX,Nolan,,2016,4.8,6537,6867,330
48353,TX,Nolan,,2017,4.1,6455,6728,273
48353,TX,Nolan,,2018,3.3,6433,6653,220
48353,TX,Nolan,,2019,2.9,6751,6955,204
48353,TX,Nolan,,2020,5.4,6631,7006,375
48353,TX,Nolan,,2021,4.8,6754,7091,337
48355,TX,Nueces,,2007,4.3,150993,157826,6833
48355,TX,Nueces,,2008,4.5,155232,162583,7351
48355,TX,Nueces,,2009,6.7,154931,166093,11162
48355,TX,Nueces,,2010,8.2,149458,162751,13293
48355,TX,Nueces,,2011,8.2,150752,164259,13507
48355,TX,Nueces,,2012,6.5,155750,166630,10880
48355,TX,Nueces,,2013,6.2,157617,167975,10358
48355,TX,Nueces,,2014,5.2,159297,168014,8717
48355,TX,Nueces,,2015,5,157629,165890,8261
48355,TX,Nueces,,2016,5.6,158355,167827,9472
48355,TX,Nueces,,2017,5.5,157654,166752,9098
48355,TX,Nueces,,2018,4.7,158449,166256,7807
48355,TX,Nueces,,2019,4.1,158208,164995,6787
48355,TX,Nueces,,2020,8.9,148793,163342,14549
48355,TX,Nueces,,2021,6.9,152485,163825,11340
48357,TX,Ochiltree,,2007,2.7,5090,5229,139
48357,TX,Ochiltree,,2008,2.7,5461,5615,154
48357,TX,Ochiltree,,2009,5.9,5192,5517,325
48357,TX,Ochiltree,,2010,5.9,4584,4873,289
48357,TX,Ochiltree,,2011,5,4847,5101,254
48357,TX,Ochiltree,,2012,3.8,5105,5308,203
48357,TX,Ochiltree,,2013,3.8,5212,5418,206
48357,TX,Ochiltree,,2014,3,5395,5563,168
48357,TX,Ochiltree,,2015,4.3,5048,5274,226
48357,TX,Ochiltree,,2016,5.3,4419,4664,245
48357,TX,Ochiltree,,2017,3.7,4325,4490,165
48357,TX,Ochiltree,,2018,2.8,4289,4413,124
48357,TX,Ochiltree,,2019,2.7,4137,4250,113
48357,TX,Ochiltree,,2020,5.8,3767,4000,233
48357,TX,Ochiltree,,2021,4.6,3772,3952,180
48359,TX,Oldham,,2007,4,895,932,37
48359,TX,Oldham,,2008,4.5,863,904,41
48359,TX,Oldham,,2009,5.5,874,925,51
48359,TX,Oldham,,2010,4.7,917,962,45
48359,TX,Oldham,,2011,4.5,935,979,44
48359,TX,Oldham,,2012,4.2,909,949,40
48359,TX,Oldham,,2013,4.5,916,959,43
48359,TX,Oldham,,2014,3.7,905,940,35
48359,TX,Oldham,,2015,3,887,914,27
48359,TX,Oldham,,2016,3,881,908,27
48359,TX,Oldham,,2017,2.6,872,895,23
48359,TX,Oldham,,2018,2.7,873,897,24
48359,TX,Oldham,,2019,2.9,874,900,26
48359,TX,Oldham,,2020,3.9,853,888,35
48359,TX,Oldham,,2021,3.5,885,917,32
48361,TX,Orange,,2007,5.3,38495,40637,2142
48361,TX,Orange,,2008,6.4,38606,41255,2649
48361,TX,Orange,,2009,9.8,37440,41511,4071
48361,TX,Orange,,2010,11.7,34016,38523,4507
48361,TX,Orange,,2011,11.9,34566,39227,4661
48361,TX,Orange,,2012,10.4,34749,38780,4031
48361,TX,Orange,,2013,10.5,33940,37915,3975
48361,TX,Orange,,2014,8.1,34796,37855,3059
48361,TX,Orange,,2015,6.6,34755,37205,2450
48361,TX,Orange,,2016,6.7,34859,37368,2509
48361,TX,Orange,,2017,7,34306,36877,2571
48361,TX,Orange,,2018,5.8,34067,36177,2110
48361,TX,Orange,,2019,5.2,34151,36012,1861
48361,TX,Orange,,2020,10.6,31720,35475,3755
48361,TX,Orange,,2021,9,31719,34858,3139
48363,TX,Palo Pinto,,2007,3.7,13356,13873,517
48363,TX,Palo Pinto,,2008,4.2,13442,14028,586
48363,TX,Palo Pinto,,2009,7.8,13137,14250,1113
48363,TX,Palo Pinto,,2010,8.7,12123,13274,1151
48363,TX,Palo Pinto,,2011,8.2,12375,13476,1101
48363,TX,Palo Pinto,,2012,6.7,12489,13385,896
48363,TX,Palo Pinto,,2013,6.6,12478,13359,881
48363,TX,Palo Pinto,,2014,5.2,12660,13357,697
48363,TX,Palo Pinto,,2015,5.2,12482,13173,691
48363,TX,Palo Pinto,,2016,5.5,12530,13256,726
48363,TX,Palo Pinto,,2017,4.1,12751,13301,550
48363,TX,Palo Pinto,,2018,3.4,12920,13372,452
48363,TX,Palo Pinto,,2019,3.2,12990,13414,424
48363,TX,Palo Pinto,,2020,7,12161,13081,920
48363,TX,Palo Pinto,,2021,5.7,12161,12902,741
48365,TX,Panola,,2007,3.9,11908,12385,477
48365,TX,Panola,,2008,3.9,12506,13013,507
48365,TX,Panola,,2009,7.3,12268,13236,968
48365,TX,Panola,,2010,9.1,10383,11421,1038
48365,TX,Panola,,2011,8.4,10933,11942,1009
48365,TX,Panola,,2012,6.8,11454,12292,838
48365,TX,Panola,,2013,6.2,11930,12723,793
48365,TX,Panola,,2014,5,11913,12541,628
48365,TX,Panola,,2015,5.3,10965,11574,609
48365,TX,Panola,,2016,7.2,9500,10235,735
48365,TX,Panola,,2017,5.5,9766,10331,565
48365,TX,Panola,,2018,4.2,10151,10597,446
48365,TX,Panola,,2019,4.1,9594,9999,405
48365,TX,Panola,,2020,8.4,8554,9338,784
48365,TX,Panola,,2021,6.7,9040,9691,651
48367,TX,Parker,,2007,4.1,50007,52126,2119
48367,TX,Parker,,2008,4.4,50924,53281,2357
48367,TX,Parker,,2009,7.6,50623,54763,4140
48367,TX,Parker,,2010,7.6,52163,56484,4321
48367,TX,Parker,,2011,7.1,53236,57311,4075
48367,TX,Parker,,2012,5.9,54376,57783,3407
48367,TX,Parker,,2013,5.6,55298,58566,3268
48367,TX,Parker,,2014,4.6,56288,59018,2730
48367,TX,Parker,,2015,4.2,57095,59589,2494
48367,TX,Parker,,2016,4.1,58798,61297,2499
48367,TX,Parker,,2017,3.5,60568,62762,2194
48367,TX,Parker,,2018,3.1,63271,65311,2040
48367,TX,Parker,,2019,2.9,65947,67923,1976
48367,TX,Parker,,2020,5.8,65054,69069,4015
48367,TX,Parker,,2021,4.4,68413,71585,3172
48369,TX,Parmer,,2007,3.2,4216,4355,139
48369,TX,Parmer,,2008,3.4,4325,4476,151
48369,TX,Parmer,,2009,4.4,4433,4636,203
48369,TX,Parmer,,2010,4.4,5122,5359,237
48369,TX,Parmer,,2011,4.6,5040,5283,243
48369,TX,Parmer,,2012,4.1,4790,4994,204
48369,TX,Parmer,,2013,3.9,4859,5056,197
48369,TX,Parmer,,2014,3.1,4960,5119,159
48369,TX,Parmer,,2015,2.4,4851,4969,118
48369,TX,Parmer,,2016,2.5,4825,4950,125
48369,TX,Parmer,,2017,2.5,4761,4883,122
48369,TX,Parmer,,2018,2.4,4725,4839,114
48369,TX,Parmer,,2019,2.2,4705,4811,106
48369,TX,Parmer,,2020,2.6,4691,4814,123
48369,TX,Parmer,,2021,2.9,4834,4976,142
48371,TX,Pecos,,2007,4.3,6280,6560,280
48371,TX,Pecos,,2008,4.5,6746,7062,316
48371,TX,Pecos,,2009,8.6,7711,8433,722
48371,TX,Pecos,,2010,7.3,6659,7187,528
48371,TX,Pecos,,2011,6.2,6746,7192,446
48371,TX,Pecos,,2012,5.1,6622,6978,356
48371,TX,Pecos,,2013,5.5,6327,6692,365
48371,TX,Pecos,,2014,4.2,6565,6853,288
48371,TX,Pecos,,2015,5.2,6512,6869,357
48371,TX,Pecos,,2016,5.9,6116,6498,382
48371,TX,Pecos,,2017,4.7,5931,6224,293
48371,TX,Pecos,,2018,3.7,6122,6355,233
48371,TX,Pecos,,2019,3.3,6092,6299,207
48371,TX,Pecos,,2020,8.3,5836,6361,525
48371,TX,Pecos,,2021,7.1,5724,6164,440
48373,TX,Polk,,2007,5.9,15637,16620,983
48373,TX,Polk,,2008,6.2,15744,16788,1044
48373,TX,Polk,,2009,9,16398,18027,1629
48373,TX,Polk,,2010,9.8,15877,17598,1721
48373,TX,Polk,,2011,9.7,15954,17660,1706
48373,TX,Polk,,2012,8,16103,17500,1397
48373,TX,Polk,,2013,7.8,15990,17341,1351
48373,TX,Polk,,2014,6.5,16084,17208,1124
48373,TX,Polk,,2015,6.1,16009,17049,1040
48373,TX,Polk,,2016,6.3,16287,17388,1101
48373,TX,Polk,,2017,6.1,16330,17399,1069
48373,TX,Polk,,2018,5.1,16768,17668,900
48373,TX,Polk,,2019,4.8,16962,17818,856
48373,TX,Polk,,2020,8.8,16625,18230,1605
48373,TX,Polk,,2021,8,17079,18571,1492
48375,TX,Potter,,2007,3.9,54530,56725,2195
48375,TX,Potter,,2008,4,54395,56682,2287
48375,TX,Potter,,2009,6,54325,57790,3465
48375,TX,Potter,,2010,6.3,54437,58112,3675
48375,TX,Potter,,2011,6.1,55092,58694,3602
48375,TX,Potter,,2012,5.3,55107,58200,3093
48375,TX,Potter,,2013,5.1,54506,57418,2912
48375,TX,Potter,,2014,4,54476,56753,2277
48375,TX,Potter,,2015,3.4,54382,56271,1889
48375,TX,Potter,,2016,3.4,54294,56177,1883
48375,TX,Potter,,2017,3.2,53236,55019,1783
48375,TX,Potter,,2018,3,52762,54366,1604
48375,TX,Potter,,2019,2.7,52240,53714,1474
48375,TX,Potter,,2020,5.5,49882,52804,2922
48375,TX,Potter,,2021,4.3,51926,54259,2333
48377,TX,Presidio,,2007,9.1,2924,3215,291
48377,TX,Presidio,,2008,10.5,2999,3349,350
48377,TX,Presidio,,2009,16.1,3149,3753,604
48377,TX,Presidio,,2010,18.5,3055,3750,695
48377,TX,Presidio,,2011,15.6,3197,3789,592
48377,TX,Presidio,,2012,13.2,3312,3816,504
48377,TX,Presidio,,2013,13,3265,3751,486
48377,TX,Presidio,,2014,11.8,3008,3410,402
48377,TX,Presidio,,2015,10.7,2784,3118,334
48377,TX,Presidio,,2016,10.7,2751,3081,330
48377,TX,Presidio,,2017,9.5,2733,3020,287
48377,TX,Presidio,,2018,7,2802,3012,210
48377,TX,Presidio,,2019,6.4,2877,3075,198
48377,TX,Presidio,,2020,14.8,2704,3175,471
48377,TX,Presidio,,2021,10.5,2774,3101,327
48379,TX,Rains,,2007,4.3,4902,5121,219
48379,TX,Rains,,2008,5.1,4803,5062,259
48379,TX,Rains,,2009,8,4721,5130,409
48379,TX,Rains,,2010,8.8,4716,5173,457
48379,TX,Rains,,2011,8.5,4729,5166,437
48379,TX,Rains,,2012,6.9,4856,5218,362
48379,TX,Rains,,2013,6.2,4998,5328,330
48379,TX,Rains,,2014,5,5128,5398,270
48379,TX,Rains,,2015,4.6,5165,5414,249
48379,TX,Rains,,2016,4,5333,5556,223
48379,TX,Rains,,2017,3.6,5454,5659,205
48379,TX,Rains,,2018,3.5,5646,5852,206
48379,TX,Rains,,2019,3,5801,5983,182
48379,TX,Rains,,2020,4.7,5674,5954,280
48379,TX,Rains,,2021,3.9,6073,6318,245
48381,TX,Randall,,2007,3,65016,67007,1991
48381,TX,Randall,,2008,3.1,65645,67767,2122
48381,TX,Randall,,2009,4.6,66177,69361,3184
48381,TX,Randall,,2010,5.2,62880,66327,3447
48381,TX,Randall,,2011,5.1,64545,68026,3481
48381,TX,Randall,,2012,4.4,64982,67968,2986
48381,TX,Randall,,2013,4.3,65414,68382,2968
48381,TX,Randall,,2014,3.5,66325,68729,2404
48381,TX,Randall,,2015,2.9,67092,69109,2017
48381,TX,Randall,,2016,3,68595,70685,2090
48381,TX,Randall,,2017,2.8,68378,70379,2001
48381,TX,Randall,,2018,2.6,69078,70942,1864
48381,TX,Randall,,2019,2.4,70514,72247,1733
48381,TX,Randall,,2020,4.5,69298,72526,3228
48381,TX,Randall,,2021,3.5,71978,74603,2625
48383,TX,Reagan,,2007,2.1,2345,2395,50
48383,TX,Reagan,,2008,2.1,2491,2544,53
48383,TX,Reagan,,2009,6,2088,2221,133
48383,TX,Reagan,,2010,5.6,1807,1914,107
48383,TX,Reagan,,2011,4.5,1923,2014,91
48383,TX,Reagan,,2012,3.4,2003,2073,70
48383,TX,Reagan,,2013,4,1876,1954,78
48383,TX,Reagan,,2014,3.2,2007,2074,67
48383,TX,Reagan,,2015,4.6,1841,1929,88
48383,TX,Reagan,,2016,6.2,1597,1702,105
48383,TX,Reagan,,2017,3.9,1711,1780,69
48383,TX,Reagan,,2018,2.5,1809,1856,47
48383,TX,Reagan,,2019,2.6,1822,1871,49
48383,TX,Reagan,,2020,9.8,1615,1790,175
48383,TX,Reagan,,2021,7.7,1526,1653,127
48385,TX,Real,,2007,3.9,1318,1372,54
48385,TX,Real,,2008,3.8,1405,1460,55
48385,TX,Real,,2009,5.5,1457,1542,85
48385,TX,Real,,2010,9.1,1034,1138,104
48385,TX,Real,,2011,10.1,1020,1135,115
48385,TX,Real,,2012,9.3,965,1064,99
48385,TX,Real,,2013,8.1,975,1061,86
48385,TX,Real,,2014,6.3,991,1058,67
48385,TX,Real,,2015,5.2,1009,1064,55
48385,TX,Real,,2016,5.7,982,1041,59
48385,TX,Real,,2017,5.7,986,1046,60
48385,TX,Real,,2018,5,987,1039,52
48385,TX,Real,,2019,3.9,1007,1048,41
48385,TX,Real,,2020,6.5,1005,1075,70
48385,TX,Real,,2021,5.9,1076,1144,68
48387,TX,Red River,,2007,5,5757,6062,305
48387,TX,Red River,,2008,6.5,5546,5932,386
48387,TX,Red River,,2009,9.1,5477,6027,550
48387,TX,Red River,,2010,11.6,4941,5591,650
48387,TX,Red River,,2011,12.5,4814,5500,686
48387,TX,Red River,,2012,10.6,4690,5248,558
48387,TX,Red River,,2013,10.1,4613,5132,519
48387,TX,Red River,,2014,7.9,4544,4932,388
48387,TX,Red River,,2015,6.4,4600,4912,312
48387,TX,Red River,,2016,5.8,4744,5036,292
48387,TX,Red River,,2017,5.3,4888,5161,273
48387,TX,Red River,,2018,5.5,4765,5040,275
48387,TX,Red River,,2019,4.6,4786,5018,232
48387,TX,Red River,,2020,6.4,4746,5069,323
48387,TX,Red River,,2021,5.9,5006,5320,314
48389,TX,Reeves,,2007,5.3,3878,4094,216
48389,TX,Reeves,,2008,5.8,3940,4182,242
48389,TX,Reeves,,2009,11.4,4164,4699,535
48389,TX,Reeves,,2010,8.9,5244,5754,510
48389,TX,Reeves,,2011,8.2,5082,5538,456
48389,TX,Reeves,,2012,6.7,4974,5330,356
48389,TX,Reeves,,2013,5.8,5292,5618,326
48389,TX,Reeves,,2014,4.1,5516,5751,235
48389,TX,Reeves,,2015,4.8,5406,5680,274
48389,TX,Reeves,,2016,5.3,5715,6036,321
48389,TX,Reeves,,2017,3.6,6692,6942,250
48389,TX,Reeves,,2018,2.1,9123,9318,195
48389,TX,Reeves,,2019,1.8,10836,11031,195
48389,TX,Reeves,,2020,7.2,8112,8740,628
48389,TX,Reeves,,2021,5.9,8103,8608,505
48391,TX,Refugio,,2007,3.8,3720,3865,145
48391,TX,Refugio,,2008,3.9,3884,4041,157
48391,TX,Refugio,,2009,6.4,3887,4152,265
48391,TX,Refugio,,2010,8.8,3040,3333,293
48391,TX,Refugio,,2011,7.8,3150,3418,268
48391,TX,Refugio,,2012,6,3291,3501,210
48391,TX,Refugio,,2013,5.4,3362,3555,193
48391,TX,Refugio,,2014,4.3,3440,3595,155
48391,TX,Refugio,,2015,5.4,3131,3308,177
48391,TX,Refugio,,2016,6.6,2929,3137,208
48391,TX,Refugio,,2017,5.6,3037,3218,181
48391,TX,Refugio,,2018,4.6,2963,3107,144
48391,TX,Refugio,,2019,3.7,2995,3110,115
48391,TX,Refugio,,2020,8.2,2773,3022,249
48391,TX,Refugio,,2021,6.7,2833,3037,204
48393,TX,Roberts,,2007,2.3,548,561,13
48393,TX,Roberts,,2008,2.5,554,568,14
48393,TX,Roberts,,2009,4.8,557,585,28
48393,TX,Roberts,,2010,5.4,455,481,26
48393,TX,Roberts,,2011,5,455,479,24
48393,TX,Roberts,,2012,4.9,447,470,23
48393,TX,Roberts,,2013,4.5,429,449,20
48393,TX,Roberts,,2014,3.8,433,450,17
48393,TX,Roberts,,2015,3.9,438,456,18
48393,TX,Roberts,,2016,4.5,422,442,20
48393,TX,Roberts,,2017,3.9,421,438,17
48393,TX,Roberts,,2018,2.8,412,424,12
48393,TX,Roberts,,2019,2.9,400,412,12
48393,TX,Roberts,,2020,4.5,381,399,18
48393,TX,Roberts,,2021,4.3,382,399,17
48395,TX,Robertson,,2007,5.1,6561,6912,351
48395,TX,Robertson,,2008,5,6599,6945,346
48395,TX,Robertson,,2009,7.8,6676,7240,564
48395,TX,Robertson,,2010,9.3,6871,7572,701
48395,TX,Robertson,,2011,9.5,6829,7544,715
48395,TX,Robertson,,2012,8,6691,7272,581
48395,TX,Robertson,,2013,7.1,6761,7274,513
48395,TX,Robertson,,2014,5.4,6749,7138,389
48395,TX,Robertson,,2015,4.8,6903,7251,348
48395,TX,Robertson,,2016,5.1,6890,7258,368
48395,TX,Robertson,,2017,4.8,7040,7392,352
48395,TX,Robertson,,2018,4.2,7150,7464,314
48395,TX,Robertson,,2019,3.6,7112,7379,267
48395,TX,Robertson,,2020,6.4,6791,7257,466
48395,TX,Robertson,,2021,5.3,7159,7557,398
48397,TX,Rockwall,,2007,4,35488,36954,1466
48397,TX,Rockwall,,2008,4.5,36454,38177,1723
48397,TX,Rockwall,,2009,7.1,36626,39443,2817
48397,TX,Rockwall,,2010,7.4,36559,39496,2937
48397,TX,Rockwall,,2011,7.3,37619,40591,2972
48397,TX,Rockwall,,2012,6.1,38572,41096,2524
48397,TX,Rockwall,,2013,5.8,39743,42189,2446
48397,TX,Rockwall,,2014,4.6,41366,43349,1983
48397,TX,Rockwall,,2015,3.8,43216,44915,1699
48397,TX,Rockwall,,2016,3.5,45704,47367,1663
48397,TX,Rockwall,,2017,3.4,46960,48607,1647
48397,TX,Rockwall,,2018,3.3,48793,50434,1641
48397,TX,Rockwall,,2019,3.1,51236,52858,1622
48397,TX,Rockwall,,2020,5.9,51050,54262,3212
48397,TX,Rockwall,,2021,4.3,54240,56678,2438
48399,TX,Runnels,,2007,4.4,4223,4419,196
48399,TX,Runnels,,2008,4.8,4247,4461,214
48399,TX,Runnels,,2009,7.5,4233,4574,341
48399,TX,Runnels,,2010,8.4,4707,5136,429
48399,TX,Runnels,,2011,7.6,4719,5106,387
48399,TX,Runnels,,2012,5.5,4771,5048,277
48399,TX,Runnels,,2013,5.3,4705,4969,264
48399,TX,Runnels,,2014,4.3,4751,4964,213
48399,TX,Runnels,,2015,3.7,4498,4673,175
48399,TX,Runnels,,2016,4,4465,4649,184
48399,TX,Runnels,,2017,3.7,4377,4546,169
48399,TX,Runnels,,2018,3.2,4389,4533,144
48399,TX,Runnels,,2019,2.8,4416,4543,127
48399,TX,Runnels,,2020,4.9,4274,4495,221
48399,TX,Runnels,,2021,4.1,4430,4618,188
48401,TX,Rusk,,2007,4.2,22447,23430,983
48401,TX,Rusk,,2008,4.3,23059,24094,1035
48401,TX,Rusk,,2009,7.7,22449,24334,1885
48401,TX,Rusk,,2010,7.9,22112,23996,1884
48401,TX,Rusk,,2011,7.3,22505,24273,1768
48401,TX,Rusk,,2012,6.2,23000,24532,1532
48401,TX,Rusk,,2013,6.3,22744,24263,1519
48401,TX,Rusk,,2014,5,22965,24172,1207
48401,TX,Rusk,,2015,4.8,21758,22853,1095
48401,TX,Rusk,,2016,5.8,21076,22382,1306
48401,TX,Rusk,,2017,5.1,20838,21962,1124
48401,TX,Rusk,,2018,4.1,21624,22550,926
48401,TX,Rusk,,2019,3.6,21814,22625,811
48401,TX,Rusk,,2020,7.3,20199,21800,1601
48401,TX,Rusk,,2021,6,20721,22047,1326
48403,TX,Sabine,,2007,8.2,3113,3390,277
48403,TX,Sabine,,2008,9,3092,3397,305
48403,TX,Sabine,,2009,14.9,3019,3549,530
48403,TX,Sabine,,2010,16.4,3061,3661,600
48403,TX,Sabine,,2011,16.2,2908,3470,562
48403,TX,Sabine,,2012,14.4,2890,3378,488
48403,TX,Sabine,,2013,13,3093,3556,463
48403,TX,Sabine,,2014,10.7,3161,3540,379
48403,TX,Sabine,,2015,9.4,3176,3505,329
48403,TX,Sabine,,2016,9.4,3157,3484,327
48403,TX,Sabine,,2017,8.7,3241,3548,307
48403,TX,Sabine,,2018,8,3232,3512,280
48403,TX,Sabine,,2019,6.6,3467,3711,244
48403,TX,Sabine,,2020,10.8,3452,3871,419
48403,TX,Sabine,,2021,9.5,3587,3965,378
48405,TX,San Augustine,,2007,5.5,3309,3501,192
48405,TX,San Augustine,,2008,6.2,3287,3505,218
48405,TX,San Augustine,,2009,10,3252,3614,362
48405,TX,San Augustine,,2010,13.1,2782,3201,419
48405,TX,San Augustine,,2011,14.6,2699,3160,461
48405,TX,San Augustine,,2012,12,2654,3017,363
48405,TX,San Augustine,,2013,11.7,2588,2931,343
48405,TX,San Augustine,,2014,9.7,2550,2823,273
48405,TX,San Augustine,,2015,9.1,2545,2801,256
48405,TX,San Augustine,,2016,8.9,2554,2805,251
48405,TX,San Augustine,,2017,7.5,2633,2848,215
48405,TX,San Augustine,,2018,6.5,2784,2977,193
48405,TX,San Augustine,,2019,4.8,3175,3334,159
48405,TX,San Augustine,,2020,9.6,2711,2999,288
48405,TX,San Augustine,,2021,8.2,2734,2979,245
48407,TX,San Jacinto,,2007,5.2,9459,9982,523
48407,TX,San Jacinto,,2008,5.8,9500,10084,584
48407,TX,San Jacinto,,2009,9.3,9226,10167,941
48407,TX,San Jacinto,,2010,10,10120,11248,1128
48407,TX,San Jacinto,,2011,10,10238,11370,1132
48407,TX,San Jacinto,,2012,8.2,10508,11444,936
48407,TX,San Jacinto,,2013,7.6,10561,11431,870
48407,TX,San Jacinto,,2014,5.8,10732,11397,665
48407,TX,San Jacinto,,2015,5.6,10657,11295,638
48407,TX,San Jacinto,,2016,6.3,10713,11431,718
48407,TX,San Jacinto,,2017,5.8,10723,11379,656
48407,TX,San Jacinto,,2018,5,10837,11409,572
48407,TX,San Jacinto,,2019,4.6,11073,11605,532
48407,TX,San Jacinto,,2020,8.1,10594,11529,935
48407,TX,San Jacinto,,2021,7.4,10994,11871,877
48409,TX,San Patricio,,2007,4.9,27665,29104,1439
48409,TX,San Patricio,,2008,5.3,28310,29907,1597
48409,TX,San Patricio,,2009,8.5,28097,30713,2616
48409,TX,San Patricio,,2010,10.6,27270,30497,3227
48409,TX,San Patricio,,2011,10,27210,30246,3036
48409,TX,San Patricio,,2012,7.5,28073,30362,2289
48409,TX,San Patricio,,2013,7.2,28390,30606,2216
48409,TX,San Patricio,,2014,6.3,28708,30646,1938
48409,TX,San Patricio,,2015,6.6,28264,30250,1986
48409,TX,San Patricio,,2016,7.5,28335,30623,2288
48409,TX,San Patricio,,2017,7.7,27997,30345,2348
48409,TX,San Patricio,,2018,6.4,27897,29799,1902
48409,TX,San Patricio,,2019,5.5,27801,29413,1612
48409,TX,San Patricio,,2020,10.2,26222,29203,2981
48409,TX,San Patricio,,2021,8.8,26830,29428,2598
48411,TX,San Saba,,2007,4.7,2356,2473,117
48411,TX,San Saba,,2008,5.5,2281,2414,133
48411,TX,San Saba,,2009,7.1,2288,2462,174
48411,TX,San Saba,,2010,6.2,2403,2563,160
48411,TX,San Saba,,2011,6.2,2362,2519,157
48411,TX,San Saba,,2012,6.2,2148,2290,142
48411,TX,San Saba,,2013,5.8,2138,2269,131
48411,TX,San Saba,,2014,4.2,2134,2228,94
48411,TX,San Saba,,2015,3.7,2163,2246,83
48411,TX,San Saba,,2016,3.4,2365,2448,83
48411,TX,San Saba,,2017,3.3,2321,2399,78
48411,TX,San Saba,,2018,3.1,2436,2513,77
48411,TX,San Saba,,2019,3,2430,2504,74
48411,TX,San Saba,,2020,5.2,2062,2174,112
48411,TX,San Saba,,2021,4.7,2100,2203,103
48413,TX,Schleicher,,2007,3.5,1366,1416,50
48413,TX,Schleicher,,2008,3.3,1421,1470,49
48413,TX,Schleicher,,2009,9.3,1373,1513,140
48413,TX,Schleicher,,2010,7.7,1511,1637,126
48413,TX,Schleicher,,2011,5.9,1598,1699,101
48413,TX,Schleicher,,2012,4,1706,1777,71
48413,TX,Schleicher,,2013,3.6,1735,1799,64
48413,TX,Schleicher,,2014,3,1722,1776,54
48413,TX,Schleicher,,2015,5.3,1422,1502,80
48413,TX,Schleicher,,2016,5.2,1347,1421,74
48413,TX,Schleicher,,2017,3.8,1274,1324,50
48413,TX,Schleicher,,2018,2.9,1318,1357,39
48413,TX,Schleicher,,2019,2.9,1257,1294,37
48413,TX,Schleicher,,2020,6.9,1118,1201,83
48413,TX,Schleicher,,2021,5.5,1126,1192,66
48415,TX,Scurry,,2007,3.8,7013,7293,280
48415,TX,Scurry,,2008,4,7245,7548,303
48415,TX,Scurry,,2009,6.7,7262,7784,522
48415,TX,Scurry,,2010,6.8,6625,7111,486
48415,TX,Scurry,,2011,5.9,6965,7398,433
48415,TX,Scurry,,2012,4.4,7740,8100,360
48415,TX,Scurry,,2013,4.2,8189,8547,358
48415,TX,Scurry,,2014,3.4,8308,8598,290
48415,TX,Scurry,,2015,4.2,7829,8170,341
48415,TX,Scurry,,2016,5.9,6973,7410,437
48415,TX,Scurry,,2017,4.4,6633,6936,303
48415,TX,Scurry,,2018,3.4,6627,6861,234
48415,TX,Scurry,,2019,3.2,6367,6580,213
48415,TX,Scurry,,2020,8.2,5661,6169,508
48415,TX,Scurry,,2021,6.7,5678,6086,408
48417,TX,Shackelford,,2007,2.6,1992,2046,54
48417,TX,Shackelford,,2008,2.6,2089,2145,56
48417,TX,Shackelford,,2009,4,2048,2133,85
48417,TX,Shackelford,,2010,5.6,1800,1907,107
48417,TX,Shackelford,,2011,4.9,1906,2004,98
48417,TX,Shackelford,,2012,3.5,2131,2208,77
48417,TX,Shackelford,,2013,3.3,2216,2292,76
48417,TX,Shackelford,,2014,2.8,2304,2370,66
48417,TX,Shackelford,,2015,2.9,2023,2083,60
48417,TX,Shackelford,,2016,3.8,1806,1878,72
48417,TX,Shackelford,,2017,3,1818,1874,56
48417,TX,Shackelford,,2018,2.3,1880,1925,45
48417,TX,Shackelford,,2019,2.2,1841,1882,41
48417,TX,Shackelford,,2020,5.3,1670,1763,93
48417,TX,Shackelford,,2021,4,1771,1845,74
48419,TX,Shelby,,2007,4.3,11664,12185,521
48419,TX,Shelby,,2008,4.8,11841,12435,594
48419,TX,Shelby,,2009,7.2,11732,12648,916
48419,TX,Shelby,,2010,8.5,10848,11857,1009
48419,TX,Shelby,,2011,8.8,10918,11976,1058
48419,TX,Shelby,,2012,7.2,11224,12097,873
48419,TX,Shelby,,2013,7.5,10741,11610,869
48419,TX,Shelby,,2014,5.9,10911,11598,687
48419,TX,Shelby,,2015,5.3,10780,11383,603
48419,TX,Shelby,,2016,6,10300,10959,659
48419,TX,Shelby,,2017,5.2,10143,10700,557
48419,TX,Shelby,,2018,4.3,10444,10917,473
48419,TX,Shelby,,2019,3.9,10583,11016,433
48419,TX,Shelby,,2020,6.8,10377,11138,761
48419,TX,Shelby,,2021,5.4,10862,11484,622
48421,TX,Sherman,,2007,3.5,1295,1342,47
48421,TX,Sherman,,2008,3.8,1402,1457,55
48421,TX,Sherman,,2009,4.4,1385,1448,63
48421,TX,Sherman,,2010,4.6,1485,1557,72
48421,TX,Sherman,,2011,4.7,1502,1576,74
48421,TX,Sherman,,2012,4.1,1438,1500,62
48421,TX,Sherman,,2013,4.1,1417,1477,60
48421,TX,Sherman,,2014,3.2,1455,1503,48
48421,TX,Sherman,,2015,2.7,1382,1421,39
48421,TX,Sherman,,2016,3,1311,1351,40
48421,TX,Sherman,,2017,3.1,1240,1280,40
48421,TX,Sherman,,2018,2.7,1282,1317,35
48421,TX,Sherman,,2019,2.4,1320,1352,32
48421,TX,Sherman,,2020,3.1,1255,1295,40
48421,TX,Sherman,,2021,3,1366,1408,42
48423,TX,Smith,,2007,4.2,92708,96807,4099
48423,TX,Smith,,2008,4.9,93950,98766,4816
48423,TX,Smith,,2009,7.5,93095,100678,7583
48423,TX,Smith,,2010,8,93200,101316,8116
48423,TX,Smith,,2011,8,93893,102096,8203
48423,TX,Smith,,2012,7,94425,101520,7095
48423,TX,Smith,,2013,6.6,94758,101447,6689
48423,TX,Smith,,2014,5.3,96723,102112,5389
48423,TX,Smith,,2015,4.5,99100,103777,4677
48423,TX,Smith,,2016,4.5,100706,105484,4778
48423,TX,Smith,,2017,4.1,100901,105250,4349
48423,TX,Smith,,2018,3.7,101901,105793,3892
48423,TX,Smith,,2019,3.3,103438,107008,3570
48423,TX,Smith,,2020,6.8,100209,107502,7293
48423,TX,Smith,,2021,5.1,104439,110095,5656
48425,TX,Somervell,,2007,4.5,3716,3891,175
48425,TX,Somervell,,2008,4.5,3927,4112,185
48425,TX,Somervell,,2009,7.1,3936,4235,299
48425,TX,Somervell,,2010,8,3725,4050,325
48425,TX,Somervell,,2011,8.1,3756,4085,329
48425,TX,Somervell,,2012,6.6,3862,4134,272
48425,TX,Somervell,,2013,6.1,3887,4139,252
48425,TX,Somervell,,2014,5.2,3916,4131,215
48425,TX,Somervell,,2015,5.1,3904,4112,208
48425,TX,Somervell,,2016,4.8,3935,4134,199
48425,TX,Somervell,,2017,4.6,3966,4157,191
48425,TX,Somervell,,2018,4.2,4074,4251,177
48425,TX,Somervell,,2019,3.6,4163,4318,155
48425,TX,Somervell,,2020,6.5,3963,4240,277
48425,TX,Somervell,,2021,5.2,4170,4398,228
48427,TX,Starr,,2007,10.8,19020,21314,2294
48427,TX,Starr,,2008,11.4,19739,22286,2547
48427,TX,Starr,,2009,16.4,20479,24489,4010
48427,TX,Starr,,2010,17.4,21586,26122,4536
48427,TX,Starr,,2011,16.7,21862,26232,4370
48427,TX,Starr,,2012,14.4,22207,25957,3750
48427,TX,Starr,,2013,15.1,22345,26311,3966
48427,TX,Starr,,2014,13.8,22401,25990,3589
48427,TX,Starr,,2015,13.6,22395,25911,3516
48427,TX,Starr,,2016,13.4,22837,26365,3528
48427,TX,Starr,,2017,11.9,22854,25930,3076
48427,TX,Starr,,2018,10.2,22411,24951,2540
48427,TX,Starr,,2019,9.9,22394,24851,2457
48427,TX,Starr,,2020,17.5,21375,25912,4537
48427,TX,Starr,,2021,16.2,21263,25381,4118
48429,TX,Stephens,,2007,3.6,4313,4473,160
48429,TX,Stephens,,2008,3.7,4512,4683,171
48429,TX,Stephens,,2009,6.7,4329,4641,312
48429,TX,Stephens,,2010,7.5,3932,4251,319
48429,TX,Stephens,,2011,8.1,4082,4440,358
48429,TX,Stephens,,2012,5.9,4116,4373,257
48429,TX,Stephens,,2013,5.2,3980,4199,219
48429,TX,Stephens,,2014,4.4,4095,4285,190
48429,TX,Stephens,,2015,4.2,3935,4108,173
48429,TX,Stephens,,2016,5.3,3807,4019,212
48429,TX,Stephens,,2017,4.6,3794,3976,182
48429,TX,Stephens,,2018,3.6,3811,3955,144
48429,TX,Stephens,,2019,3,3922,4044,122
48429,TX,Stephens,,2020,6.1,3752,3995,243
48429,TX,Stephens,,2021,4.9,3984,4190,206
48431,TX,Sterling,,2007,2.9,768,791,23
48431,TX,Sterling,,2008,2.9,825,850,25
48431,TX,Sterling,,2009,4.2,822,858,36
48431,TX,Sterling,,2010,4.9,644,677,33
48431,TX,Sterling,,2011,5,647,681,34
48431,TX,Sterling,,2012,3.5,693,718,25
48431,TX,Sterling,,2013,3.9,721,750,29
48431,TX,Sterling,,2014,3,787,811,24
48431,TX,Sterling,,2015,3.5,721,747,26
48431,TX,Sterling,,2016,3.9,644,670,26
48431,TX,Sterling,,2017,3.7,567,589,22
48431,TX,Sterling,,2018,3.5,557,577,20
48431,TX,Sterling,,2019,3.2,550,568,18
48431,TX,Sterling,,2020,6.5,519,555,36
48431,TX,Sterling,,2021,5.1,556,586,30
48433,TX,Stonewall,,2007,3.2,850,878,28
48433,TX,Stonewall,,2008,3.4,833,862,29
48433,TX,Stonewall,,2009,4.2,815,851,36
48433,TX,Stonewall,,2010,5.8,704,747,43
48433,TX,Stonewall,,2011,5.6,703,745,42
48433,TX,Stonewall,,2012,4.3,714,746,32
48433,TX,Stonewall,,2013,4.8,673,707,34
48433,TX,Stonewall,,2014,3.9,669,696,27
48433,TX,Stonewall,,2015,4.4,634,663,29
48433,TX,Stonewall,,2016,4.4,612,640,28
48433,TX,Stonewall,,2017,3.6,588,610,22
48433,TX,Stonewall,,2018,3.4,564,584,20
48433,TX,Stonewall,,2019,2.9,560,577,17
48433,TX,Stonewall,,2020,5.1,539,568,29
48433,TX,Stonewall,,2021,4.1,563,587,24
48435,TX,Sutton,,2007,2.2,3039,3106,67
48435,TX,Sutton,,2008,2,3448,3517,69
48435,TX,Sutton,,2009,7.1,3214,3459,245
48435,TX,Sutton,,2010,9.8,1801,1997,196
48435,TX,Sutton,,2011,7.1,1809,1948,139
48435,TX,Sutton,,2012,4.8,1913,2010,97
48435,TX,Sutton,,2013,4.6,1966,2061,95
48435,TX,Sutton,,2014,3.6,1945,2018,73
48435,TX,Sutton,,2015,6.1,1615,1720,105
48435,TX,Sutton,,2016,8,1465,1592,127
48435,TX,Sutton,,2017,5.1,1419,1496,77
48435,TX,Sutton,,2018,3.9,1388,1444,56
48435,TX,Sutton,,2019,3.7,1348,1400,52
48435,TX,Sutton,,2020,9.9,1085,1204,119
48435,TX,Sutton,,2021,8.3,1054,1149,95
48437,TX,Swisher,,2007,4.3,3338,3489,151
48437,TX,Swisher,,2008,4.5,3401,3560,159
48437,TX,Swisher,,2009,5.7,3450,3659,209
48437,TX,Swisher,,2010,6.6,2976,3186,210
48437,TX,Swisher,,2011,7,2930,3149,219
48437,TX,Swisher,,2012,5.9,2863,3043,180
48437,TX,Swisher,,2013,8.5,2707,2959,252
48437,TX,Swisher,,2014,6.2,2699,2878,179
48437,TX,Swisher,,2015,4.8,2602,2733,131
48437,TX,Swisher,,2016,4.3,2600,2716,116
48437,TX,Swisher,,2017,4.1,2561,2671,110
48437,TX,Swisher,,2018,4.3,2514,2627,113
48437,TX,Swisher,,2019,3.7,2489,2584,95
48437,TX,Swisher,,2020,5.2,2369,2499,130
48437,TX,Swisher,,2021,4.9,2465,2593,128
48439,TX,Tarrant,,2007,4.3,831763,869387,37624
48439,TX,Tarrant,,2008,4.8,839259,881829,42570
48439,TX,Tarrant,,2009,7.7,829943,898809,68866
48439,TX,Tarrant,,2010,8.2,850393,926222,75829
48439,TX,Tarrant,,2011,7.8,875968,950017,74049
48439,TX,Tarrant,,2012,6.5,901503,963879,62376
48439,TX,Tarrant,,2013,6.1,919846,979558,59712
48439,TX,Tarrant,,2014,5.1,939109,989579,50470
48439,TX,Tarrant,,2015,4.2,950296,991895,41599
48439,TX,Tarrant,,2016,4,971204,1011543,40339
48439,TX,Tarrant,,2017,3.8,989989,1028588,38599
48439,TX,Tarrant,,2018,3.5,1012587,1049714,37127
48439,TX,Tarrant,,2019,3.3,1031409,1066885,35476
48439,TX,Tarrant,,2020,7.4,991029,1070120,79091
48439,TX,Tarrant,,2021,5.3,1041556,1099856,58300
48441,TX,Taylor,,2007,3.5,63183,65470,2287
48441,TX,Taylor,,2008,3.7,64705,67200,2495
48441,TX,Taylor,,2009,5.6,64222,68021,3799
48441,TX,Taylor,,2010,6.8,59989,64370,4381
48441,TX,Taylor,,2011,6.8,60239,64622,4383
48441,TX,Taylor,,2012,5.6,60712,64331,3619
48441,TX,Taylor,,2013,5.3,61099,64530,3431
48441,TX,Taylor,,2014,4.3,61569,64315,2746
48441,TX,Taylor,,2015,3.7,61031,63374,2343
48441,TX,Taylor,,2016,3.7,60949,63322,2373
48441,TX,Taylor,,2017,3.6,61462,63732,2270
48441,TX,Taylor,,2018,3.2,62647,64707,2060
48441,TX,Taylor,,2019,2.9,64105,65996,1891
48441,TX,Taylor,,2020,5.5,61986,65565,3579
48441,TX,Taylor,,2021,4.3,64246,67165,2919
48443,TX,Terrell,,2007,5,339,357,18
48443,TX,Terrell,,2008,6.6,309,331,22
48443,TX,Terrell,,2009,9.1,349,384,35
48443,TX,Terrell,,2010,6.8,467,501,34
48443,TX,Terrell,,2011,6.4,484,517,33
48443,TX,Terrell,,2012,4.6,522,547,25
48443,TX,Terrell,,2013,5,497,523,26
48443,TX,Terrell,,2014,4.6,457,479,22
48443,TX,Terrell,,2015,4.8,414,435,21
48443,TX,Terrell,,2016,4.2,390,407,17
48443,TX,Terrell,,2017,4.6,372,390,18
48443,TX,Terrell,,2018,3.5,361,374,13
48443,TX,Terrell,,2019,3.5,360,373,13
48443,TX,Terrell,,2020,4.5,360,377,17
48443,TX,Terrell,,2021,3.6,396,411,15
48445,TX,Terry,,2007,4.6,5451,5716,265
48445,TX,Terry,,2008,4.2,5620,5866,246
48445,TX,Terry,,2009,6.8,5632,6046,414
48445,TX,Terry,,2010,7.5,5333,5764,431
48445,TX,Terry,,2011,7.3,5420,5849,429
48445,TX,Terry,,2012,6.5,5284,5651,367
48445,TX,Terry,,2013,6,5192,5522,330
48445,TX,Terry,,2014,4.4,5360,5604,244
48445,TX,Terry,,2015,4.7,5150,5405,255
48445,TX,Terry,,2016,4.8,5096,5352,256
48445,TX,Terry,,2017,5.1,4942,5205,263
48445,TX,Terry,,2018,4.1,4873,5082,209
48445,TX,Terry,,2019,3.6,4758,4938,180
48445,TX,Terry,,2020,7.3,4422,4771,349
48445,TX,Terry,,2021,6.1,4484,4776,292
48447,TX,Throckmorton,,2007,3.8,933,970,37
48447,TX,Throckmorton,,2008,3.5,910,943,33
48447,TX,Throckmorton,,2009,4.8,986,1036,50
48447,TX,Throckmorton,,2010,6,825,878,53
48447,TX,Throckmorton,,2011,7.2,809,872,63
48447,TX,Throckmorton,,2012,5.3,785,829,44
48447,TX,Throckmorton,,2013,5,754,794,40
48447,TX,Throckmorton,,2014,4,798,831,33
48447,TX,Throckmorton,,2015,3.2,756,781,25
48447,TX,Throckmorton,,2016,3.5,717,743,26
48447,TX,Throckmorton,,2017,4.4,656,686,30
48447,TX,Throckmorton,,2018,3.3,671,694,23
48447,TX,Throckmorton,,2019,3.7,617,641,24
48447,TX,Throckmorton,,2020,4.7,603,633,30
48447,TX,Throckmorton,,2021,2.8,980,1008,28
48449,TX,Titus,,2007,3.8,13746,14288,542
48449,TX,Titus,,2008,4.3,13512,14119,607
48449,TX,Titus,,2009,7.2,13315,14348,1033
48449,TX,Titus,,2010,8.6,12808,14009,1201
48449,TX,Titus,,2011,8.5,12551,13716,1165
48449,TX,Titus,,2012,7.5,12248,13236,988
48449,TX,Titus,,2013,7.5,12077,13055,978
48449,TX,Titus,,2014,6.4,12071,12894,823
48449,TX,Titus,,2015,5.8,12002,12741,739
48449,TX,Titus,,2016,6.2,12088,12884,796
48449,TX,Titus,,2017,5.4,12157,12856,699
48449,TX,Titus,,2018,5.1,12127,12775,648
48449,TX,Titus,,2019,4.1,12253,12782,529
48449,TX,Titus,,2020,6.7,12268,13153,885
48449,TX,Titus,,2021,5.4,12837,13563,726
48451,TX,Tom Green,,2007,3.7,49817,51747,1930
48451,TX,Tom Green,,2008,4.1,49576,51710,2134
48451,TX,Tom Green,,2009,6.3,49612,52942,3330
48451,TX,Tom Green,,2010,6.6,49196,52663,3467
48451,TX,Tom Green,,2011,6.5,49775,53211,3436
48451,TX,Tom Green,,2012,5.3,50819,53663,2844
48451,TX,Tom Green,,2013,5.2,51314,54129,2815
48451,TX,Tom Green,,2014,4.1,52349,54580,2231
48451,TX,Tom Green,,2015,4.1,52313,54568,2255
48451,TX,Tom Green,,2016,4.5,51838,54272,2434
48451,TX,Tom Green,,2017,3.7,51770,53759,1989
48451,TX,Tom Green,,2018,3.2,52400,54115,1715
48451,TX,Tom Green,,2019,3,52351,53983,1632
48451,TX,Tom Green,,2020,6.3,49931,53310,3379
48451,TX,Tom Green,,2021,4.9,51382,54009,2627
48453,TX,Travis,,2007,3.7,509961,529314,19353
48453,TX,Travis,,2008,4.2,514663,537471,22808
48453,TX,Travis,,2009,6.7,512405,548967,36562
48453,TX,Travis,,2010,6.8,537174,576411,39237
48453,TX,Travis,,2011,6.6,554438,593506,39068
48453,TX,Travis,,2012,5.5,577445,610842,33397
48453,TX,Travis,,2013,5.1,596682,628618,31936
48453,TX,Travis,,2014,4.1,616779,643405,26626
48453,TX,Travis,,2015,3.3,634230,655919,21689
48453,TX,Travis,,2016,3.2,656873,678480,21607
48453,TX,Travis,,2017,3.1,672102,693425,21323
48453,TX,Travis,,2018,2.9,691743,712216,20473
48453,TX,Travis,,2019,2.6,709594,728706,19112
48453,TX,Travis,,2020,6.4,684165,730591,46426
48453,TX,Travis,,2021,4,739716,770868,31152
48455,TX,Trinity,,2007,4.8,5563,5846,283
48455,TX,Trinity,,2008,5.5,5482,5800,318
48455,TX,Trinity,,2009,8.4,5422,5922,500
48455,TX,Trinity,,2010,9.6,5237,5792,555
48455,TX,Trinity,,2011,9.9,5157,5723,566
48455,TX,Trinity,,2012,8.2,5108,5562,454
48455,TX,Trinity,,2013,7.5,5140,5559,419
48455,TX,Trinity,,2014,6.1,5180,5516,336
48455,TX,Trinity,,2015,5.9,5159,5485,326
48455,TX,Trinity,,2016,6.1,5151,5485,334
48455,TX,Trinity,,2017,5.6,5040,5338,298
48455,TX,Trinity,,2018,5.2,4991,5264,273
48455,TX,Trinity,,2019,4.8,4985,5234,249
48455,TX,Trinity,,2020,8.1,4836,5264,428
48455,TX,Trinity,,2021,7.3,4962,5355,393
48457,TX,Tyler,,2007,5.5,7606,8052,446
48457,TX,Tyler,,2008,6,7753,8249,496
48457,TX,Tyler,,2009,9.7,7644,8464,820
48457,TX,Tyler,,2010,11.8,6980,7914,934
48457,TX,Tyler,,2011,12.4,6876,7850,974
48457,TX,Tyler,,2012,10.6,6757,7560,803
48457,TX,Tyler,,2013,10.3,6804,7589,785
48457,TX,Tyler,,2014,8.1,6956,7568,612
48457,TX,Tyler,,2015,7.1,6851,7371,520
48457,TX,Tyler,,2016,7.3,6689,7217,528
48457,TX,Tyler,,2017,7.4,6502,7022,520
48457,TX,Tyler,,2018,6.7,6455,6916,461
48457,TX,Tyler,,2019,5.7,6666,7071,405
48457,TX,Tyler,,2020,9.9,6575,7296,721
48457,TX,Tyler,,2021,8.5,6779,7409,630
48459,TX,Upshur,,2007,4,18385,19161,776
48459,TX,Upshur,,2008,4.2,18964,19804,840
48459,TX,Upshur,,2009,7.5,18221,19707,1486
48459,TX,Upshur,,2010,8.8,16691,18309,1618
48459,TX,Upshur,,2011,8.2,17079,18607,1528
48459,TX,Upshur,,2012,6.7,17430,18681,1251
48459,TX,Upshur,,2013,6.4,17309,18502,1193
48459,TX,Upshur,,2014,5.2,17585,18551,966
48459,TX,Upshur,,2015,5.3,17032,17983,951
48459,TX,Upshur,,2016,6.4,16754,17903,1149
48459,TX,Upshur,,2017,5.3,16659,17589,930
48459,TX,Upshur,,2018,4.2,16765,17505,740
48459,TX,Upshur,,2019,3.7,17128,17787,659
48459,TX,Upshur,,2020,7.7,16041,17379,1338
48459,TX,Upshur,,2021,6.3,16456,17555,1099
48461,TX,Upton,,2007,3.1,1610,1661,51
48461,TX,Upton,,2008,3.1,1721,1776,55
48461,TX,Upton,,2009,5.4,1723,1822,99
48461,TX,Upton,,2010,6.2,1459,1555,96
48461,TX,Upton,,2011,5.5,1483,1569,86
48461,TX,Upton,,2012,4,1524,1588,64
48461,TX,Upton,,2013,4.2,1636,1707,71
48461,TX,Upton,,2014,3.3,1811,1872,61
48461,TX,Upton,,2015,3.9,1714,1784,70
48461,TX,Upton,,2016,5.3,1498,1582,84
48461,TX,Upton,,2017,3.8,1478,1536,58
48461,TX,Upton,,2018,3.5,1511,1565,54
48461,TX,Upton,,2019,3,1587,1636,49
48461,TX,Upton,,2020,5.7,1696,1799,103
48461,TX,Upton,,2021,5.2,1670,1762,92
48463,TX,Uvalde,,2007,5.3,10385,10969,584
48463,TX,Uvalde,,2008,5.7,10526,11168,642
48463,TX,Uvalde,,2009,7.9,10707,11623,916
48463,TX,Uvalde,,2010,9,10779,11844,1065
48463,TX,Uvalde,,2011,9.2,11031,12144,1113
48463,TX,Uvalde,,2012,7.9,10982,11924,942
48463,TX,Uvalde,,2013,7.1,11086,11927,841
48463,TX,Uvalde,,2014,5.8,10997,11671,674
48463,TX,Uvalde,,2015,5.1,11093,11687,594
48463,TX,Uvalde,,2016,5.3,11184,11813,629
48463,TX,Uvalde,,2017,4.7,11069,11617,548
48463,TX,Uvalde,,2018,4.3,10869,11358,489
48463,TX,Uvalde,,2019,3.8,10918,11347,429
48463,TX,Uvalde,,2020,6.4,10488,11208,720
48463,TX,Uvalde,,2021,5.5,10631,11252,621
48465,TX,Val Verde,,2007,5.5,19128,20242,1114
48465,TX,Val Verde,,2008,5.8,19254,20442,1188
48465,TX,Val Verde,,2009,9.2,19122,21055,1933
48465,TX,Val Verde,,2010,9.3,18722,20650,1928
48465,TX,Val Verde,,2011,9.3,18566,20466,1900
48465,TX,Val Verde,,2012,7.6,18452,19965,1513
48465,TX,Val Verde,,2013,7.5,18134,19594,1460
48465,TX,Val Verde,,2014,5.8,18231,19358,1127
48465,TX,Val Verde,,2015,6,18398,19581,1183
48465,TX,Val Verde,,2016,6.3,18887,20147,1260
48465,TX,Val Verde,,2017,5.1,18921,19943,1022
48465,TX,Val Verde,,2018,3.9,21340,22207,867
48465,TX,Val Verde,,2019,3.3,21857,22612,755
48465,TX,Val Verde,,2020,8.3,19576,21356,1780
48465,TX,Val Verde,,2021,5.9,20785,22098,1313
48467,TX,Van Zandt,,2007,3.9,24351,25349,998
48467,TX,Van Zandt,,2008,4.4,24444,25567,1123
48467,TX,Van Zandt,,2009,6.9,24216,26014,1798
48467,TX,Van Zandt,,2010,8.4,21641,23634,1993
48467,TX,Van Zandt,,2011,8.2,21779,23734,1955
48467,TX,Van Zandt,,2012,6.9,21938,23562,1624
48467,TX,Van Zandt,,2013,6.6,22239,23804,1565
48467,TX,Van Zandt,,2014,5.4,22589,23869,1280
48467,TX,Van Zandt,,2015,4.5,23124,24221,1097
48467,TX,Van Zandt,,2016,4.3,23791,24862,1071
48467,TX,Van Zandt,,2017,3.8,24242,25196,954
48467,TX,Van Zandt,,2018,3.5,24606,25508,902
48467,TX,Van Zandt,,2019,3.3,24975,25817,842
48467,TX,Van Zandt,,2020,6.1,24284,25874,1590
48467,TX,Van Zandt,,2021,4.7,25515,26780,1265
48469,TX,Victoria,,2007,3.5,42912,44468,1556
48469,TX,Victoria,,2008,3.8,43525,45249,1724
48469,TX,Victoria,,2009,6.9,42379,45512,3133
48469,TX,Victoria,,2010,7.7,39816,43147,3331
48469,TX,Victoria,,2011,7,40664,43711,3047
48469,TX,Victoria,,2012,5.6,42637,45145,2508
48469,TX,Victoria,,2013,5.4,43283,45743,2460
48469,TX,Victoria,,2014,4.2,44240,46188,1948
48469,TX,Victoria,,2015,4.2,43437,45350,1913
48469,TX,Victoria,,2016,5.4,41357,43732,2375
48469,TX,Victoria,,2017,4.9,40554,42632,2078
48469,TX,Victoria,,2018,3.9,40900,42546,1646
48469,TX,Victoria,,2019,3.5,40461,41917,1456
48469,TX,Victoria,,2020,8.3,37217,40595,3378
48469,TX,Victoria,,2021,6.4,38175,40785,2610
48471,TX,Walker,,2007,4.8,24610,25846,1236
48471,TX,Walker,,2008,5.2,24957,26336,1379
48471,TX,Walker,,2009,7,25817,27748,1931
48471,TX,Walker,,2010,7.8,21456,23273,1817
48471,TX,Walker,,2011,8.1,21285,23164,1879
48471,TX,Walker,,2012,6.9,21501,23098,1597
48471,TX,Walker,,2013,6.7,21539,23077,1538
48471,TX,Walker,,2014,5.5,21851,23124,1273
48471,TX,Walker,,2015,5.1,21817,22988,1171
48471,TX,Walker,,2016,5.3,22547,23797,1250
48471,TX,Walker,,2017,4.7,22414,23512,1098
48471,TX,Walker,,2018,4.2,22649,23649,1000
48471,TX,Walker,,2019,3.9,22888,23826,938
48471,TX,Walker,,2020,7.2,22148,23861,1713
48471,TX,Walker,,2021,6.3,22451,23951,1500
48473,TX,Waller,,2007,4.6,15310,16041,731
48473,TX,Waller,,2008,5,15365,16176,811
48473,TX,Waller,,2009,8.2,15132,16486,1354
48473,TX,Waller,,2010,8.7,18252,19989,1737
48473,TX,Waller,,2011,8.5,18619,20339,1720
48473,TX,Waller,,2012,7,19026,20450,1424
48473,TX,Waller,,2013,6.5,19443,20798,1355
48473,TX,Waller,,2014,5.2,20186,21289,1103
48473,TX,Waller,,2015,4.8,20622,21670,1048
48473,TX,Waller,,2016,5.6,20939,22180,1241
48473,TX,Waller,,2017,4.9,21122,22219,1097
48473,TX,Waller,,2018,4.3,21937,22922,985
48473,TX,Waller,,2019,3.8,22983,23880,897
48473,TX,Waller,,2020,7.6,22406,24252,1846
48473,TX,Waller,,2021,6.4,23216,24799,1583
48475,TX,Ward,,2007,3.7,4682,4864,182
48475,TX,Ward,,2008,3.9,4877,5076,199
48475,TX,Ward,,2009,8.7,4606,5047,441
48475,TX,Ward,,2010,8.5,4243,4637,394
48475,TX,Ward,,2011,6.7,4604,4936,332
48475,TX,Ward,,2012,4.8,5087,5343,256
48475,TX,Ward,,2013,4.7,5247,5508,261
48475,TX,Ward,,2014,3.6,5697,5912,215
48475,TX,Ward,,2015,4.3,5660,5915,255
48475,TX,Ward,,2016,5.7,5089,5397,308
48475,TX,Ward,,2017,4.1,5318,5544,226
48475,TX,Ward,,2018,2.6,6534,6707,173
48475,TX,Ward,,2019,2.4,7097,7270,173
48475,TX,Ward,,2020,9.5,5532,6111,579
48475,TX,Ward,,2021,7.2,5463,5884,421
48477,TX,Washington,,2007,3.7,15445,16041,596
48477,TX,Washington,,2008,4,15734,16387,653
48477,TX,Washington,,2009,6,15993,17014,1021
48477,TX,Washington,,2010,7.2,14453,15581,1128
48477,TX,Washington,,2011,6.8,14600,15671,1071
48477,TX,Washington,,2012,5.6,14736,15608,872
48477,TX,Washington,,2013,5.5,14829,15695,866
48477,TX,Washington,,2014,4.7,14946,15676,730
48477,TX,Washington,,2015,4.8,14628,15365,737
48477,TX,Washington,,2016,5.1,14320,15089,769
48477,TX,Washington,,2017,4.3,14134,14762,628
48477,TX,Washington,,2018,3.7,14190,14729,539
48477,TX,Washington,,2019,3.4,14488,14998,510
48477,TX,Washington,,2020,5.6,14249,15102,853
48477,TX,Washington,,2021,5.2,14391,15187,796
48479,TX,Webb,,2007,4.8,85119,89376,4257
48479,TX,Webb,,2008,5.4,87522,92471,4949
48479,TX,Webb,,2009,8.5,86377,94396,8019
48479,TX,Webb,,2010,8.3,96457,105189,8732
48479,TX,Webb,,2011,7.7,99571,107844,8273
48479,TX,Webb,,2012,6.4,101867,108879,7012
48479,TX,Webb,,2013,6.2,103340,110145,6805
48479,TX,Webb,,2014,5.2,105313,111033,5720
48479,TX,Webb,,2015,4.8,106503,111837,5334
48479,TX,Webb,,2016,4.9,108314,113897,5583
48479,TX,Webb,,2017,4.2,109410,114261,4851
48479,TX,Webb,,2018,3.8,110797,115174,4377
48479,TX,Webb,,2019,3.7,112721,117063,4342
48479,TX,Webb,,2020,8.5,105441,115186,9745
48479,TX,Webb,,2021,6.3,109033,116373,7340
48481,TX,Wharton,,2007,4.2,19728,20597,869
48481,TX,Wharton,,2008,4.4,19981,20898,917
48481,TX,Wharton,,2009,7,19790,21269,1479
48481,TX,Wharton,,2010,8.7,19450,21309,1859
48481,TX,Wharton,,2011,8.5,19661,21492,1831
48481,TX,Wharton,,2012,6.7,19946,21384,1438
48481,TX,Wharton,,2013,6,20175,21465,1290
48481,TX,Wharton,,2014,4.7,20524,21542,1018
48481,TX,Wharton,,2015,4.4,20294,21238,944
48481,TX,Wharton,,2016,5,20018,21080,1062
48481,TX,Wharton,,2017,4.5,19996,20944,948
48481,TX,Wharton,,2018,3.7,20291,21080,789
48481,TX,Wharton,,2019,3.4,20683,21409,726
48481,TX,Wharton,,2020,6.8,19724,21161,1437
48481,TX,Wharton,,2021,5.7,19914,21120,1206
48483,TX,Wheeler,,2007,2.6,2975,3053,78
48483,TX,Wheeler,,2008,2.4,3311,3393,82
48483,TX,Wheeler,,2009,5.6,3039,3220,181
48483,TX,Wheeler,,2010,6.1,2568,2736,168
48483,TX,Wheeler,,2011,5.1,2706,2852,146
48483,TX,Wheeler,,2012,4.3,2763,2888,125
48483,TX,Wheeler,,2013,4.3,2994,3130,136
48483,TX,Wheeler,,2014,3.6,2965,3076,111
48483,TX,Wheeler,,2015,3.9,2712,2822,110
48483,TX,Wheeler,,2016,4.8,2366,2484,118
48483,TX,Wheeler,,2017,4,2242,2335,93
48483,TX,Wheeler,,2018,3.2,2327,2403,76
48483,TX,Wheeler,,2019,3,2170,2237,67
48483,TX,Wheeler,,2020,6.1,2042,2174,132
48483,TX,Wheeler,,2021,6.2,1937,2066,129
48485,TX,Wichita,,2007,4.3,59164,61795,2631
48485,TX,Wichita,,2008,4.9,58181,61169,2988
48485,TX,Wichita,,2009,7.5,56955,61577,4622
48485,TX,Wichita,,2010,7.8,54733,59360,4627
48485,TX,Wichita,,2011,7.1,54788,58982,4194
48485,TX,Wichita,,2012,6,54805,58331,3526
48485,TX,Wichita,,2013,5.9,53848,57224,3376
48485,TX,Wichita,,2014,4.9,53641,56429,2788
48485,TX,Wichita,,2015,4.3,52958,55348,2390
48485,TX,Wichita,,2016,4.4,53072,55486,2414
48485,TX,Wichita,,2017,3.7,53588,55659,2071
48485,TX,Wichita,,2018,3.4,53906,55823,1917
48485,TX,Wichita,,2019,3.2,53647,55414,1767
48485,TX,Wichita,,2020,6.6,51404,55057,3653
48485,TX,Wichita,,2021,5.3,52400,55325,2925
48487,TX,Wilbarger,,2007,3.4,7402,7665,263
48487,TX,Wilbarger,,2008,3.6,7324,7594,270
48487,TX,Wilbarger,,2009,4.7,7527,7896,369
48487,TX,Wilbarger,,2010,7.9,5663,6149,486
48487,TX,Wilbarger,,2011,7.5,5584,6036,452
48487,TX,Wilbarger,,2012,6,5556,5910,354
48487,TX,Wilbarger,,2013,5.8,5431,5767,336
48487,TX,Wilbarger,,2014,5,5024,5287,263
48487,TX,Wilbarger,,2015,4.9,4863,5112,249
48487,TX,Wilbarger,,2016,4.7,4812,5050,238
48487,TX,Wilbarger,,2017,4.7,4693,4925,232
48487,TX,Wilbarger,,2018,4.2,4723,4929,206
48487,TX,Wilbarger,,2019,3.6,4719,4893,174
48487,TX,Wilbarger,,2020,5.9,4584,4869,285
48487,TX,Wilbarger,,2021,6.6,4569,4891,322
48489,TX,Willacy,,2007,8.2,6931,7551,620
48489,TX,Willacy,,2008,8.9,7031,7718,687
48489,TX,Willacy,,2009,11.9,7411,8410,999
48489,TX,Willacy,,2010,14.5,6662,7794,1132
48489,TX,Willacy,,2011,16.9,6429,7740,1311
48489,TX,Willacy,,2012,15.7,6241,7404,1163
48489,TX,Willacy,,2013,15.9,6247,7427,1180
48489,TX,Willacy,,2014,12.5,6269,7168,899
48489,TX,Willacy,,2015,13.1,5868,6755,887
48489,TX,Willacy,,2016,12.3,5707,6505,798
48489,TX,Willacy,,2017,11.1,5582,6280,698
48489,TX,Willacy,,2018,9.9,5703,6333,630
48489,TX,Willacy,,2019,8.3,5938,6472,534
48489,TX,Willacy,,2020,12,5766,6550,784
48489,TX,Willacy,,2021,10.5,6245,6976,731
48491,TX,Williamson,,2007,3.8,185955,193203,7248
48491,TX,Williamson,,2008,4.5,193342,202460,9118
48491,TX,Williamson,,2009,7.3,195151,210536,15385
48491,TX,Williamson,,2010,7.3,206656,222974,16318
48491,TX,Williamson,,2011,7,214564,230756,16192
48491,TX,Williamson,,2012,5.8,223136,236866,13730
48491,TX,Williamson,,2013,5.3,233019,246119,13100
48491,TX,Williamson,,2014,4.4,243698,254967,11269
48491,TX,Williamson,,2015,3.5,254904,264097,9193
48491,TX,Williamson,,2016,3.4,269349,278717,9368
48491,TX,Williamson,,2017,3.3,279094,288605,9511
48491,TX,Williamson,,2018,3.1,291963,301255,9292
48491,TX,Williamson,,2019,2.8,306186,315068,8882
48491,TX,Williamson,,2020,5.8,302663,321374,18711
48491,TX,Williamson,,2021,4,326982,340568,13586
48493,TX,Wilson,,2007,4.1,17414,18164,750
48493,TX,Wilson,,2008,4.6,17877,18746,869
48493,TX,Wilson,,2009,6.5,17729,18955,1226
48493,TX,Wilson,,2010,6.9,19804,21262,1458
48493,TX,Wilson,,2011,6.7,20079,21529,1450
48493,TX,Wilson,,2012,5.5,20487,21681,1194
48493,TX,Wilson,,2013,5.3,20992,22166,1174
48493,TX,Wilson,,2014,4.2,21565,22513,948
48493,TX,Wilson,,2015,3.8,22103,22981,878
48493,TX,Wilson,,2016,3.9,22830,23760,930
48493,TX,Wilson,,2017,3.5,23157,24002,845
48493,TX,Wilson,,2018,3.1,23555,24308,753
48493,TX,Wilson,,2019,2.8,23920,24621,701
48493,TX,Wilson,,2020,5.7,22860,24248,1388
48493,TX,Wilson,,2021,4.4,23899,24999,1100
48495,TX,Winkler,,2007,3.2,3235,3342,107
48495,TX,Winkler,,2008,3.8,3326,3456,130
48495,TX,Winkler,,2009,9.3,3103,3421,318
48495,TX,Winkler,,2010,9.3,2634,2903,269
48495,TX,Winkler,,2011,7.4,2825,3051,226
48495,TX,Winkler,,2012,5.6,3000,3179,179
48495,TX,Winkler,,2013,5.3,3140,3316,176
48495,TX,Winkler,,2014,4.4,3135,3281,146
48495,TX,Winkler,,2015,5.7,2926,3104,178
48495,TX,Winkler,,2016,7.7,2834,3071,237
48495,TX,Winkler,,2017,5.2,3067,3234,167
48495,TX,Winkler,,2018,2.9,3872,3986,114
48495,TX,Winkler,,2019,2.9,3894,4009,115
48495,TX,Winkler,,2020,9.4,3569,3941,372
48495,TX,Winkler,,2021,7.7,3439,3726,287
48497,TX,Wise,,2007,4.2,26191,27344,1153
48497,TX,Wise,,2008,4.4,26347,27547,1200
48497,TX,Wise,,2009,8.7,25870,28321,2451
48497,TX,Wise,,2010,8.7,25293,27713,2420
48497,TX,Wise,,2011,7.8,25940,28142,2202
48497,TX,Wise,,2012,6.4,26379,28186,1807
48497,TX,Wise,,2013,6,26639,28351,1712
48497,TX,Wise,,2014,4.9,27045,28450,1405
48497,TX,Wise,,2015,4.7,27345,28685,1340
48497,TX,Wise,,2016,4.7,28044,29438,1394
48497,TX,Wise,,2017,4,28738,29948,1210
48497,TX,Wise,,2018,3.5,29876,30950,1074
48497,TX,Wise,,2019,3.2,30896,31925,1029
48497,TX,Wise,,2020,6.5,29841,31929,2088
48497,TX,Wise,,2021,4.9,31380,32980,1600
48499,TX,Wood,,2007,4.6,17117,17934,817
48499,TX,Wood,,2008,5.1,17158,18076,918
48499,TX,Wood,,2009,8,17173,18658,1485
48499,TX,Wood,,2010,9.1,15447,16993,1546
48499,TX,Wood,,2011,8.9,15457,16969,1512
48499,TX,Wood,,2012,7.8,15389,16693,1304
48499,TX,Wood,,2013,7.3,15468,16693,1225
48499,TX,Wood,,2014,6,15735,16747,1012
48499,TX,Wood,,2015,5.3,15873,16770,897
48499,TX,Wood,,2016,5.3,16339,17248,909
48499,TX,Wood,,2017,4.7,16400,17213,813
48499,TX,Wood,,2018,4.3,16452,17190,738
48499,TX,Wood,,2019,3.9,16810,17491,681
48499,TX,Wood,,2020,6.6,16551,17724,1173
48499,TX,Wood,,2021,5.6,16977,17988,1011
48501,TX,Yoakum,,2007,3.3,3749,3877,128
48501,TX,Yoakum,,2008,3.1,3963,4089,126
48501,TX,Yoakum,,2009,7.6,3801,4112,311
48501,TX,Yoakum,,2010,7,3436,3695,259
48501,TX,Yoakum,,2011,5.4,3936,4161,225
48501,TX,Yoakum,,2012,4,4153,4326,173
48501,TX,Yoakum,,2013,3.9,4041,4204,163
48501,TX,Yoakum,,2014,3.1,4155,4286,131
48501,TX,Yoakum,,2015,3.8,3894,4047,153
48501,TX,Yoakum,,2016,4.8,3582,3762,180
48501,TX,Yoakum,,2017,3.6,3659,3794,135
48501,TX,Yoakum,,2018,2.9,3571,3677,106
48501,TX,Yoakum,,2019,2.9,3595,3702,107
48501,TX,Yoakum,,2020,12,3066,3484,418
48501,TX,Yoakum,,2021,7.8,3027,3284,257
48503,TX,Young,,2007,3.3,9234,9545,311
48503,TX,Young,,2008,3.5,9481,9821,340
48503,TX,Young,,2009,6.4,9077,9700,623
48503,TX,Young,,2010,7.7,7990,8658,668
48503,TX,Young,,2011,7.4,7953,8589,636
48503,TX,Young,,2012,5.7,8065,8550,485
48503,TX,Young,,2013,5.2,8111,8556,445
48503,TX,Young,,2014,4.1,8299,8657,358
48503,TX,Young,,2015,4.3,8109,8473,364
48503,TX,Young,,2016,4.4,7947,8312,365
48503,TX,Young,,2017,3.8,7711,8016,305
48503,TX,Young,,2018,3.3,7824,8089,265
48503,TX,Young,,2019,3,7668,7903,235
48503,TX,Young,,2020,5.3,7280,7686,406
48503,TX,Young,,2021,4.5,7701,8066,365
48505,TX,Zapata,,2007,5.4,4682,4948,266
48505,TX,Zapata,,2008,5.5,4881,5167,286
48505,TX,Zapata,,2009,10.8,4763,5341,578
48505,TX,Zapata,,2010,10.4,5167,5769,602
48505,TX,Zapata,,2011,8.4,5925,6465,540
48505,TX,Zapata,,2012,6.3,6374,6802,428
48505,TX,Zapata,,2013,6.3,6607,7050,443
48505,TX,Zapata,,2014,5.3,6564,6929,365
48505,TX,Zapata,,2015,7.7,5718,6194,476
48505,TX,Zapata,,2016,10.8,4648,5210,562
48505,TX,Zapata,,2017,7.5,4949,5351,402
48505,TX,Zapata,,2018,5.6,5012,5309,297
48505,TX,Zapata,,2019,5,4802,5057,255
48505,TX,Zapata,,2020,12.2,4072,4640,568
48505,TX,Zapata,,2021,12.1,3980,4526,546
48507,TX,Zavala,,2007,10.7,3321,3720,399
48507,TX,Zavala,,2008,10.7,3259,3649,390
48507,TX,Zavala,,2009,14.4,3364,3932,568
48507,TX,Zavala,,2010,13.9,3928,4564,636
48507,TX,Zavala,,2011,14.5,3932,4598,666
48507,TX,Zavala,,2012,13.4,3790,4378,588
48507,TX,Zavala,,2013,14.6,3421,4006,585
48507,TX,Zavala,,2014,12.3,3417,3896,479
48507,TX,Zavala,,2015,11.3,3381,3810,429
48507,TX,Zavala,,2016,13.9,3347,3887,540
48507,TX,Zavala,,2017,11.3,3289,3706,417
48507,TX,Zavala,,2018,9.7,3186,3528,342
48507,TX,Zavala,,2019,8.5,3030,3310,280
48507,TX,Zavala,,2020,14.3,2889,3370,481
48507,TX,Zavala,,2021,12.7,2861,3276,415
49000,UT,Utah,,2007,2.6,1342237,1377638,35401
49000,UT,Utah,,2008,3.3,1339394,1385646,46252
49000,UT,Utah,,2009,7.3,1274210,1373841,99631
49000,UT,Utah,,2010,7.9,1242907,1350173,107266
49000,UT,Utah,,2011,7.1,1246797,1341427,94630
49000,UT,Utah,,2012,4.8,1284149,1348557,64408
49000,UT,Utah,,2013,4.2,1327560,1385908,58348
49000,UT,Utah,,2014,3.6,1364353,1415779,51426
49000,UT,Utah,,2015,3.5,1401945,1453457,51512
49000,UT,Utah,,2016,3.3,1449981,1500137,50156
49000,UT,Utah,,2017,3.1,1505413,1554352,48939
49000,UT,Utah,,2018,2.9,1537389,1583703,46314
49000,UT,Utah,,2019,2.6,1576421,1618055,41634
49000,UT,Utah,,2020,4.7,1562799,1640426,77627
49000,UT,Utah,,2021,2.7,1636150,1681494,45344
49001,UT,Beaver,,2007,2.5,3138,3219,81
49001,UT,Beaver,,2008,3.2,3049,3151,102
49001,UT,Beaver,,2009,6.1,3353,3571,218
49001,UT,Beaver,,2010,10.1,2827,3145,318
49001,UT,Beaver,,2011,8.4,2772,3026,254
49001,UT,Beaver,,2012,5.4,2694,2847,153
49001,UT,Beaver,,2013,4.3,2851,2979,128
49001,UT,Beaver,,2014,3.8,2827,2940,113
49001,UT,Beaver,,2015,3.7,2985,3100,115
49001,UT,Beaver,,2016,4.8,2918,3065,147
49001,UT,Beaver,,2017,3.9,2933,3053,120
49001,UT,Beaver,,2018,3.3,2931,3032,101
49001,UT,Beaver,,2019,3,2809,2895,86
49001,UT,Beaver,,2020,4,2724,2838,114
49001,UT,Beaver,,2021,2.8,2746,2826,80
49003,UT,Box Elder,,2007,2.7,23147,23778,631
49003,UT,Box Elder,,2008,3.8,23043,23942,899
49003,UT,Box Elder,,2009,8,21488,23351,1863
49003,UT,Box Elder,,2010,8.6,21520,23543,2023
49003,UT,Box Elder,,2011,7.8,21230,23033,1803
49003,UT,Box Elder,,2012,5.1,21382,22526,1144
49003,UT,Box Elder,,2013,4.3,21840,22833,993
49003,UT,Box Elder,,2014,3.7,22372,23230,858
49003,UT,Box Elder,,2015,3.6,22991,23854,863
49003,UT,Box Elder,,2016,3.4,23763,24595,832
49003,UT,Box Elder,,2017,3.2,24632,25437,805
49003,UT,Box Elder,,2018,2.8,24938,25667,729
49003,UT,Box Elder,,2019,2.6,25552,26232,680
49003,UT,Box Elder,,2020,4.4,25470,26641,1171
49003,UT,Box Elder,,2021,2.4,26237,26895,658
49005,UT,Cache,,2007,2,60303,61558,1255
49005,UT,Cache,,2008,2.6,60627,62224,1597
49005,UT,Cache,,2009,5.4,59035,62421,3386
49005,UT,Cache,,2010,6.2,53470,56996,3526
49005,UT,Cache,,2011,5.5,53105,56206,3101
49005,UT,Cache,,2012,4,53809,56022,2213
49005,UT,Cache,,2013,3.6,54930,57002,2072
49005,UT,Cache,,2014,3.1,56624,58407,1783
49005,UT,Cache,,2015,3,57948,59742,1794
49005,UT,Cache,,2016,3,59218,61026,1808
49005,UT,Cache,,2017,2.7,61219,62905,1686
49005,UT,Cache,,2018,2.5,62209,63817,1608
49005,UT,Cache,,2019,2.1,63718,65104,1386
49005,UT,Cache,,2020,3,63958,65906,1948
49005,UT,Cache,,2021,2,67395,68747,1352
49007,UT,Carbon,,2007,3.6,9410,9765,355
49007,UT,Carbon,,2008,4,9809,10218,409
49007,UT,Carbon,,2009,7.8,9722,10547,825
49007,UT,Carbon,,2010,8.7,9007,9868,861
49007,UT,Carbon,,2011,7.9,8737,9490,753
49007,UT,Carbon,,2012,6.2,8512,9079,567
49007,UT,Carbon,,2013,5.8,8298,8809,511
49007,UT,Carbon,,2014,4.9,8198,8620,422
49007,UT,Carbon,,2015,5.6,8178,8661,483
49007,UT,Carbon,,2016,5.8,7819,8298,479
49007,UT,Carbon,,2017,4.9,7906,8313,407
49007,UT,Carbon,,2018,4.2,8170,8531,361
49007,UT,Carbon,,2019,3.6,8271,8583,312
49007,UT,Carbon,,2020,5.3,8146,8600,454
49007,UT,Carbon,,2021,3.9,8097,8424,327
49009,UT,Daggett,,2007,3.6,507,526,19
49009,UT,Daggett,,2008,3.7,439,456,17
49009,UT,Daggett,,2009,5.8,454,482,28
49009,UT,Daggett,,2010,7.3,456,492,36
49009,UT,Daggett,,2011,6.4,438,468,30
49009,UT,Daggett,,2012,4.4,409,428,19
49009,UT,Daggett,,2013,4.5,404,423,19
49009,UT,Daggett,,2014,4,410,427,17
49009,UT,Daggett,,2015,4.5,443,464,21
49009,UT,Daggett,,2016,5,438,461,23
49009,UT,Daggett,,2017,4.9,410,431,21
49009,UT,Daggett,,2018,4.2,385,402,17
49009,UT,Daggett,,2019,3.8,377,392,15
49009,UT,Daggett,,2020,4.6,393,412,19
49009,UT,Daggett,,2021,3.6,400,415,15
49011,UT,Davis,,2007,2.5,142912,146581,3669
49011,UT,Davis,,2008,3.2,142449,147087,4638
49011,UT,Davis,,2009,6.5,136223,145736,9513
49011,UT,Davis,,2010,7.1,135943,146307,10364
49011,UT,Davis,,2011,6.3,136414,145592,9178
49011,UT,Davis,,2012,4.3,139776,146077,6301
49011,UT,Davis,,2013,3.9,144606,150480,5874
49011,UT,Davis,,2014,3.4,149286,154563,5277
49011,UT,Davis,,2015,3.3,153881,159156,5275
49011,UT,Davis,,2016,3.1,158759,163777,5018
49011,UT,Davis,,2017,3,164325,169361,5036
49011,UT,Davis,,2018,2.7,166757,171470,4713
49011,UT,Davis,,2019,2.4,170250,174427,4177
49011,UT,Davis,,2020,4.1,168939,176223,7284
49011,UT,Davis,,2021,2.4,174865,179229,4364
49013,UT,Duchesne,,2007,2.2,9134,9343,209
49013,UT,Duchesne,,2008,2.5,10150,10408,258
49013,UT,Duchesne,,2009,8.5,9528,10408,880
49013,UT,Duchesne,,2010,9.6,7343,8121,778
49013,UT,Duchesne,,2011,6.9,7803,8382,579
49013,UT,Duchesne,,2012,4.1,8622,8994,372
49013,UT,Duchesne,,2013,3.9,8809,9170,361
49013,UT,Duchesne,,2014,3.5,9170,9499,329
49013,UT,Duchesne,,2015,7.4,8109,8756,647
49013,UT,Duchesne,,2016,8.6,7373,8070,697
49013,UT,Duchesne,,2017,5.5,7564,8008,444
49013,UT,Duchesne,,2018,4.3,7442,7774,332
49013,UT,Duchesne,,2019,3.9,7485,7785,300
49013,UT,Duchesne,,2020,7.8,7218,7829,611
49013,UT,Duchesne,,2021,4.9,7372,7748,376
49015,UT,Emery,,2007,3.3,5030,5203,173
49015,UT,Emery,,2008,3.5,4925,5106,181
49015,UT,Emery,,2009,7,4909,5279,370
49015,UT,Emery,,2010,7.4,4878,5265,387
49015,UT,Emery,,2011,7.7,4651,5037,386
49015,UT,Emery,,2012,6.3,4356,4651,295
49015,UT,Emery,,2013,5.6,4381,4639,258
49015,UT,Emery,,2014,5.1,4339,4571,232
49015,UT,Emery,,2015,5.9,4117,4377,260
49015,UT,Emery,,2016,6.1,3988,4246,258
49015,UT,Emery,,2017,4.9,3997,4205,208
49015,UT,Emery,,2018,4.5,4160,4357,197
49015,UT,Emery,,2019,3.9,4161,4332,171
49015,UT,Emery,,2020,4.8,4193,4404,211
49015,UT,Emery,,2021,3.9,4278,4450,172
49017,UT,Garfield,,2007,4.6,2638,2766,128
49017,UT,Garfield,,2008,5.7,2679,2842,163
49017,UT,Garfield,,2009,10.3,2590,2888,298
49017,UT,Garfield,,2010,10.4,2744,3062,318
49017,UT,Garfield,,2011,11.1,2619,2946,327
49017,UT,Garfield,,2012,8.4,2557,2792,235
49017,UT,Garfield,,2013,8.5,2500,2731,231
49017,UT,Garfield,,2014,8.4,2463,2688,225
49017,UT,Garfield,,2015,8.7,2498,2737,239
49017,UT,Garfield,,2016,8.1,2554,2779,225
49017,UT,Garfield,,2017,7.3,2697,2909,212
49017,UT,Garfield,,2018,7.3,2587,2792,205
49017,UT,Garfield,,2019,6.1,2617,2787,170
49017,UT,Garfield,,2020,10.4,2379,2654,275
49017,UT,Garfield,,2021,6.5,2597,2778,181
49019,UT,Grand,,2007,4.6,4999,5241,242
49019,UT,Grand,,2008,5.5,5016,5309,293
49019,UT,Grand,,2009,9.7,4904,5432,528
49019,UT,Grand,,2010,10.7,4737,5304,567
49019,UT,Grand,,2011,10.1,4749,5284,535
49019,UT,Grand,,2012,7.5,4898,5293,395
49019,UT,Grand,,2013,7.1,4983,5365,382
49019,UT,Grand,,2014,6.1,5138,5470,332
49019,UT,Grand,,2015,6,5247,5580,333
49019,UT,Grand,,2016,5.7,5376,5701,325
49019,UT,Grand,,2017,5.2,5650,5957,307
49019,UT,Grand,,2018,4.5,5832,6108,276
49019,UT,Grand,,2019,3.9,6005,6246,241
49019,UT,Grand,,2020,9.5,5647,6242,595
49019,UT,Grand,,2021,4.4,6285,6574,289
49021,UT,Iron,,2007,2.9,20680,21294,614
49021,UT,Iron,,2008,4.1,20192,21054,862
49021,UT,Iron,,2009,8.7,19231,21066,1835
49021,UT,Iron,,2010,9.7,18355,20319,1964
49021,UT,Iron,,2011,8.6,18046,19742,1696
49021,UT,Iron,,2012,6,17936,19089,1153
49021,UT,Iron,,2013,5.1,18115,19087,972
49021,UT,Iron,,2014,4.3,18892,19746,854
49021,UT,Iron,,2015,4.4,19343,20224,881
49021,UT,Iron,,2016,4.2,20480,21385,905
49021,UT,Iron,,2017,4,21436,22337,901
49021,UT,Iron,,2018,3.3,22281,23051,770
49021,UT,Iron,,2019,2.9,23606,24318,712
49021,UT,Iron,,2020,4.5,24126,25272,1146
49021,UT,Iron,,2021,2.8,25519,26265,746
49023,UT,Juab,,2007,3.1,4037,4167,130
49023,UT,Juab,,2008,5.1,3781,3985,204
49023,UT,Juab,,2009,9.9,3589,3984,395
49023,UT,Juab,,2010,9.3,4167,4592,425
49023,UT,Juab,,2011,8.6,4177,4568,391
49023,UT,Juab,,2012,5.4,4293,4537,244
49023,UT,Juab,,2013,4.6,4415,4629,214
49023,UT,Juab,,2014,3.9,4571,4756,185
49023,UT,Juab,,2015,3.9,4721,4912,191
49023,UT,Juab,,2016,3.5,5016,5200,184
49023,UT,Juab,,2017,3.3,5268,5446,178
49023,UT,Juab,,2018,2.8,5455,5614,159
49023,UT,Juab,,2019,2.5,5713,5858,145
49023,UT,Juab,,2020,3,5671,5847,176
49023,UT,Juab,,2021,2,6036,6159,123
49025,UT,Kane,,2007,3.2,3427,3539,112
49025,UT,Kane,,2008,3.9,3381,3518,137
49025,UT,Kane,,2009,7.5,3273,3539,266
49025,UT,Kane,,2010,8.1,3259,3545,286
49025,UT,Kane,,2011,7.8,3199,3469,270
49025,UT,Kane,,2012,5.9,3196,3395,199
49025,UT,Kane,,2013,4.9,3255,3423,168
49025,UT,Kane,,2014,4.6,3372,3533,161
49025,UT,Kane,,2015,4.3,3450,3606,156
49025,UT,Kane,,2016,3.7,3543,3679,136
49025,UT,Kane,,2017,3.3,3636,3761,125
49025,UT,Kane,,2018,3,3703,3819,116
49025,UT,Kane,,2019,2.9,3740,3850,110
49025,UT,Kane,,2020,5.3,3669,3876,207
49025,UT,Kane,,2021,2.9,3887,4002,115
49027,UT,Millard,,2007,2.5,6135,6291,156
49027,UT,Millard,,2008,3.1,5925,6116,191
49027,UT,Millard,,2009,5.5,6156,6516,360
49027,UT,Millard,,2010,6.3,5989,6392,403
49027,UT,Millard,,2011,5.6,5784,6124,340
49027,UT,Millard,,2012,4.1,5596,5837,241
49027,UT,Millard,,2013,3.8,5603,5822,219
49027,UT,Millard,,2014,3.3,5718,5915,197
49027,UT,Millard,,2015,3.4,5884,6094,210
49027,UT,Millard,,2016,3.2,5990,6190,200
49027,UT,Millard,,2017,3.2,6257,6461,204
49027,UT,Millard,,2018,3.1,6062,6255,193
49027,UT,Millard,,2019,2.7,5913,6074,161
49027,UT,Millard,,2020,3.3,5833,6029,196
49027,UT,Millard,,2021,2.4,5875,6018,143
49029,UT,Morgan,,2007,2.6,3943,4049,106
49029,UT,Morgan,,2008,3.1,3976,4104,128
49029,UT,Morgan,,2009,6.2,3836,4091,255
49029,UT,Morgan,,2010,7,3958,4255,297
49029,UT,Morgan,,2011,6,3963,4215,252
49029,UT,Morgan,,2012,4.3,4074,4258,184
49029,UT,Morgan,,2013,3.7,4279,4444,165
49029,UT,Morgan,,2014,3.2,4500,4651,151
49029,UT,Morgan,,2015,3.1,4754,4904,150
49029,UT,Morgan,,2016,2.9,4977,5125,148
49029,UT,Morgan,,2017,2.8,5264,5413,149
49029,UT,Morgan,,2018,2.6,5345,5488,143
49029,UT,Morgan,,2019,2.4,5427,5561,134
49029,UT,Morgan,,2020,3.4,5473,5664,191
49029,UT,Morgan,,2021,2.1,5658,5779,121
49031,UT,Piute,,2007,2.2,918,939,21
49031,UT,Piute,,2008,2.7,888,913,25
49031,UT,Piute,,2009,6.5,841,899,58
49031,UT,Piute,,2010,10,511,568,57
49031,UT,Piute,,2011,10.4,472,527,55
49031,UT,Piute,,2012,7.5,446,482,36
49031,UT,Piute,,2013,7.1,443,477,34
49031,UT,Piute,,2014,6.8,424,455,31
49031,UT,Piute,,2015,6.3,433,462,29
49031,UT,Piute,,2016,5.7,430,456,26
49031,UT,Piute,,2017,4.7,462,485,23
49031,UT,Piute,,2018,5,460,484,24
49031,UT,Piute,,2019,4.5,462,484,22
49031,UT,Piute,,2020,6.2,451,481,30
49031,UT,Piute,,2021,4.4,458,479,21
49033,UT,Rich,,2007,2,1435,1464,29
49033,UT,Rich,,2008,2.5,1404,1440,36
49033,UT,Rich,,2009,5,1396,1470,74
49033,UT,Rich,,2010,7.4,958,1034,76
49033,UT,Rich,,2011,7.6,902,976,74
49033,UT,Rich,,2012,4.7,885,929,44
49033,UT,Rich,,2013,4.2,929,970,41
49033,UT,Rich,,2014,3.7,961,998,37
49033,UT,Rich,,2015,3.6,1003,1040,37
49033,UT,Rich,,2016,3.1,1057,1091,34
49033,UT,Rich,,2017,3.1,1110,1146,36
49033,UT,Rich,,2018,3,1146,1182,36
49033,UT,Rich,,2019,3,1140,1175,35
49033,UT,Rich,,2020,3.5,1123,1164,41
49033,UT,Rich,,2021,2.3,1244,1273,29
49035,UT,Salt Lake,,2007,2.5,544296,558195,13899
49035,UT,Salt Lake,,2008,3.2,545829,563645,17816
49035,UT,Salt Lake,,2009,7,517994,556963,38969
49035,UT,Salt Lake,,2010,7.8,503514,546019,42505
49035,UT,Salt Lake,,2011,6.9,505036,542664,37628
49035,UT,Salt Lake,,2012,4.6,521300,546710,25410
49035,UT,Salt Lake,,2013,4,539099,561750,22651
49035,UT,Salt Lake,,2014,3.5,550796,570837,20041
49035,UT,Salt Lake,,2015,3.3,563174,582490,19316
49035,UT,Salt Lake,,2016,3.1,581020,599503,18483
49035,UT,Salt Lake,,2017,3,598906,617457,18551
49035,UT,Salt Lake,,2018,2.8,607123,624844,17721
49035,UT,Salt Lake,,2019,2.5,621401,637173,15772
49035,UT,Salt Lake,,2020,5.1,610521,643461,32940
49035,UT,Salt Lake,,2021,2.8,635656,653817,18161
49037,UT,San Juan,,2007,5.2,4777,5038,261
49037,UT,San Juan,,2008,5.9,4750,5050,300
49037,UT,San Juan,,2009,11.7,4697,5321,624
49037,UT,San Juan,,2010,11.1,5394,6065,671
49037,UT,San Juan,,2011,10.4,5306,5924,618
49037,UT,San Juan,,2012,7.8,5134,5570,436
49037,UT,San Juan,,2013,7.3,5170,5579,409
49037,UT,San Juan,,2014,7.4,5139,5549,410
49037,UT,San Juan,,2015,7.7,5243,5683,440
49037,UT,San Juan,,2016,7.8,5265,5713,448
49037,UT,San Juan,,2017,6.8,5327,5716,389
49037,UT,San Juan,,2018,5.9,5406,5744,338
49037,UT,San Juan,,2019,5,5470,5757,287
49037,UT,San Juan,,2020,10.3,4928,5492,564
49037,UT,San Juan,,2021,6.3,5125,5470,345
49039,UT,Sanpete,,2007,3.1,10764,11104,340
49039,UT,Sanpete,,2008,3.9,10782,11225,443
49039,UT,Sanpete,,2009,8.3,10449,11399,950
49039,UT,Sanpete,,2010,9.1,10369,11411,1042
49039,UT,Sanpete,,2011,8.2,10134,11041,907
49039,UT,Sanpete,,2012,5.7,10413,11038,625
49039,UT,Sanpete,,2013,5.2,10330,10892,562
49039,UT,Sanpete,,2014,4.3,10493,10968,475
49039,UT,Sanpete,,2015,4.1,10898,11358,460
49039,UT,Sanpete,,2016,3.9,11300,11755,455
49039,UT,Sanpete,,2017,3.8,11605,12065,460
49039,UT,Sanpete,,2018,3.5,12115,12556,441
49039,UT,Sanpete,,2019,3.1,12148,12542,394
49039,UT,Sanpete,,2020,3.8,12275,12759,484
49039,UT,Sanpete,,2021,2.8,12691,13057,366
49041,UT,Sevier,,2007,2.7,9347,9609,262
49041,UT,Sevier,,2008,3.8,9363,9728,365
49041,UT,Sevier,,2009,7.8,9157,9931,774
49041,UT,Sevier,,2010,8.4,8867,9680,813
49041,UT,Sevier,,2011,7.7,8708,9436,728
49041,UT,Sevier,,2012,5.4,8744,9243,499
49041,UT,Sevier,,2013,5,8673,9127,454
49041,UT,Sevier,,2014,4.3,8792,9186,394
49041,UT,Sevier,,2015,4.4,9047,9460,413
49041,UT,Sevier,,2016,4.3,9145,9551,406
49041,UT,Sevier,,2017,3.7,9462,9828,366
49041,UT,Sevier,,2018,3.4,9613,9947,334
49041,UT,Sevier,,2019,3,9512,9810,298
49041,UT,Sevier,,2020,4.3,9477,9901,424
49041,UT,Sevier,,2021,3.3,9666,9992,326
49043,UT,Summit,,2007,2.5,21534,22081,547
49043,UT,Summit,,2008,3.1,21652,22339,687
49043,UT,Summit,,2009,6.9,20792,22341,1549
49043,UT,Summit,,2010,7.5,19209,20773,1564
49043,UT,Summit,,2011,6.4,19715,21066,1351
49043,UT,Summit,,2012,4.4,20233,21156,923
49043,UT,Summit,,2013,3.8,20909,21739,830
49043,UT,Summit,,2014,3.3,21619,22350,731
49043,UT,Summit,,2015,3.2,22208,22953,745
49043,UT,Summit,,2016,3,23066,23791,725
49043,UT,Summit,,2017,3,23706,24439,733
49043,UT,Summit,,2018,2.8,23866,24565,699
49043,UT,Summit,,2019,2.4,24478,25083,605
49043,UT,Summit,,2020,7.2,22837,24610,1773
49043,UT,Summit,,2021,2.9,24266,24987,721
49045,UT,Tooele,,2007,2.8,26513,27277,764
49045,UT,Tooele,,2008,3.6,27214,28223,1009
49045,UT,Tooele,,2009,7.8,26143,28364,2221
49045,UT,Tooele,,2010,8.5,25024,27338,2314
49045,UT,Tooele,,2011,7.5,25077,27103,2026
49045,UT,Tooele,,2012,5.3,25793,27233,1440
49045,UT,Tooele,,2013,5,26667,28068,1401
49045,UT,Tooele,,2014,4.6,27335,28646,1311
49045,UT,Tooele,,2015,4.1,28188,29380,1192
49045,UT,Tooele,,2016,3.7,29582,30713,1131
49045,UT,Tooele,,2017,3.5,31325,32455,1130
49045,UT,Tooele,,2018,3.2,32417,33488,1071
49045,UT,Tooele,,2019,2.8,34052,35032,980
49045,UT,Tooele,,2020,4.7,34351,36054,1703
49045,UT,Tooele,,2021,2.9,35747,36804,1057
49047,UT,Uintah,,2007,2.1,17145,17505,360
49047,UT,Uintah,,2008,2.1,18394,18795,401
49047,UT,Uintah,,2009,8.3,16318,17790,1472
49047,UT,Uintah,,2010,8.6,13819,15119,1300
49047,UT,Uintah,,2011,6.3,14439,15409,970
49047,UT,Uintah,,2012,3.9,15099,15715,616
49047,UT,Uintah,,2013,4,14836,15453,617
49047,UT,Uintah,,2014,3.4,15321,15861,540
49047,UT,Uintah,,2015,6.7,14201,15217,1016
49047,UT,Uintah,,2016,9.1,12782,14057,1275
49047,UT,Uintah,,2017,5.9,12927,13731,804
49047,UT,Uintah,,2018,4.4,13089,13694,605
49047,UT,Uintah,,2019,4.2,13167,13741,574
49047,UT,Uintah,,2020,9.3,12212,13462,1250
49047,UT,Uintah,,2021,5.6,12806,13562,756
49049,UT,Utah,,2007,2.4,220711,226175,5464
49049,UT,Utah,,2008,3.3,218201,225584,7383
49049,UT,Utah,,2009,7,207334,222838,15504
49049,UT,Utah,,2010,7.5,211554,228807,17253
49049,UT,Utah,,2011,6.6,214480,229612,15132
49049,UT,Utah,,2012,4.4,224333,234640,10307
49049,UT,Utah,,2013,3.9,235773,245330,9557
49049,UT,Utah,,2014,3.3,244673,253091,8418
49049,UT,Utah,,2015,3.2,256260,264713,8453
49049,UT,Utah,,2016,3,269619,277959,8340
49049,UT,Utah,,2017,2.8,283780,292059,8279
49049,UT,Utah,,2018,2.7,293624,301683,8059
49049,UT,Utah,,2019,2.4,302523,309866,7343
49049,UT,Utah,,2020,3.8,304605,316642,12037
49049,UT,Utah,,2021,2.3,324289,332018,7729
49051,UT,Wasatch,,2007,2.5,10602,10878,276
49051,UT,Wasatch,,2008,3.4,10052,10411,359
49051,UT,Wasatch,,2009,8.3,9242,10078,836
49051,UT,Wasatch,,2010,8.5,10348,11310,962
49051,UT,Wasatch,,2011,7.3,10479,11303,824
49051,UT,Wasatch,,2012,5.1,10858,11438,580
49051,UT,Wasatch,,2013,4.3,11508,12023,515
49051,UT,Wasatch,,2014,3.6,12155,12609,454
49051,UT,Wasatch,,2015,3.4,12736,13190,454
49051,UT,Wasatch,,2016,3.3,13398,13853,455
49051,UT,Wasatch,,2017,3.2,14201,14672,471
49051,UT,Wasatch,,2018,3,14805,15259,454
49051,UT,Wasatch,,2019,2.7,15726,16163,437
49051,UT,Wasatch,,2020,6.5,15398,16460,1062
49051,UT,Wasatch,,2021,2.9,16421,16903,482
49053,UT,Washington,,2007,2.7,62609,64370,1761
49053,UT,Washington,,2008,4.4,59613,62371,2758
49053,UT,Washington,,2009,9.7,54486,60341,5855
49053,UT,Washington,,2010,10.6,50540,56551,6011
49053,UT,Washington,,2011,9.3,50517,55677,5160
49053,UT,Washington,,2012,6.1,52679,56098,3419
49053,UT,Washington,,2013,5.1,55503,58465,2962
49053,UT,Washington,,2014,4.2,58414,60968,2554
49053,UT,Washington,,2015,4,60796,63328,2532
49053,UT,Washington,,2016,3.6,64578,67007,2429
49053,UT,Washington,,2017,3.4,68646,71043,2397
49053,UT,Washington,,2018,3.2,72265,74671,2406
49053,UT,Washington,,2019,2.9,74521,76786,2265
49053,UT,Washington,,2020,5.4,75746,80053,4307
49053,UT,Washington,,2021,2.9,81174,83600,2426
49055,UT,Wayne,,2007,4.1,1361,1419,58
49055,UT,Wayne,,2008,5.1,1333,1405,72
49055,UT,Wayne,,2009,8.1,1367,1487,120
49055,UT,Wayne,,2010,8.7,1433,1570,137
49055,UT,Wayne,,2011,10.4,1273,1421,148
49055,UT,Wayne,,2012,9.5,1195,1321,126
49055,UT,Wayne,,2013,10.1,1216,1352,136
49055,UT,Wayne,,2014,9,1246,1369,123
49055,UT,Wayne,,2015,8.9,1280,1405,125
49055,UT,Wayne,,2016,7.5,1312,1419,107
49055,UT,Wayne,,2017,7.1,1361,1465,104
49055,UT,Wayne,,2018,5.7,1357,1439,82
49055,UT,Wayne,,2019,5.4,1359,1436,77
49055,UT,Wayne,,2020,7.7,1338,1449,111
49055,UT,Wayne,,2021,4.7,1435,1506,71
49057,UT,Weber,,2007,3,110785,114269,3484
49057,UT,Weber,,2008,3.9,110479,115001,4522
49057,UT,Weber,,2009,8.3,105702,115309,9607
49057,UT,Weber,,2010,8.9,102717,112727,10010
49057,UT,Weber,,2011,8.2,102575,111692,9117
49057,UT,Weber,,2012,5.6,104929,111161,6232
49057,UT,Weber,,2013,5,107237,112850,5613
49057,UT,Weber,,2014,4.2,109106,113878,4772
49057,UT,Weber,,2015,4,111928,116610,4682
49057,UT,Weber,,2016,3.7,115214,119671,4457
49057,UT,Weber,,2017,3.5,119400,123793,4393
49057,UT,Weber,,2018,3.3,121848,125974,4126
49057,UT,Weber,,2019,2.9,124818,128564,3746
49057,UT,Weber,,2020,4.9,123701,130007,6306
49057,UT,Weber,,2021,2.9,127926,131718,3792
50000,VT,Vermont,,2007,3.9,339367,353268,13901
50000,VT,Vermont,,2008,4.5,337925,353986,16061
50000,VT,Vermont,,2009,6.2,337018,359282,22264
50000,VT,Vermont,,2010,6.3,336920,359692,22772
50000,VT,Vermont,,2011,5.6,337779,357676,19897
50000,VT,Vermont,,2012,4.8,336899,353947,17048
50000,VT,Vermont,,2013,4.4,334684,350175,15491
50000,VT,Vermont,,2014,4,334742,348697,13955
50000,VT,Vermont,,2015,3.5,334262,346512,12250
50000,VT,Vermont,,2016,3.1,335043,345851,10808
50000,VT,Vermont,,2017,3,344698,355385,10687
50000,VT,Vermont,,2018,2.6,347125,356456,9331
50000,VT,Vermont,,2019,2.3,347600,355950,8350
50000,VT,Vermont,,2020,5.6,322078,341137,19059
50000,VT,Vermont,,2021,3.4,316941,328216,11275
50001,VT,Addison,,2007,3.8,20715,21528,813
50001,VT,Addison,,2008,4.3,20684,21611,927
50001,VT,Addison,,2009,5.7,20624,21880,1256
50001,VT,Addison,,2010,6,19973,21257,1284
50001,VT,Addison,,2011,5,20017,21072,1055
50001,VT,Addison,,2012,4.4,19903,20815,912
50001,VT,Addison,,2013,4.1,19911,20770,859
50001,VT,Addison,,2014,3.8,20128,20914,786
50001,VT,Addison,,2015,3.4,20088,20801,713
50001,VT,Addison,,2016,2.9,20323,20925,602
50001,VT,Addison,,2017,2.8,20746,21348,602
50001,VT,Addison,,2018,2.5,20854,21392,538
50001,VT,Addison,,2019,2.3,20861,21350,489
50001,VT,Addison,,2020,4.6,19588,20531,943
50001,VT,Addison,,2021,2.8,19352,19901,549
50003,VT,Bennington,,2007,4,19639,20450,811
50003,VT,Bennington,,2008,4.7,19529,20483,954
50003,VT,Bennington,,2009,7.2,19097,20572,1475
50003,VT,Bennington,,2010,7.2,18896,20359,1463
50003,VT,Bennington,,2011,6.5,18643,19933,1290
50003,VT,Bennington,,2012,5.7,18484,19608,1124
50003,VT,Bennington,,2013,5.2,18254,19260,1006
50003,VT,Bennington,,2014,4.7,17886,18759,873
50003,VT,Bennington,,2015,4.2,17891,18671,780
50003,VT,Bennington,,2016,3.6,17830,18503,673
50003,VT,Bennington,,2017,3.6,18095,18780,685
50003,VT,Bennington,,2018,3.1,18315,18897,582
50003,VT,Bennington,,2019,2.9,18279,18822,543
50003,VT,Bennington,,2020,6.5,16580,17735,1155
50003,VT,Bennington,,2021,4.3,16189,16919,730
50005,VT,Caledonia,,2007,4.4,15974,16706,732
50005,VT,Caledonia,,2008,5,15927,16768,841
50005,VT,Caledonia,,2009,7.3,15518,16738,1220
50005,VT,Caledonia,,2010,7,15624,16805,1181
50005,VT,Caledonia,,2011,6.4,15520,16579,1059
50005,VT,Caledonia,,2012,6.1,15113,16087,974
50005,VT,Caledonia,,2013,5.3,14908,15744,836
50005,VT,Caledonia,,2014,4.9,14597,15344,747
50005,VT,Caledonia,,2015,4.6,14460,15158,698
50005,VT,Caledonia,,2016,4,14345,14946,601
50005,VT,Caledonia,,2017,3.7,14551,15110,559
50005,VT,Caledonia,,2018,3.2,14667,15157,490
50005,VT,Caledonia,,2019,2.9,14555,14992,437
50005,VT,Caledonia,,2020,6,13698,14571,873
50005,VT,Caledonia,,2021,3.7,13516,14037,521
50007,VT,Chittenden,,2007,3.3,85310,88226,2916
50007,VT,Chittenden,,2008,3.9,85333,88773,3440
50007,VT,Chittenden,,2009,5.3,85543,90297,4754
50007,VT,Chittenden,,2010,5,89890,94608,4718
50007,VT,Chittenden,,2011,4.3,91300,95373,4073
50007,VT,Chittenden,,2012,3.7,92113,95623,3510
50007,VT,Chittenden,,2013,3.4,91747,95009,3262
50007,VT,Chittenden,,2014,3.1,93018,95964,2946
50007,VT,Chittenden,,2015,2.7,92799,95366,2567
50007,VT,Chittenden,,2016,2.4,93248,95560,2312
50007,VT,Chittenden,,2017,2.3,97209,99460,2251
50007,VT,Chittenden,,2018,2,98196,100209,2013
50007,VT,Chittenden,,2019,1.8,98451,100222,1771
50007,VT,Chittenden,,2020,4.7,91705,96193,4488
50007,VT,Chittenden,,2021,2.8,90238,92865,2627
50009,VT,Essex,,2007,5.2,3091,3260,169
50009,VT,Essex,,2008,6,3055,3250,195
50009,VT,Essex,,2009,8.4,3030,3309,279
50009,VT,Essex,,2010,10.3,2851,3180,329
50009,VT,Essex,,2011,8.5,2798,3058,260
50009,VT,Essex,,2012,7.8,2694,2923,229
50009,VT,Essex,,2013,6.7,2647,2838,191
50009,VT,Essex,,2014,6,2616,2782,166
50009,VT,Essex,,2015,5.7,2612,2770,158
50009,VT,Essex,,2016,4.8,2577,2708,131
50009,VT,Essex,,2017,4.6,2642,2770,128
50009,VT,Essex,,2018,3.6,2681,2781,100
50009,VT,Essex,,2019,3.2,2686,2775,89
50009,VT,Essex,,2020,7.6,2507,2714,207
50009,VT,Essex,,2021,4.8,2487,2613,126
50011,VT,Franklin,,2007,4.2,24829,25928,1099
50011,VT,Franklin,,2008,4.8,24690,25926,1236
50011,VT,Franklin,,2009,6.1,24944,26578,1634
50011,VT,Franklin,,2010,5.9,26063,27704,1641
50011,VT,Franklin,,2011,5.2,26409,27866,1457
50011,VT,Franklin,,2012,4.4,26578,27787,1209
50011,VT,Franklin,,2013,4.2,26318,27469,1151
50011,VT,Franklin,,2014,4,26493,27595,1102
50011,VT,Franklin,,2015,3.5,26471,27438,967
50011,VT,Franklin,,2016,3,26623,27448,825
50011,VT,Franklin,,2017,3,27539,28404,865
50011,VT,Franklin,,2018,2.5,27756,28461,705
50011,VT,Franklin,,2019,2.3,27843,28498,655
50011,VT,Franklin,,2020,5.1,25978,27373,1395
50011,VT,Franklin,,2021,3.5,25798,26722,924
50013,VT,Grand Isle,,2007,5.3,3966,4190,224
50013,VT,Grand Isle,,2008,5.8,4008,4256,248
50013,VT,Grand Isle,,2009,7.3,3942,4252,310
50013,VT,Grand Isle,,2010,7.2,3841,4139,298
50013,VT,Grand Isle,,2011,6.4,3894,4162,268
50013,VT,Grand Isle,,2012,5.3,3904,4121,217
50013,VT,Grand Isle,,2013,4.5,3869,4051,182
50013,VT,Grand Isle,,2014,4.5,3901,4085,184
50013,VT,Grand Isle,,2015,3.9,3799,3955,156
50013,VT,Grand Isle,,2016,3.6,3844,3988,144
50013,VT,Grand Isle,,2017,3.5,4029,4174,145
50013,VT,Grand Isle,,2018,3.2,4070,4203,133
50013,VT,Grand Isle,,2019,2.8,4182,4302,120
50013,VT,Grand Isle,,2020,5.8,3847,4085,238
50013,VT,Grand Isle,,2021,3.9,3786,3941,155
50015,VT,Lamoille,,2007,4.7,14387,15089,702
50015,VT,Lamoille,,2008,5.3,14301,15095,794
50015,VT,Lamoille,,2009,7.1,14546,15659,1113
50015,VT,Lamoille,,2010,7.9,13371,14518,1147
50015,VT,Lamoille,,2011,7,13513,14537,1024
50015,VT,Lamoille,,2012,6.2,13132,13997,865
50015,VT,Lamoille,,2013,5.7,13084,13873,789
50015,VT,Lamoille,,2014,5.2,13103,13818,715
50015,VT,Lamoille,,2015,4.6,13212,13848,636
50015,VT,Lamoille,,2016,4.1,13389,13961,572
50015,VT,Lamoille,,2017,4,13893,14471,578
50015,VT,Lamoille,,2018,3.5,13920,14422,502
50015,VT,Lamoille,,2019,3.1,14022,14464,442
50015,VT,Lamoille,,2020,7.7,12838,13914,1076
50015,VT,Lamoille,,2021,4,12841,13380,539
50017,VT,Orange,,2007,3.7,15859,16462,603
50017,VT,Orange,,2008,4.3,15574,16268,694
50017,VT,Orange,,2009,5.8,15647,16614,967
50017,VT,Orange,,2010,6.1,15718,16739,1021
50017,VT,Orange,,2011,5.4,15679,16577,898
50017,VT,Orange,,2012,4.6,15658,16409,751
50017,VT,Orange,,2013,4.1,15499,16164,665
50017,VT,Orange,,2014,3.9,15347,15965,618
50017,VT,Orange,,2015,3.4,15435,15978,543
50017,VT,Orange,,2016,3,15472,15951,479
50017,VT,Orange,,2017,3.1,15875,16378,503
50017,VT,Orange,,2018,2.6,16017,16449,432
50017,VT,Orange,,2019,2.3,16156,16542,386
50017,VT,Orange,,2020,5.3,15054,15890,836
50017,VT,Orange,,2021,3.2,14737,15227,490
50019,VT,Orleans,,2007,6,13482,14338,856
50019,VT,Orleans,,2008,6.7,13242,14192,950
50019,VT,Orleans,,2009,8.6,13285,14536,1251
50019,VT,Orleans,,2010,9.2,12926,14240,1314
50019,VT,Orleans,,2011,8.5,12948,14158,1210
50019,VT,Orleans,,2012,7.5,13013,14071,1058
50019,VT,Orleans,,2013,6.8,12870,13813,943
50019,VT,Orleans,,2014,6.3,12822,13680,858
50019,VT,Orleans,,2015,5.5,12908,13661,753
50019,VT,Orleans,,2016,5.1,12883,13572,689
50019,VT,Orleans,,2017,5.1,13272,13988,716
50019,VT,Orleans,,2018,4.4,13332,13947,615
50019,VT,Orleans,,2019,4.2,13200,13774,574
50019,VT,Orleans,,2020,7.7,12105,13118,1013
50019,VT,Orleans,,2021,4.6,12178,12770,592
50021,VT,Rutland,,2007,4.3,34124,35653,1529
50021,VT,Rutland,,2008,5.3,33730,35629,1899
50021,VT,Rutland,,2009,7.5,32919,35572,2653
50021,VT,Rutland,,2010,7.7,31053,33635,2582
50021,VT,Rutland,,2011,6.9,30962,33254,2292
50021,VT,Rutland,,2012,6.1,30720,32706,1986
50021,VT,Rutland,,2013,5.3,30537,32256,1719
50021,VT,Rutland,,2014,4.8,30393,31918,1525
50021,VT,Rutland,,2015,4.2,30111,31435,1324
50021,VT,Rutland,,2016,3.6,30405,31554,1149
50021,VT,Rutland,,2017,3.5,30847,31966,1119
50021,VT,Rutland,,2018,3.1,30770,31747,977
50021,VT,Rutland,,2019,2.7,30764,31621,857
50021,VT,Rutland,,2020,6.7,28274,30306,2032
50021,VT,Rutland,,2021,4.2,27751,28966,1215
50023,VT,Washington,,2007,4,32744,34110,1366
50023,VT,Washington,,2008,4.6,32690,34257,1567
50023,VT,Washington,,2009,5.9,32733,34789,2056
50023,VT,Washington,,2010,6.1,32995,35143,2148
50023,VT,Washington,,2011,5.3,32962,34819,1857
50023,VT,Washington,,2012,4.6,32961,34544,1583
50023,VT,Washington,,2013,4.3,33064,34555,1491
50023,VT,Washington,,2014,3.9,33067,34412,1345
50023,VT,Washington,,2015,3.4,33055,34236,1181
50023,VT,Washington,,2016,3.1,32965,34014,1049
50023,VT,Washington,,2017,2.9,34178,35215,1037
50023,VT,Washington,,2018,2.6,34721,35630,909
50023,VT,Washington,,2019,2.2,34948,35748,800
50023,VT,Washington,,2020,4.9,32354,34017,1663
50023,VT,Washington,,2021,3,31416,32392,976
50025,VT,Windham,,2007,4,23684,24670,986
50025,VT,Windham,,2008,4.4,23666,24761,1095
50025,VT,Windham,,2009,5.9,23736,25228,1492
50025,VT,Windham,,2010,6.4,23833,25456,1623
50025,VT,Windham,,2011,5.7,23534,24953,1419
50025,VT,Windham,,2012,5,23366,24604,1238
50025,VT,Windham,,2013,4.7,22947,24075,1128
50025,VT,Windham,,2014,4.1,22647,23623,976
50025,VT,Windham,,2015,3.5,22745,23577,832
50025,VT,Windham,,2016,3.2,22545,23294,749
50025,VT,Windham,,2017,3.1,22733,23460,727
50025,VT,Windham,,2018,2.8,22545,23193,648
50025,VT,Windham,,2019,2.5,22228,22799,571
50025,VT,Windham,,2020,6.6,20239,21680,1441
50025,VT,Windham,,2021,4.4,19506,20410,904
50027,VT,Windsor,,2007,3.3,31580,32661,1081
50027,VT,Windsor,,2008,3.7,31506,32709,1203
50027,VT,Windsor,,2009,5.4,31464,33274,1810
50027,VT,Windsor,,2010,6.3,29891,31913,2022
50027,VT,Windsor,,2011,5.5,29600,31333,1733
50027,VT,Windsor,,2012,4.5,29261,30650,1389
50027,VT,Windsor,,2013,4.2,29029,30300,1271
50027,VT,Windsor,,2014,3.7,28723,29835,1112
50027,VT,Windsor,,2015,3.2,28678,29621,943
50027,VT,Windsor,,2016,2.8,28594,29429,835
50027,VT,Windsor,,2017,2.6,29088,29856,768
50027,VT,Windsor,,2018,2.3,29279,29966,687
50027,VT,Windsor,,2019,2.1,29424,30044,620
50027,VT,Windsor,,2020,5.9,27312,29011,1699
50027,VT,Windsor,,2021,3.3,27145,28071,926
51000,VA,Virginia,,2007,3.3,3906626,4039414,132788
51000,VA,Virginia,,2008,4.3,3952723,4128589,175866
51000,VA,Virginia,,2009,6.8,3853351,4136186,282835
51000,VA,Virginia,,2010,7.3,3858466,4163293,304827
51000,VA,Virginia,,2011,6.6,3929008,4205184,276176
51000,VA,Virginia,,2012,5.9,3967151,4217529,250378
51000,VA,Virginia,,2013,5.6,4002057,4238377,236320
51000,VA,Virginia,,2014,5.1,4040908,4258856,217948
51000,VA,Virginia,,2015,4.4,4048081,4233981,185900
51000,VA,Virginia,,2016,4,4084822,4254348,169526
51000,VA,Virginia,,2017,3.7,4193290,4352977,159687
51000,VA,Virginia,,2018,3,4255213,4384657,129444
51000,VA,Virginia,,2019,2.8,4332647,4455815,123168
51000,VA,Virginia,,2020,6.2,4097860,4368772,270912
51000,VA,Virginia,,2021,3.9,4100803,4267656,166853
51001,VA,Accomack,,2007,4.4,17974,18810,836
51001,VA,Accomack,,2008,5.4,17964,18986,1022
51001,VA,Accomack,,2009,6.6,18478,19790,1312
51001,VA,Accomack,,2010,8.1,15471,16831,1360
51001,VA,Accomack,,2011,8.4,15177,16564,1387
51001,VA,Accomack,,2012,7.7,15123,16388,1265
51001,VA,Accomack,,2013,7,15083,16226,1143
51001,VA,Accomack,,2014,6.6,15056,16112,1056
51001,VA,Accomack,,2015,5.4,15082,15938,856
51001,VA,Accomack,,2016,4.8,15060,15820,760
51001,VA,Accomack,,2017,4.5,16035,16789,754
51001,VA,Accomack,,2018,3.8,16273,16913,640
51001,VA,Accomack,,2019,3.5,16206,16795,589
51001,VA,Accomack,,2020,6.5,14987,16025,1038
51001,VA,Accomack,,2021,4.3,14516,15176,660
51003,VA,Albemarle,,2007,2.4,50080,51323,1243
51003,VA,Albemarle,,2008,3.2,50855,52545,1690
51003,VA,Albemarle,,2009,5.2,49407,52139,2732
51003,VA,Albemarle,,2010,6.1,47912,51043,3131
51003,VA,Albemarle,,2011,5.6,49185,52080,2895
51003,VA,Albemarle,,2012,5.1,49877,52571,2694
51003,VA,Albemarle,,2013,4.7,50068,52554,2486
51003,VA,Albemarle,,2014,4.4,51417,53788,2371
51003,VA,Albemarle,,2015,3.8,52053,54136,2083
51003,VA,Albemarle,,2016,3.5,52631,54534,1903
51003,VA,Albemarle,,2017,3.3,54055,55877,1822
51003,VA,Albemarle,,2018,2.7,55264,56771,1507
51003,VA,Albemarle,,2019,2.4,57256,58689,1433
51003,VA,Albemarle,,2020,5.3,53473,56485,3012
51003,VA,Albemarle,,2021,3.2,53650,55448,1798
51005,VA,Alleghany,,2007,4.7,6662,6991,329
51005,VA,Alleghany,,2008,5.8,6481,6882,401
51005,VA,Alleghany,,2009,9.3,6445,7105,660
51005,VA,Alleghany,,2010,8.8,7261,7964,703
51005,VA,Alleghany,,2011,7.8,7276,7893,617
51005,VA,Alleghany,,2012,6.9,7248,7788,540
51005,VA,Alleghany,,2013,6.4,7032,7515,483
51005,VA,Alleghany,,2014,5.8,6801,7221,420
51005,VA,Alleghany,,2015,5,6722,7075,353
51005,VA,Alleghany,,2016,5,6593,6941,348
51005,VA,Alleghany,,2017,4.5,6749,7070,321
51005,VA,Alleghany,,2018,3.7,6742,6999,257
51005,VA,Alleghany,,2019,3.3,6822,7058,236
51005,VA,Alleghany,,2020,6.5,6367,6810,443
51005,VA,Alleghany,,2021,4.1,6245,6512,267
51007,VA,Amelia,,2007,3,6371,6567,196
51007,VA,Amelia,,2008,4.8,6430,6756,326
51007,VA,Amelia,,2009,7.9,6152,6681,529
51007,VA,Amelia,,2010,8.7,5697,6238,541
51007,VA,Amelia,,2011,7.5,5785,6251,466
51007,VA,Amelia,,2012,6.4,5811,6208,397
51007,VA,Amelia,,2013,5.8,5816,6173,357
51007,VA,Amelia,,2014,5.2,5908,6230,322
51007,VA,Amelia,,2015,4.4,5941,6215,274
51007,VA,Amelia,,2016,4.2,5947,6207,260
51007,VA,Amelia,,2017,3.9,6021,6268,247
51007,VA,Amelia,,2018,3.2,6066,6268,202
51007,VA,Amelia,,2019,3.1,6205,6404,199
51007,VA,Amelia,,2020,5.8,5777,6132,355
51007,VA,Amelia,,2021,3.6,5771,5984,213
51009,VA,Amherst,,2007,3.8,14960,15544,584
51009,VA,Amherst,,2008,4.4,15295,16007,712
51009,VA,Amherst,,2009,7.9,14458,15699,1241
51009,VA,Amherst,,2010,8.2,15022,16372,1350
51009,VA,Amherst,,2011,7.2,14983,16153,1170
51009,VA,Amherst,,2012,6.6,14990,16043,1053
51009,VA,Amherst,,2013,6,14856,15801,945
51009,VA,Amherst,,2014,5.3,14847,15682,835
51009,VA,Amherst,,2015,4.7,14618,15340,722
51009,VA,Amherst,,2016,4.3,14364,15010,646
51009,VA,Amherst,,2017,4,14533,15146,613
51009,VA,Amherst,,2018,3.3,14601,15093,492
51009,VA,Amherst,,2019,3.2,14772,15253,481
51009,VA,Amherst,,2020,5.5,13944,14763,819
51009,VA,Amherst,,2021,3.7,13812,14340,528
51011,VA,Appomattox,,2007,4.2,6712,7006,294
51011,VA,Appomattox,,2008,4.8,6941,7292,351
51011,VA,Appomattox,,2009,8.1,6595,7174,579
51011,VA,Appomattox,,2010,8.8,6707,7354,647
51011,VA,Appomattox,,2011,7.9,6675,7250,575
51011,VA,Appomattox,,2012,7.3,6684,7211,527
51011,VA,Appomattox,,2013,6.3,6707,7158,451
51011,VA,Appomattox,,2014,5.6,6739,7139,400
51011,VA,Appomattox,,2015,4.8,6725,7066,341
51011,VA,Appomattox,,2016,4.6,6684,7006,322
51011,VA,Appomattox,,2017,4.3,6842,7151,309
51011,VA,Appomattox,,2018,3.6,6929,7189,260
51011,VA,Appomattox,,2019,3.4,7060,7310,250
51011,VA,Appomattox,,2020,5.7,6713,7121,408
51011,VA,Appomattox,,2021,3.9,6648,6915,267
51013,VA,Arlington,,2007,2.1,128594,131327,2733
51013,VA,Arlington,,2008,2.7,132754,136375,3621
51013,VA,Arlington,,2009,4.4,131729,137724,5995
51013,VA,Arlington,,2010,4.2,131635,137453,5818
51013,VA,Arlington,,2011,3.7,136334,141644,5310
51013,VA,Arlington,,2012,3.4,138982,143875,4893
51013,VA,Arlington,,2013,3.4,140275,145169,4894
51013,VA,Arlington,,2014,3.2,140437,145098,4661
51013,VA,Arlington,,2015,2.8,140880,144902,4022
51013,VA,Arlington,,2016,2.6,142857,146628,3771
51013,VA,Arlington,,2017,2.5,147637,151365,3728
51013,VA,Arlington,,2018,2,150729,153786,3057
51013,VA,Arlington,,2019,1.9,153294,156258,2964
51013,VA,Arlington,,2020,4.4,145804,152550,6746
51013,VA,Arlington,,2021,3,146210,150721,4511
51015,VA,Augusta,,2007,2.8,36135,37195,1060
51015,VA,Augusta,,2008,3.9,36355,37833,1478
51015,VA,Augusta,,2009,6.6,36065,38600,2535
51015,VA,Augusta,,2010,7.3,34464,37184,2720
51015,VA,Augusta,,2011,6.3,35012,37375,2363
51015,VA,Augusta,,2012,5.7,34890,36990,2100
51015,VA,Augusta,,2013,5.1,35024,36905,1881
51015,VA,Augusta,,2014,4.6,35275,36977,1702
51015,VA,Augusta,,2015,4,35304,36791,1487
51015,VA,Augusta,,2016,3.6,35570,36898,1328
51015,VA,Augusta,,2017,3.4,35823,37072,1249
51015,VA,Augusta,,2018,2.7,36170,37168,998
51015,VA,Augusta,,2019,2.4,37089,38009,920
51015,VA,Augusta,,2020,4.6,35471,37173,1702
51015,VA,Augusta,,2021,3.1,35201,36312,1111
51017,VA,Bath,,2007,3.4,2831,2932,101
51017,VA,Bath,,2008,4.4,2672,2795,123
51017,VA,Bath,,2009,6.4,2530,2702,172
51017,VA,Bath,,2010,7.7,2319,2513,194
51017,VA,Bath,,2011,6.3,2410,2572,162
51017,VA,Bath,,2012,5.7,2435,2582,147
51017,VA,Bath,,2013,5.2,2445,2578,133
51017,VA,Bath,,2014,4.4,2488,2602,114
51017,VA,Bath,,2015,4,2444,2546,102
51017,VA,Bath,,2016,3.6,2408,2499,91
51017,VA,Bath,,2017,3,2508,2585,77
51017,VA,Bath,,2018,2.4,2477,2539,62
51017,VA,Bath,,2019,2.4,2445,2505,60
51017,VA,Bath,,2020,9.9,2080,2309,229
51017,VA,Bath,,2021,4.6,2118,2219,101
51019,VA,Bedford,,2007,3.2,36527,37743,1216
51019,VA,Bedford,,2008,4,37028,38554,1526
51019,VA,Bedford,,2009,7,35236,37871,2635
51019,VA,Bedford,,2010,7.2,36284,39107,2823
51019,VA,Bedford,,2011,6.5,36258,38759,2501
51019,VA,Bedford,,2012,5.8,36030,38267,2237
51019,VA,Bedford,,2013,5.6,36114,38242,2128
51019,VA,Bedford,,2014,5,36641,38576,1935
51019,VA,Bedford,,2015,4.4,36703,38381,1678
51019,VA,Bedford,,2016,4,36486,38012,1526
51019,VA,Bedford,,2017,3.8,36985,38458,1473
51019,VA,Bedford,,2018,3,37484,38654,1170
51019,VA,Bedford,,2019,2.8,38109,39215,1106
51019,VA,Bedford,,2020,5.1,36284,38220,1936
51019,VA,Bedford,,2021,3.4,35981,37256,1275
51021,VA,Bland,,2007,4.1,3251,3389,138
51021,VA,Bland,,2008,5.1,3315,3494,179
51021,VA,Bland,,2009,7.6,3338,3611,273
51021,VA,Bland,,2010,8.8,2645,2899,254
51021,VA,Bland,,2011,7.4,2644,2854,210
51021,VA,Bland,,2012,6.9,2673,2871,198
51021,VA,Bland,,2013,6.6,2687,2877,190
51021,VA,Bland,,2014,5.9,2706,2876,170
51021,VA,Bland,,2015,5.6,2635,2792,157
51021,VA,Bland,,2016,5.1,2601,2742,141
51021,VA,Bland,,2017,4,2777,2894,117
51021,VA,Bland,,2018,3.1,2772,2862,90
51021,VA,Bland,,2019,2.7,2798,2877,79
51021,VA,Bland,,2020,5.6,2653,2811,158
51021,VA,Bland,,2021,3.4,2627,2720,93
51023,VA,Botetourt,,2007,2.9,16930,17427,497
51023,VA,Botetourt,,2008,3.5,17103,17728,625
51023,VA,Botetourt,,2009,6.4,16437,17565,1128
51023,VA,Botetourt,,2010,6.6,16551,17722,1171
51023,VA,Botetourt,,2011,5.9,16667,17703,1036
51023,VA,Botetourt,,2012,5.4,16752,17702,950
51023,VA,Botetourt,,2013,5.1,16731,17634,903
51023,VA,Botetourt,,2014,4.8,16900,17749,849
51023,VA,Botetourt,,2015,4.1,16738,17459,721
51023,VA,Botetourt,,2016,3.6,16755,17375,620
51023,VA,Botetourt,,2017,3.5,16828,17435,607
51023,VA,Botetourt,,2018,2.7,16993,17457,464
51023,VA,Botetourt,,2019,2.5,17351,17796,445
51023,VA,Botetourt,,2020,4.5,16543,17321,778
51023,VA,Botetourt,,2021,3,16463,16976,513
51025,VA,Brunswick,,2007,5.2,6531,6888,357
51025,VA,Brunswick,,2008,7.1,6548,7050,502
51025,VA,Brunswick,,2009,11.4,6406,7234,828
51025,VA,Brunswick,,2010,11.5,6165,6968,803
51025,VA,Brunswick,,2011,10.5,6089,6806,717
51025,VA,Brunswick,,2012,9.9,6051,6717,666
51025,VA,Brunswick,,2013,9.2,6046,6656,610
51025,VA,Brunswick,,2014,7.9,5971,6485,514
51025,VA,Brunswick,,2015,6.7,5928,6355,427
51025,VA,Brunswick,,2016,5.9,5852,6216,364
51025,VA,Brunswick,,2017,5.2,5852,6176,324
51025,VA,Brunswick,,2018,4.9,5760,6057,297
51025,VA,Brunswick,,2019,4.6,5832,6115,283
51025,VA,Brunswick,,2020,7.9,5481,5951,470
51025,VA,Brunswick,,2021,6.3,5350,5708,358
51027,VA,Buchanan,,2007,5.3,8219,8675,456
51027,VA,Buchanan,,2008,5.4,8464,8948,484
51027,VA,Buchanan,,2009,8.7,8472,9280,808
51027,VA,Buchanan,,2010,10.1,7493,8339,846
51027,VA,Buchanan,,2011,8.5,7740,8458,718
51027,VA,Buchanan,,2012,8.9,7805,8569,764
51027,VA,Buchanan,,2013,10.8,7281,8159,878
51027,VA,Buchanan,,2014,10.3,6988,7788,800
51027,VA,Buchanan,,2015,10.7,6517,7298,781
51027,VA,Buchanan,,2016,10.6,6136,6860,724
51027,VA,Buchanan,,2017,7,6561,7055,494
51027,VA,Buchanan,,2018,5.4,6616,6994,378
51027,VA,Buchanan,,2019,5.5,6504,6882,378
51027,VA,Buchanan,,2020,9.4,5823,6430,607
51027,VA,Buchanan,,2021,6.7,5717,6130,413
51029,VA,Buckingham,,2007,3.7,6743,7005,262
51029,VA,Buckingham,,2008,5.3,6880,7264,384
51029,VA,Buckingham,,2009,8.3,6794,7407,613
51029,VA,Buckingham,,2010,10.9,5866,6583,717
51029,VA,Buckingham,,2011,9.5,5955,6583,628
51029,VA,Buckingham,,2012,8.4,5920,6460,540
51029,VA,Buckingham,,2013,7.7,5910,6406,496
51029,VA,Buckingham,,2014,6.7,5900,6322,422
51029,VA,Buckingham,,2015,5.8,5948,6317,369
51029,VA,Buckingham,,2016,5.3,5939,6273,334
51029,VA,Buckingham,,2017,5.3,6037,6377,340
51029,VA,Buckingham,,2018,4.4,6092,6374,282
51029,VA,Buckingham,,2019,4.1,6335,6606,271
51029,VA,Buckingham,,2020,7.3,5863,6326,463
51029,VA,Buckingham,,2021,5.3,5879,6205,326
51031,VA,Campbell,,2007,3.7,26269,27279,1010
51031,VA,Campbell,,2008,4.3,26688,27883,1195
51031,VA,Campbell,,2009,7.4,25245,27258,2013
51031,VA,Campbell,,2010,7.9,25601,27793,2192
51031,VA,Campbell,,2011,7.1,25594,27560,1966
51031,VA,Campbell,,2012,6.3,25331,27044,1713
51031,VA,Campbell,,2013,5.8,25375,26942,1567
51031,VA,Campbell,,2014,5.3,25317,26725,1408
51031,VA,Campbell,,2015,4.7,25100,26328,1228
51031,VA,Campbell,,2016,4.4,24840,25973,1133
51031,VA,Campbell,,2017,4.1,25223,26301,1078
51031,VA,Campbell,,2018,3.3,25273,26148,875
51031,VA,Campbell,,2019,3.1,25566,26378,812
51031,VA,Campbell,,2020,5.8,24261,25759,1498
51031,VA,Campbell,,2021,3.8,24042,24996,954
51033,VA,Caroline,,2007,4,13359,13919,560
51033,VA,Caroline,,2008,5.2,13528,14264,736
51033,VA,Caroline,,2009,8.6,12977,14193,1216
51033,VA,Caroline,,2010,9.7,12966,14363,1397
51033,VA,Caroline,,2011,8.9,13157,14450,1293
51033,VA,Caroline,,2012,7.6,13370,14477,1107
51033,VA,Caroline,,2013,6.9,13573,14579,1006
51033,VA,Caroline,,2014,6.1,13922,14819,897
51033,VA,Caroline,,2015,5,14047,14790,743
51033,VA,Caroline,,2016,4.4,14224,14875,651
51033,VA,Caroline,,2017,4.2,14519,15163,644
51033,VA,Caroline,,2018,3.4,14769,15296,527
51033,VA,Caroline,,2019,3.2,14899,15389,490
51033,VA,Caroline,,2020,6.7,14024,15029,1005
51033,VA,Caroline,,2021,4.3,14012,14644,632
51035,VA,Carroll,,2007,6.1,13091,13941,850
51035,VA,Carroll,,2008,7.2,13065,14072,1007
51035,VA,Carroll,,2009,11,12884,14484,1600
51035,VA,Carroll,,2010,11.8,12382,14032,1650
51035,VA,Carroll,,2011,9.8,12267,13602,1335
51035,VA,Carroll,,2012,8.4,12341,13467,1126
51035,VA,Carroll,,2013,8.1,12185,13256,1071
51035,VA,Carroll,,2014,6.6,12357,13229,872
51035,VA,Carroll,,2015,5.3,12409,13100,691
51035,VA,Carroll,,2016,5.1,12321,12977,656
51035,VA,Carroll,,2017,4.4,13040,13637,597
51035,VA,Carroll,,2018,3.6,12941,13420,479
51035,VA,Carroll,,2019,3.5,12976,13451,475
51035,VA,Carroll,,2020,8.2,12116,13195,1079
51035,VA,Carroll,,2021,4.1,12255,12778,523
51036,VA,Charles City,,2007,4.2,3653,3814,161
51036,VA,Charles City,,2008,5.4,3675,3885,210
51036,VA,Charles City,,2009,9.2,3498,3852,354
51036,VA,Charles City,,2010,9.8,3525,3908,383
51036,VA,Charles City,,2011,9,3578,3930,352
51036,VA,Charles City,,2012,7.7,3551,3847,296
51036,VA,Charles City,,2013,6.6,3538,3788,250
51036,VA,Charles City,,2014,5.8,3512,3730,218
51036,VA,Charles City,,2015,5.3,3535,3731,196
51036,VA,Charles City,,2016,4.5,3558,3724,166
51036,VA,Charles City,,2017,4.7,3542,3718,176
51036,VA,Charles City,,2018,4,3532,3678,146
51036,VA,Charles City,,2019,3.4,3587,3714,127
51036,VA,Charles City,,2020,6.6,3300,3534,234
51036,VA,Charles City,,2021,4.4,3292,3443,151
51037,VA,Charlotte,,2007,5.7,4978,5281,303
51037,VA,Charlotte,,2008,6.4,5091,5438,347
51037,VA,Charlotte,,2009,9.4,5051,5575,524
51037,VA,Charlotte,,2010,10.2,4818,5368,550
51037,VA,Charlotte,,2011,9.8,4865,5391,526
51037,VA,Charlotte,,2012,8.5,4897,5354,457
51037,VA,Charlotte,,2013,7.6,4909,5312,403
51037,VA,Charlotte,,2014,6.6,4964,5317,353
51037,VA,Charlotte,,2015,5.6,4975,5271,296
51037,VA,Charlotte,,2016,4.9,5000,5259,259
51037,VA,Charlotte,,2017,4.5,5128,5371,243
51037,VA,Charlotte,,2018,3.6,5070,5261,191
51037,VA,Charlotte,,2019,3.5,5140,5326,186
51037,VA,Charlotte,,2020,5.5,4830,5113,283
51037,VA,Charlotte,,2021,3.7,5013,5206,193
51041,VA,Chesterfield,,2007,2.8,161024,165729,4705
51041,VA,Chesterfield,,2008,4,162997,169701,6704
51041,VA,Chesterfield,,2009,6.8,156656,168067,11411
51041,VA,Chesterfield,,2010,7.5,156230,168850,12620
51041,VA,Chesterfield,,2011,6.7,159724,171269,11545
51041,VA,Chesterfield,,2012,6,162399,172730,10331
51041,VA,Chesterfield,,2013,5.5,165077,174719,9642
51041,VA,Chesterfield,,2014,5,169093,178043,8950
51041,VA,Chesterfield,,2015,4.2,171090,178675,7585
51041,VA,Chesterfield,,2016,3.8,174105,180972,6867
51041,VA,Chesterfield,,2017,3.6,178778,185395,6617
51041,VA,Chesterfield,,2018,2.9,182542,187984,5442
51041,VA,Chesterfield,,2019,2.7,186569,191771,5202
51041,VA,Chesterfield,,2020,5.8,177388,188369,10981
51041,VA,Chesterfield,,2021,3.6,177248,183962,6714
51043,VA,Clarke,,2007,2.9,7787,8020,233
51043,VA,Clarke,,2008,3.7,7880,8182,302
51043,VA,Clarke,,2009,6.4,7612,8136,524
51043,VA,Clarke,,2010,6.8,7178,7705,527
51043,VA,Clarke,,2011,5.7,7318,7761,443
51043,VA,Clarke,,2012,5.1,7331,7728,397
51043,VA,Clarke,,2013,4.6,7273,7626,353
51043,VA,Clarke,,2014,4.3,7246,7572,326
51043,VA,Clarke,,2015,3.9,7168,7461,293
51043,VA,Clarke,,2016,3.5,7184,7446,262
51043,VA,Clarke,,2017,3.4,7266,7521,255
51043,VA,Clarke,,2018,2.9,7359,7576,217
51043,VA,Clarke,,2019,2.4,7573,7762,189
51043,VA,Clarke,,2020,4.6,7138,7479,341
51043,VA,Clarke,,2021,3.1,7155,7383,228
51045,VA,Craig,,2007,4,2460,2563,103
51045,VA,Craig,,2008,4.4,2439,2550,111
51045,VA,Craig,,2009,7.5,2269,2454,185
51045,VA,Craig,,2010,8.1,2245,2444,199
51045,VA,Craig,,2011,7.5,2291,2477,186
51045,VA,Craig,,2012,6.9,2292,2461,169
51045,VA,Craig,,2013,6.9,2287,2456,169
51045,VA,Craig,,2014,6.2,2312,2466,154
51045,VA,Craig,,2015,5.4,2259,2389,130
51045,VA,Craig,,2016,4.7,2243,2353,110
51045,VA,Craig,,2017,4.3,2210,2309,99
51045,VA,Craig,,2018,3.5,2231,2313,82
51045,VA,Craig,,2019,3.1,2298,2372,74
51045,VA,Craig,,2020,5.1,2157,2273,116
51045,VA,Craig,,2021,3.3,2148,2222,74
51047,VA,Culpeper,,2007,3.9,19460,20248,788
51047,VA,Culpeper,,2008,5.2,19867,20952,1085
51047,VA,Culpeper,,2009,8.1,19677,21407,1730
51047,VA,Culpeper,,2010,7.3,21580,23289,1709
51047,VA,Culpeper,,2011,6.3,21878,23359,1481
51047,VA,Culpeper,,2012,5.6,22029,23329,1300
51047,VA,Culpeper,,2013,5.2,22161,23387,1226
51047,VA,Culpeper,,2014,4.9,22281,23431,1150
51047,VA,Culpeper,,2015,4.3,22202,23196,994
51047,VA,Culpeper,,2016,3.8,22585,23481,896
51047,VA,Culpeper,,2017,3.6,23268,24132,864
51047,VA,Culpeper,,2018,2.8,23824,24522,698
51047,VA,Culpeper,,2019,2.6,24675,25324,649
51047,VA,Culpeper,,2020,4.9,23655,24876,1221
51047,VA,Culpeper,,2021,3.2,23745,24541,796
51049,VA,Cumberland,,2007,3.5,4437,4596,159
51049,VA,Cumberland,,2008,5.1,4455,4696,241
51049,VA,Cumberland,,2009,7.4,4274,4618,344
51049,VA,Cumberland,,2010,8.6,4139,4530,391
51049,VA,Cumberland,,2011,7.6,4206,4552,346
51049,VA,Cumberland,,2012,7,4204,4520,316
51049,VA,Cumberland,,2013,6.5,4215,4508,293
51049,VA,Cumberland,,2014,6,4279,4553,274
51049,VA,Cumberland,,2015,5.1,4341,4573,232
51049,VA,Cumberland,,2016,4.5,4400,4609,209
51049,VA,Cumberland,,2017,4.1,4536,4731,195
51049,VA,Cumberland,,2018,3.2,4543,4694,151
51049,VA,Cumberland,,2019,3,4585,4726,141
51049,VA,Cumberland,,2020,6,4325,4603,278
51049,VA,Cumberland,,2021,4.3,4343,4537,194
51051,VA,Dickenson,,2007,5.6,5473,5800,327
51051,VA,Dickenson,,2008,6.2,5701,6076,375
51051,VA,Dickenson,,2009,8.8,5901,6473,572
51051,VA,Dickenson,,2010,10.7,4931,5524,593
51051,VA,Dickenson,,2011,9.9,4913,5451,538
51051,VA,Dickenson,,2012,10.5,4660,5204,544
51051,VA,Dickenson,,2013,10.9,4758,5341,583
51051,VA,Dickenson,,2014,10,4688,5209,521
51051,VA,Dickenson,,2015,10,4436,4927,491
51051,VA,Dickenson,,2016,9.8,4128,4575,447
51051,VA,Dickenson,,2017,6.7,4362,4676,314
51051,VA,Dickenson,,2018,5.1,4333,4565,232
51051,VA,Dickenson,,2019,4.9,4512,4745,233
51051,VA,Dickenson,,2020,7.9,4372,4747,375
51051,VA,Dickenson,,2021,5.3,4398,4645,247
51053,VA,Dinwiddie,,2007,3.7,12375,12853,478
51053,VA,Dinwiddie,,2008,4.9,12537,13183,646
51053,VA,Dinwiddie,,2009,8.2,12044,13121,1077
51053,VA,Dinwiddie,,2010,9.1,12361,13591,1230
51053,VA,Dinwiddie,,2011,8,12538,13622,1084
51053,VA,Dinwiddie,,2012,7.4,12600,13612,1012
51053,VA,Dinwiddie,,2013,7.2,12565,13538,973
51053,VA,Dinwiddie,,2014,6.3,12650,13505,855
51053,VA,Dinwiddie,,2015,5.3,12648,13362,714
51053,VA,Dinwiddie,,2016,4.8,12815,13461,646
51053,VA,Dinwiddie,,2017,4.4,12950,13552,602
51053,VA,Dinwiddie,,2018,3.5,13210,13684,474
51053,VA,Dinwiddie,,2019,3.3,13365,13814,449
51053,VA,Dinwiddie,,2020,6.3,12615,13469,854
51053,VA,Dinwiddie,,2021,4.5,12617,13210,593
51057,VA,Essex,,2007,4,5279,5497,218
51057,VA,Essex,,2008,5.6,5333,5649,316
51057,VA,Essex,,2009,8.2,5366,5848,482
51057,VA,Essex,,2010,9.3,5194,5727,533
51057,VA,Essex,,2011,8.3,5219,5690,471
51057,VA,Essex,,2012,7.2,5320,5733,413
51057,VA,Essex,,2013,6.5,5316,5686,370
51057,VA,Essex,,2014,6.2,5344,5700,356
51057,VA,Essex,,2015,5.3,5238,5531,293
51057,VA,Essex,,2016,4.7,5267,5529,262
51057,VA,Essex,,2017,4.8,5374,5643,269
51057,VA,Essex,,2018,3.8,5350,5560,210
51057,VA,Essex,,2019,3.5,5379,5575,196
51057,VA,Essex,,2020,6.9,5109,5488,379
51057,VA,Essex,,2021,4.8,5028,5284,256
51059,VA,Fairfax,,2007,2.4,567649,581325,13676
51059,VA,Fairfax,,2008,3.1,573490,591663,18173
51059,VA,Fairfax,,2009,4.9,561229,589897,28668
51059,VA,Fairfax,,2010,5.2,579209,611055,31846
51059,VA,Fairfax,,2011,4.7,589888,619259,29371
51059,VA,Fairfax,,2012,4.4,595562,623114,27552
51059,VA,Fairfax,,2013,4.3,597713,624643,26930
51059,VA,Fairfax,,2014,4.1,596624,622116,25492
51059,VA,Fairfax,,2015,3.5,594499,616185,21686
51059,VA,Fairfax,,2016,3.2,598093,617693,19600
51059,VA,Fairfax,,2017,3,610106,629074,18968
51059,VA,Fairfax,,2018,2.4,617899,633295,15396
51059,VA,Fairfax,,2019,2.3,628443,643065,14622
51059,VA,Fairfax,,2020,5.8,591622,627997,36375
51059,VA,Fairfax,,2021,3.5,593574,614999,21425
51061,VA,Fauquier,,2007,2.7,35937,36937,1000
51061,VA,Fauquier,,2008,3.6,36403,37765,1362
51061,VA,Fauquier,,2009,5.6,35459,37560,2101
51061,VA,Fauquier,,2010,6.3,33536,35805,2269
51061,VA,Fauquier,,2011,5.5,34092,36073,1981
51061,VA,Fauquier,,2012,5,34162,35975,1813
51061,VA,Fauquier,,2013,4.8,34198,35928,1730
51061,VA,Fauquier,,2014,4.5,34427,36049,1622
51061,VA,Fauquier,,2015,3.9,34477,35873,1396
51061,VA,Fauquier,,2016,3.4,34745,35977,1232
51061,VA,Fauquier,,2017,3.2,35091,36269,1178
51061,VA,Fauquier,,2018,2.6,36096,37054,958
51061,VA,Fauquier,,2019,2.4,37168,38085,917
51061,VA,Fauquier,,2020,4.7,35058,36777,1719
51061,VA,Fauquier,,2021,3,35138,36217,1079
51063,VA,Floyd,,2007,3.8,6846,7114,268
51063,VA,Floyd,,2008,4.8,6816,7156,340
51063,VA,Floyd,,2009,7.8,6795,7370,575
51063,VA,Floyd,,2010,7.1,7563,8143,580
51063,VA,Floyd,,2011,6.3,7796,8321,525
51063,VA,Floyd,,2012,5.6,7901,8366,465
51063,VA,Floyd,,2013,5.3,7946,8389,443
51063,VA,Floyd,,2014,4.6,7952,8332,380
51063,VA,Floyd,,2015,3.9,7999,8326,327
51063,VA,Floyd,,2016,4,7873,8201,328
51063,VA,Floyd,,2017,3.6,7858,8154,296
51063,VA,Floyd,,2018,2.7,7969,8190,221
51063,VA,Floyd,,2019,2.5,8134,8345,211
51063,VA,Floyd,,2020,5,7735,8144,409
51063,VA,Floyd,,2021,3.1,7903,8157,254
51065,VA,Fluvanna,,2007,2.6,13447,13799,352
51065,VA,Fluvanna,,2008,3.6,13634,14138,504
51065,VA,Fluvanna,,2009,5.9,13227,14050,823
51065,VA,Fluvanna,,2010,6.5,12246,13093,847
51065,VA,Fluvanna,,2011,5.8,12477,13245,768
51065,VA,Fluvanna,,2012,5.1,12483,13160,677
51065,VA,Fluvanna,,2013,4.7,12431,13038,607
51065,VA,Fluvanna,,2014,4.3,12648,13215,567
51065,VA,Fluvanna,,2015,3.7,12724,13214,490
51065,VA,Fluvanna,,2016,3.3,12764,13201,437
51065,VA,Fluvanna,,2017,3,13131,13540,409
51065,VA,Fluvanna,,2018,2.5,13464,13806,342
51065,VA,Fluvanna,,2019,2.3,14116,14444,328
51065,VA,Fluvanna,,2020,5.2,13083,13805,722
51065,VA,Fluvanna,,2021,3.3,13130,13572,442
51067,VA,Franklin,,2007,3.6,25460,26410,950
51067,VA,Franklin,,2008,5.1,25688,27080,1392
51067,VA,Franklin,,2009,8.4,24679,26934,2255
51067,VA,Franklin,,2010,8.9,25204,27664,2460
51067,VA,Franklin,,2011,7.5,25573,27639,2066
51067,VA,Franklin,,2012,6.4,25618,27384,1766
51067,VA,Franklin,,2013,5.8,25648,27216,1568
51067,VA,Franklin,,2014,5.3,25824,27256,1432
51067,VA,Franklin,,2015,4.6,25328,26550,1222
51067,VA,Franklin,,2016,4.2,25288,26402,1114
51067,VA,Franklin,,2017,3.9,25535,26562,1027
51067,VA,Franklin,,2018,3,25638,26443,805
51067,VA,Franklin,,2019,2.9,26013,26789,776
51067,VA,Franklin,,2020,5.4,24731,26146,1415
51067,VA,Franklin,,2021,3.5,24628,25534,906
51069,VA,Frederick,,2007,3.2,39829,41145,1316
51069,VA,Frederick,,2008,4.5,39544,41414,1870
51069,VA,Frederick,,2009,7.7,37925,41089,3164
51069,VA,Frederick,,2010,7.6,38812,42027,3215
51069,VA,Frederick,,2011,6.5,40343,43128,2785
51069,VA,Frederick,,2012,5.7,40959,43416,2457
51069,VA,Frederick,,2013,5.2,41871,44153,2282
51069,VA,Frederick,,2014,4.6,42578,44636,2058
51069,VA,Frederick,,2015,3.9,43043,44796,1753
51069,VA,Frederick,,2016,3.4,43842,45404,1562
51069,VA,Frederick,,2017,3.2,45346,46824,1478
51069,VA,Frederick,,2018,2.6,46597,47832,1235
51069,VA,Frederick,,2019,2.4,48048,49229,1181
51069,VA,Frederick,,2020,4.6,47189,49464,2275
51069,VA,Frederick,,2021,2.9,47598,49021,1423
51071,VA,Giles,,2007,4.9,7763,8159,396
51071,VA,Giles,,2008,5.8,7888,8373,485
51071,VA,Giles,,2009,9.3,7593,8375,782
51071,VA,Giles,,2010,9.8,7504,8317,813
51071,VA,Giles,,2011,7.9,7603,8259,656
51071,VA,Giles,,2012,7.1,7641,8227,586
51071,VA,Giles,,2013,6.8,7656,8217,561
51071,VA,Giles,,2014,6.1,7601,8092,491
51071,VA,Giles,,2015,5.1,7567,7974,407
51071,VA,Giles,,2016,5.3,7530,7950,420
51071,VA,Giles,,2017,4.6,7574,7942,368
51071,VA,Giles,,2018,3.3,7651,7913,262
51071,VA,Giles,,2019,3.2,7755,8013,258
51071,VA,Giles,,2020,6.2,7304,7788,484
51071,VA,Giles,,2021,3.5,7479,7747,268
51073,VA,Gloucester,,2007,2.7,20001,20553,552
51073,VA,Gloucester,,2008,3.8,20244,21033,789
51073,VA,Gloucester,,2009,6.1,19633,20917,1284
51073,VA,Gloucester,,2010,7,18210,19578,1368
51073,VA,Gloucester,,2011,6.3,18298,19521,1223
51073,VA,Gloucester,,2012,5.5,18278,19348,1070
51073,VA,Gloucester,,2013,5.1,18344,19327,983
51073,VA,Gloucester,,2014,4.7,18581,19504,923
51073,VA,Gloucester,,2015,4,18399,19169,770
51073,VA,Gloucester,,2016,3.6,18430,19118,688
51073,VA,Gloucester,,2017,3.3,18899,19539,640
51073,VA,Gloucester,,2018,2.7,19153,19678,525
51073,VA,Gloucester,,2019,2.5,19389,19894,505
51073,VA,Gloucester,,2020,5.4,18257,19302,1045
51073,VA,Gloucester,,2021,3.4,18202,18837,635
51075,VA,Goochland,,2007,2.6,10839,11126,287
51075,VA,Goochland,,2008,3.6,11025,11434,409
51075,VA,Goochland,,2009,6.6,10674,11433,759
51075,VA,Goochland,,2010,7.3,9728,10499,771
51075,VA,Goochland,,2011,6.3,9703,10360,657
51075,VA,Goochland,,2012,5.5,9705,10267,562
51075,VA,Goochland,,2013,5,9854,10376,522
51075,VA,Goochland,,2014,4.7,10080,10577,497
51075,VA,Goochland,,2015,4.1,10220,10659,439
51075,VA,Goochland,,2016,3.7,10443,10845,402
51075,VA,Goochland,,2017,3.5,10548,10927,379
51075,VA,Goochland,,2018,2.9,10905,11236,331
51075,VA,Goochland,,2019,2.7,11266,11581,315
51075,VA,Goochland,,2020,4.8,10880,11426,546
51075,VA,Goochland,,2021,3.1,10887,11232,345
51077,VA,Grayson,,2007,5.5,6745,7139,394
51077,VA,Grayson,,2008,7,6676,7176,500
51077,VA,Grayson,,2009,10.9,6534,7334,800
51077,VA,Grayson,,2010,12.7,6452,7388,936
51077,VA,Grayson,,2011,10.8,6415,7191,776
51077,VA,Grayson,,2012,9.4,6329,6984,655
51077,VA,Grayson,,2013,9.4,6345,7006,661
51077,VA,Grayson,,2014,7.6,6552,7091,539
51077,VA,Grayson,,2015,5.8,6659,7071,412
51077,VA,Grayson,,2016,5,6677,7031,354
51077,VA,Grayson,,2017,3.9,7441,7744,303
51077,VA,Grayson,,2018,3,7511,7744,233
51077,VA,Grayson,,2019,2.8,7941,8173,232
51077,VA,Grayson,,2020,5.7,7563,8022,459
51077,VA,Grayson,,2021,3.3,7580,7841,261
51079,VA,Greene,,2007,2.3,10179,10420,241
51079,VA,Greene,,2008,3.5,10290,10668,378
51079,VA,Greene,,2009,5.9,10161,10799,638
51079,VA,Greene,,2010,6.9,9002,9667,665
51079,VA,Greene,,2011,6,9189,9778,589
51079,VA,Greene,,2012,5.4,9254,9786,532
51079,VA,Greene,,2013,4.7,9234,9690,456
51079,VA,Greene,,2014,4.3,9460,9887,427
51079,VA,Greene,,2015,3.7,9525,9888,363
51079,VA,Greene,,2016,3.2,9626,9946,320
51079,VA,Greene,,2017,3,9932,10240,308
51079,VA,Greene,,2018,2.5,10150,10410,260
51079,VA,Greene,,2019,2.3,10477,10725,248
51079,VA,Greene,,2020,5.2,9824,10361,537
51079,VA,Greene,,2021,3,9861,10165,304
51081,VA,Greensville,,2007,4.9,4087,4296,209
51081,VA,Greensville,,2008,5.9,4128,4389,261
51081,VA,Greensville,,2009,9.1,4018,4422,404
51081,VA,Greensville,,2010,9.8,4122,4569,447
51081,VA,Greensville,,2011,8.7,4173,4572,399
51081,VA,Greensville,,2012,8.5,4082,4459,377
51081,VA,Greensville,,2013,7.6,4025,4354,329
51081,VA,Greensville,,2014,6.3,3987,4257,270
51081,VA,Greensville,,2015,5.3,3966,4188,222
51081,VA,Greensville,,2016,5,4002,4212,210
51081,VA,Greensville,,2017,4.3,4275,4467,192
51081,VA,Greensville,,2018,3.6,4255,4415,160
51081,VA,Greensville,,2019,3.4,4192,4338,146
51081,VA,Greensville,,2020,6.6,3975,4258,283
51081,VA,Greensville,,2021,4.9,4045,4252,207
51083,VA,Halifax,,2007,6.9,14394,15455,1061
51083,VA,Halifax,,2008,7.4,14601,15765,1164
51083,VA,Halifax,,2009,11.5,14709,16621,1912
51083,VA,Halifax,,2010,12.5,14644,16727,2083
51083,VA,Halifax,,2011,10.9,14544,16332,1788
51083,VA,Halifax,,2012,9.3,14525,16016,1491
51083,VA,Halifax,,2013,8.9,14434,15852,1418
51083,VA,Halifax,,2014,7.7,14404,15598,1194
51083,VA,Halifax,,2015,6.3,14299,15255,956
51083,VA,Halifax,,2016,5.7,14026,14880,854
51083,VA,Halifax,,2017,4.8,14933,15693,760
51083,VA,Halifax,,2018,4,14682,15301,619
51083,VA,Halifax,,2019,3.9,15146,15758,612
51083,VA,Halifax,,2020,7,14114,15176,1062
51083,VA,Halifax,,2021,4.8,14091,14798,707
51085,VA,Hanover,,2007,2.7,53285,54745,1460
51085,VA,Hanover,,2008,3.7,53678,55745,2067
51085,VA,Hanover,,2009,6.7,51158,54812,3654
51085,VA,Hanover,,2010,6.7,50830,54500,3670
51085,VA,Hanover,,2011,6,51605,54872,3267
51085,VA,Hanover,,2012,5.4,52100,55076,2976
51085,VA,Hanover,,2013,4.9,52693,55429,2736
51085,VA,Hanover,,2014,4.5,53492,55997,2505
51085,VA,Hanover,,2015,3.8,54307,56465,2158
51085,VA,Hanover,,2016,3.4,55280,57255,1975
51085,VA,Hanover,,2017,3.3,56750,58679,1929
51085,VA,Hanover,,2018,2.6,57837,59372,1535
51085,VA,Hanover,,2019,2.4,58713,60155,1442
51085,VA,Hanover,,2020,4.8,55260,58056,2796
51085,VA,Hanover,,2021,3,55208,56895,1687
51087,VA,Henrico,,2007,3,157824,162685,4861
51087,VA,Henrico,,2008,3.9,159279,165784,6505
51087,VA,Henrico,,2009,7,153471,165056,11585
51087,VA,Henrico,,2010,7.5,155376,167948,12572
51087,VA,Henrico,,2011,6.7,158821,170265,11444
51087,VA,Henrico,,2012,5.9,162124,172338,10214
51087,VA,Henrico,,2013,5.4,164651,174131,9480
51087,VA,Henrico,,2014,5,168004,176852,8848
51087,VA,Henrico,,2015,4.2,170112,177634,7522
51087,VA,Henrico,,2016,3.8,172221,179085,6864
51087,VA,Henrico,,2017,3.6,175322,181903,6581
51087,VA,Henrico,,2018,3,177154,182576,5422
51087,VA,Henrico,,2019,2.8,179699,184822,5123
51087,VA,Henrico,,2020,6.4,169700,181386,11686
51087,VA,Henrico,,2021,4,169543,176593,7050
51089,VA,Henry,,2007,5.9,24289,25820,1531
51089,VA,Henry,,2008,8.6,23254,25452,2198
51089,VA,Henry,,2009,13.9,22154,25744,3590
51089,VA,Henry,,2010,15.1,20457,24091,3634
51089,VA,Henry,,2011,12.6,19921,22781,2860
51089,VA,Henry,,2012,10.4,20347,22698,2351
51089,VA,Henry,,2013,8.9,21311,23392,2081
51089,VA,Henry,,2014,7.5,21257,22989,1732
51089,VA,Henry,,2015,6.3,21019,22437,1418
51089,VA,Henry,,2016,5.5,20946,22165,1219
51089,VA,Henry,,2017,4.6,22876,23979,1103
51089,VA,Henry,,2018,3.7,23027,23903,876
51089,VA,Henry,,2019,3.3,23272,24068,796
51089,VA,Henry,,2020,7.6,21957,23761,1804
51089,VA,Henry,,2021,4.7,22423,23520,1097
51091,VA,Highland,,2007,3.6,1087,1128,41
51091,VA,Highland,,2008,5.5,1080,1143,63
51091,VA,Highland,,2009,7.7,1077,1167,90
51091,VA,Highland,,2010,6.4,1355,1447,92
51091,VA,Highland,,2011,5.6,1376,1457,81
51091,VA,Highland,,2012,4.8,1390,1460,70
51091,VA,Highland,,2013,4.2,1360,1419,59
51091,VA,Highland,,2014,3.8,1371,1425,54
51091,VA,Highland,,2015,3.5,1298,1345,47
51091,VA,Highland,,2016,3.1,1268,1308,40
51091,VA,Highland,,2017,3.2,1263,1305,42
51091,VA,Highland,,2018,2.8,1233,1268,35
51091,VA,Highland,,2019,2.7,1233,1267,34
51091,VA,Highland,,2020,3.7,1187,1233,46
51091,VA,Highland,,2021,2.9,1188,1223,35
51093,VA,Isle of Wight,,2007,3.1,18023,18598,575
51093,VA,Isle of Wight,,2008,4,18315,19071,756
51093,VA,Isle of Wight,,2009,6.3,17720,18920,1200
51093,VA,Isle of Wight,,2010,7.3,17449,18826,1377
51093,VA,Isle of Wight,,2011,6.9,17546,18850,1304
51093,VA,Isle of Wight,,2012,6.2,17575,18738,1163
51093,VA,Isle of Wight,,2013,5.6,17803,18861,1058
51093,VA,Isle of Wight,,2014,5.1,18058,19038,980
51093,VA,Isle of Wight,,2015,4.5,18026,18876,850
51093,VA,Isle of Wight,,2016,4.2,18151,18955,804
51093,VA,Isle of Wight,,2017,3.8,18536,19268,732
51093,VA,Isle of Wight,,2018,2.9,18969,19541,572
51093,VA,Isle of Wight,,2019,2.8,19287,19834,547
51093,VA,Isle of Wight,,2020,5,18417,19391,974
51093,VA,Isle of Wight,,2021,3.5,18366,19026,660
51095,VA,James City,,2007,2.7,30513,31349,836
51095,VA,James City,,2008,3.4,31247,32356,1109
51095,VA,James City,,2009,5.5,30533,32303,1770
51095,VA,James City,,2010,6.5,30190,32282,2092
51095,VA,James City,,2011,6.1,30577,32554,1977
51095,VA,James City,,2012,5.6,31095,32942,1847
51095,VA,James City,,2013,5.2,31951,33708,1757
51095,VA,James City,,2014,4.8,33060,34735,1675
51095,VA,James City,,2015,4.3,32960,34430,1470
51095,VA,James City,,2016,3.8,33580,34910,1330
51095,VA,James City,,2017,3.5,34977,36236,1259
51095,VA,James City,,2018,2.9,35805,36861,1056
51095,VA,James City,,2019,2.6,36277,37256,979
51095,VA,James City,,2020,6.9,34511,37050,2539
51095,VA,James City,,2021,4,34422,35844,1422
51097,VA,King and Queen,,2007,3.8,3208,3334,126
51097,VA,King and Queen,,2008,4.9,3182,3347,165
51097,VA,King and Queen,,2009,8.2,3010,3278,268
51097,VA,King and Queen,,2010,8.2,3301,3597,296
51097,VA,King and Queen,,2011,7.3,3389,3657,268
51097,VA,King and Queen,,2012,6.5,3430,3668,238
51097,VA,King and Queen,,2013,6,3422,3639,217
51097,VA,King and Queen,,2014,5.7,3449,3656,207
51097,VA,King and Queen,,2015,4.7,3472,3645,173
51097,VA,King and Queen,,2016,4.1,3515,3665,150
51097,VA,King and Queen,,2017,3.4,3703,3835,132
51097,VA,King and Queen,,2018,3,3772,3889,117
51097,VA,King and Queen,,2019,2.8,3809,3917,108
51097,VA,King and Queen,,2020,5.1,3682,3878,196
51097,VA,King and Queen,,2021,3.1,3692,3812,120
51099,VA,King George,,2007,3.8,9006,9362,356
51099,VA,King George,,2008,5.5,9120,9649,529
51099,VA,King George,,2009,7.7,9503,10299,796
51099,VA,King George,,2010,7.5,10568,11429,861
51099,VA,King George,,2011,7,10890,11704,814
51099,VA,King George,,2012,6.4,10971,11715,744
51099,VA,King George,,2013,5.7,11301,11979,678
51099,VA,King George,,2014,5.3,11482,12123,641
51099,VA,King George,,2015,4.7,11533,12101,568
51099,VA,King George,,2016,4.2,11817,12336,519
51099,VA,King George,,2017,3.7,12575,13059,484
51099,VA,King George,,2018,2.9,12937,13327,390
51099,VA,King George,,2019,2.6,13275,13635,360
51099,VA,King George,,2020,4.5,13263,13882,619
51099,VA,King George,,2021,2.9,13496,13898,402
51101,VA,King William,,2007,2.9,8217,8465,248
51101,VA,King William,,2008,4,8397,8750,353
51101,VA,King William,,2009,7.2,8078,8701,623
51101,VA,King William,,2010,7.6,8007,8669,662
51101,VA,King William,,2011,6.9,8093,8689,596
51101,VA,King William,,2012,6.2,8135,8673,538
51101,VA,King William,,2013,5.5,8222,8701,479
51101,VA,King William,,2014,5.1,8338,8783,445
51101,VA,King William,,2015,4.2,8375,8739,364
51101,VA,King William,,2016,3.7,8435,8762,327
51101,VA,King William,,2017,3.4,8707,9014,307
51101,VA,King William,,2018,2.9,8905,9172,267
51101,VA,King William,,2019,2.7,9114,9365,251
51101,VA,King William,,2020,5.3,8804,9297,493
51101,VA,King William,,2021,3.3,8809,9114,305
51103,VA,Lancaster,,2007,4.7,5076,5328,252
51103,VA,Lancaster,,2008,6.2,5202,5543,341
51103,VA,Lancaster,,2009,9.5,5145,5682,537
51103,VA,Lancaster,,2010,10,5021,5579,558
51103,VA,Lancaster,,2011,9.2,5065,5581,516
51103,VA,Lancaster,,2012,7.8,5081,5512,431
51103,VA,Lancaster,,2013,7.3,5003,5399,396
51103,VA,Lancaster,,2014,7.5,4961,5364,403
51103,VA,Lancaster,,2015,6.5,4813,5147,334
51103,VA,Lancaster,,2016,5.5,4832,5115,283
51103,VA,Lancaster,,2017,5.2,5105,5384,279
51103,VA,Lancaster,,2018,4.3,5113,5344,231
51103,VA,Lancaster,,2019,4.3,5237,5471,234
51103,VA,Lancaster,,2020,7.3,4971,5360,389
51103,VA,Lancaster,,2021,5.3,4964,5244,280
51105,VA,Lee,,2007,4.5,9168,9600,432
51105,VA,Lee,,2008,5.7,9227,9788,561
51105,VA,Lee,,2009,7.4,9421,10171,750
51105,VA,Lee,,2010,8.1,9320,10143,823
51105,VA,Lee,,2011,7.6,9439,10214,775
51105,VA,Lee,,2012,8.1,8983,9774,791
51105,VA,Lee,,2013,8.6,8502,9298,796
51105,VA,Lee,,2014,8,8153,8864,711
51105,VA,Lee,,2015,7.1,7989,8601,612
51105,VA,Lee,,2016,6.7,7886,8451,565
51105,VA,Lee,,2017,5.1,8186,8628,442
51105,VA,Lee,,2018,4.1,8047,8388,341
51105,VA,Lee,,2019,4,8073,8409,336
51105,VA,Lee,,2020,6.4,7772,8301,529
51105,VA,Lee,,2021,4,7705,8030,325
51107,VA,Loudoun,,2007,2.3,160226,163946,3720
51107,VA,Loudoun,,2008,3,167549,172780,5231
51107,VA,Loudoun,,2009,4.8,166583,174974,8391
51107,VA,Loudoun,,2010,5.2,166403,175593,9190
51107,VA,Loudoun,,2011,4.7,172808,181241,8433
51107,VA,Loudoun,,2012,4.4,177761,185858,8097
51107,VA,Loudoun,,2013,4.3,182994,191165,8171
51107,VA,Loudoun,,2014,4.2,188499,196697,8198
51107,VA,Loudoun,,2015,3.5,193830,200891,7061
51107,VA,Loudoun,,2016,3.1,201078,207602,6524
51107,VA,Loudoun,,2017,3,209681,216176,6495
51107,VA,Loudoun,,2018,2.5,216382,221826,5444
51107,VA,Loudoun,,2019,2.3,224380,229631,5251
51107,VA,Loudoun,,2020,5.3,215250,227250,12000
51107,VA,Loudoun,,2021,3.1,215775,222649,6874
51109,VA,Louisa,,2007,3.1,15653,16160,507
51109,VA,Louisa,,2008,4.5,16017,16777,760
51109,VA,Louisa,,2009,8,15401,16743,1342
51109,VA,Louisa,,2010,7.7,16505,17879,1374
51109,VA,Louisa,,2011,6.8,16695,17913,1218
51109,VA,Louisa,,2012,6.1,16842,17936,1094
51109,VA,Louisa,,2013,5.5,17057,18056,999
51109,VA,Louisa,,2014,5,17591,18513,922
51109,VA,Louisa,,2015,4.2,18078,18866,788
51109,VA,Louisa,,2016,3.8,17895,18595,700
51109,VA,Louisa,,2017,3.4,19098,19765,667
51109,VA,Louisa,,2018,2.8,19408,19958,550
51109,VA,Louisa,,2019,2.6,19810,20349,539
51109,VA,Louisa,,2020,5.2,18973,20011,1038
51109,VA,Louisa,,2021,3.4,19239,19910,671
51111,VA,Lunenburg,,2007,4.9,5248,5518,270
51111,VA,Lunenburg,,2008,6.4,5152,5504,352
51111,VA,Lunenburg,,2009,9.5,5109,5643,534
51111,VA,Lunenburg,,2010,9.7,5018,5558,540
51111,VA,Lunenburg,,2011,8.5,5032,5500,468
51111,VA,Lunenburg,,2012,7.4,4977,5375,398
51111,VA,Lunenburg,,2013,6.9,4958,5325,367
51111,VA,Lunenburg,,2014,5.8,5048,5358,310
51111,VA,Lunenburg,,2015,5,5038,5305,267
51111,VA,Lunenburg,,2016,4.5,5021,5260,239
51111,VA,Lunenburg,,2017,4.1,5182,5404,222
51111,VA,Lunenburg,,2018,3.2,5201,5372,171
51111,VA,Lunenburg,,2019,3.1,5219,5387,168
51111,VA,Lunenburg,,2020,5.2,4979,5254,275
51111,VA,Lunenburg,,2021,3.8,4852,5044,192
51113,VA,Madison,,2007,2.9,7142,7355,213
51113,VA,Madison,,2008,4,7095,7394,299
51113,VA,Madison,,2009,6.3,6993,7461,468
51113,VA,Madison,,2010,6.5,6714,7178,464
51113,VA,Madison,,2011,5.2,6834,7211,377
51113,VA,Madison,,2012,4.7,6911,7252,341
51113,VA,Madison,,2013,4.4,6914,7229,315
51113,VA,Madison,,2014,4,6984,7272,288
51113,VA,Madison,,2015,3.4,7011,7255,244
51113,VA,Madison,,2016,3.1,6962,7183,221
51113,VA,Madison,,2017,2.9,7120,7333,213
51113,VA,Madison,,2018,2.4,7168,7346,178
51113,VA,Madison,,2019,2.2,7368,7533,165
51113,VA,Madison,,2020,3.8,7058,7336,278
51113,VA,Madison,,2021,2.5,7148,7329,181
51115,VA,Mathews,,2007,2.8,4306,4428,122
51115,VA,Mathews,,2008,3.9,4320,4493,173
51115,VA,Mathews,,2009,5.6,4108,4353,245
51115,VA,Mathews,,2010,6.5,3954,4229,275
51115,VA,Mathews,,2011,6.5,3962,4238,276
51115,VA,Mathews,,2012,5.6,3937,4170,233
51115,VA,Mathews,,2013,4.9,3959,4165,206
51115,VA,Mathews,,2014,4.5,3951,4139,188
51115,VA,Mathews,,2015,4.2,3920,4090,170
51115,VA,Mathews,,2016,4,3885,4045,160
51115,VA,Mathews,,2017,3.7,3980,4132,152
51115,VA,Mathews,,2018,3,4040,4164,124
51115,VA,Mathews,,2019,2.8,4103,4223,120
51115,VA,Mathews,,2020,4.9,3821,4019,198
51115,VA,Mathews,,2021,3.2,3811,3936,125
51117,VA,Mecklenburg,,2007,5.5,12501,13222,721
51117,VA,Mecklenburg,,2008,7,12528,13478,950
51117,VA,Mecklenburg,,2009,11.1,12569,14142,1573
51117,VA,Mecklenburg,,2010,11.5,12546,14183,1637
51117,VA,Mecklenburg,,2011,10.3,12582,14031,1449
51117,VA,Mecklenburg,,2012,9.2,12260,13508,1248
51117,VA,Mecklenburg,,2013,9.1,11608,12771,1163
51117,VA,Mecklenburg,,2014,7.6,11705,12663,958
51117,VA,Mecklenburg,,2015,6,11803,12561,758
51117,VA,Mecklenburg,,2016,5.5,11783,12473,690
51117,VA,Mecklenburg,,2017,4.8,12236,12859,623
51117,VA,Mecklenburg,,2018,4,12277,12792,515
51117,VA,Mecklenburg,,2019,4,12327,12834,507
51117,VA,Mecklenburg,,2020,6.8,11818,12674,856
51117,VA,Mecklenburg,,2021,4.7,11842,12429,587
51119,VA,Middlesex,,2007,3.3,4881,5045,164
51119,VA,Middlesex,,2008,4.1,4914,5126,212
51119,VA,Middlesex,,2009,6.8,4854,5208,354
51119,VA,Middlesex,,2010,7.4,4787,5167,380
51119,VA,Middlesex,,2011,6.5,4799,5131,332
51119,VA,Middlesex,,2012,5.9,4823,5128,305
51119,VA,Middlesex,,2013,5.4,4839,5115,276
51119,VA,Middlesex,,2014,5,4795,5045,250
51119,VA,Middlesex,,2015,4.2,4791,5000,209
51119,VA,Middlesex,,2016,3.8,4845,5035,190
51119,VA,Middlesex,,2017,3.2,5194,5367,173
51119,VA,Middlesex,,2018,2.7,5142,5283,141
51119,VA,Middlesex,,2019,2.5,5194,5329,135
51119,VA,Middlesex,,2020,5.1,4893,5154,261
51119,VA,Middlesex,,2021,3.4,4914,5085,171
51121,VA,Montgomery,,2007,3.5,42791,44326,1535
51121,VA,Montgomery,,2008,4.4,43811,45828,2017
51121,VA,Montgomery,,2009,7.1,42404,45648,3244
51121,VA,Montgomery,,2010,7.2,44117,47555,3438
51121,VA,Montgomery,,2011,6.3,45247,48292,3045
51121,VA,Montgomery,,2012,5.8,46231,49090,2859
51121,VA,Montgomery,,2013,5.5,46938,49678,2740
51121,VA,Montgomery,,2014,5,47448,49948,2500
51121,VA,Montgomery,,2015,4.3,47798,49925,2127
51121,VA,Montgomery,,2016,4.1,47769,49796,2027
51121,VA,Montgomery,,2017,3.7,48280,50146,1866
51121,VA,Montgomery,,2018,2.9,48891,50359,1468
51121,VA,Montgomery,,2019,2.8,49650,51066,1416
51121,VA,Montgomery,,2020,4.7,46761,49092,2331
51121,VA,Montgomery,,2021,3,47901,49360,1459
51125,VA,Nelson,,2007,2.9,7678,7908,230
51125,VA,Nelson,,2008,3.9,7753,8065,312
51125,VA,Nelson,,2009,6.5,7547,8074,527
51125,VA,Nelson,,2010,7.3,7031,7586,555
51125,VA,Nelson,,2011,6.3,7113,7593,480
51125,VA,Nelson,,2012,5.7,7028,7453,425
51125,VA,Nelson,,2013,5.4,6963,7359,396
51125,VA,Nelson,,2014,4.8,7060,7418,358
51125,VA,Nelson,,2015,4,7003,7296,293
51125,VA,Nelson,,2016,3.5,6989,7246,257
51125,VA,Nelson,,2017,3.5,7100,7355,255
51125,VA,Nelson,,2018,3.1,7165,7392,227
51125,VA,Nelson,,2019,2.7,7434,7642,208
51125,VA,Nelson,,2020,5.6,6822,7229,407
51125,VA,Nelson,,2021,3.5,6857,7106,249
51127,VA,New Kent,,2007,2.9,9142,9418,276
51127,VA,New Kent,,2008,3.9,9529,9912,383
51127,VA,New Kent,,2009,7.1,9213,9918,705
51127,VA,New Kent,,2010,7.4,9546,10310,764
51127,VA,New Kent,,2011,6.4,9757,10423,666
51127,VA,New Kent,,2012,5.5,10021,10600,579
51127,VA,New Kent,,2013,4.9,10257,10788,531
51127,VA,New Kent,,2014,4.4,10623,11116,493
51127,VA,New Kent,,2015,3.8,10835,11258,423
51127,VA,New Kent,,2016,3.3,11300,11690,390
51127,VA,New Kent,,2017,3.2,11714,12095,381
51127,VA,New Kent,,2018,2.7,12185,12521,336
51127,VA,New Kent,,2019,2.3,12696,13000,304
51127,VA,New Kent,,2020,4.5,12190,12767,577
51127,VA,New Kent,,2021,3,12184,12555,371
51131,VA,Northampton,,2007,4.4,5707,5969,262
51131,VA,Northampton,,2008,5.9,5755,6113,358
51131,VA,Northampton,,2009,7.8,5910,6411,501
51131,VA,Northampton,,2010,8.7,5796,6346,550
51131,VA,Northampton,,2011,8.9,5791,6354,563
51131,VA,Northampton,,2012,9.1,5623,6184,561
51131,VA,Northampton,,2013,8.9,5494,6031,537
51131,VA,Northampton,,2014,7.4,5648,6101,453
51131,VA,Northampton,,2015,6,5752,6120,368
51131,VA,Northampton,,2016,5.7,5546,5881,335
51131,VA,Northampton,,2017,5.6,5258,5568,310
51131,VA,Northampton,,2018,5.4,5145,5436,291
51131,VA,Northampton,,2019,4.4,5270,5513,243
51131,VA,Northampton,,2020,7.8,4998,5418,420
51131,VA,Northampton,,2021,5.4,5071,5359,288
51133,VA,Northumberland,,2007,4.7,5678,5958,280
51133,VA,Northumberland,,2008,6.2,5549,5913,364
51133,VA,Northumberland,,2009,8.9,5599,6144,545
51133,VA,Northumberland,,2010,8.9,5614,6161,547
51133,VA,Northumberland,,2011,9,5482,6022,540
51133,VA,Northumberland,,2012,8,5411,5882,471
51133,VA,Northumberland,,2013,7.2,5278,5689,411
51133,VA,Northumberland,,2014,6.9,5265,5657,392
51133,VA,Northumberland,,2015,6,5154,5483,329
51133,VA,Northumberland,,2016,5.4,5161,5454,293
51133,VA,Northumberland,,2017,5.2,5322,5612,290
51133,VA,Northumberland,,2018,4.4,5349,5595,246
51133,VA,Northumberland,,2019,4.3,5495,5740,245
51133,VA,Northumberland,,2020,6.3,5304,5663,359
51133,VA,Northumberland,,2021,4.9,5236,5503,267
51135,VA,Nottoway,,2007,4.2,6310,6586,276
51135,VA,Nottoway,,2008,5.9,6200,6589,389
51135,VA,Nottoway,,2009,8.2,6124,6670,546
51135,VA,Nottoway,,2010,7.8,6335,6869,534
51135,VA,Nottoway,,2011,7.1,6391,6882,491
51135,VA,Nottoway,,2012,6.2,6440,6869,429
51135,VA,Nottoway,,2013,5.9,6656,7073,417
51135,VA,Nottoway,,2014,5.2,6730,7102,372
51135,VA,Nottoway,,2015,4.5,6838,7158,320
51135,VA,Nottoway,,2016,3.9,6768,7044,276
51135,VA,Nottoway,,2017,3.8,6920,7192,272
51135,VA,Nottoway,,2018,3,7061,7283,222
51135,VA,Nottoway,,2019,2.7,7170,7371,201
51135,VA,Nottoway,,2020,5,6841,7204,363
51135,VA,Nottoway,,2021,3.7,6772,7029,257
51137,VA,Orange,,2007,3.5,14874,15408,534
51137,VA,Orange,,2008,4.9,14893,15667,774
51137,VA,Orange,,2009,7.9,14655,15909,1254
51137,VA,Orange,,2010,8.4,14171,15478,1307
51137,VA,Orange,,2011,7.5,14587,15762,1175
51137,VA,Orange,,2012,6.5,14814,15852,1038
51137,VA,Orange,,2013,5.8,15187,16118,931
51137,VA,Orange,,2014,5.2,15393,16237,844
51137,VA,Orange,,2015,4.5,15388,16118,730
51137,VA,Orange,,2016,4,15730,16386,656
51137,VA,Orange,,2017,3.7,16380,17015,635
51137,VA,Orange,,2018,3,16670,17184,514
51137,VA,Orange,,2019,3,17069,17591,522
51137,VA,Orange,,2020,5.6,16186,17148,962
51137,VA,Orange,,2021,3.6,16376,16992,616
51139,VA,Page,,2007,5.5,10735,11356,621
51139,VA,Page,,2008,7.4,10920,11793,873
51139,VA,Page,,2009,12,10681,12136,1455
51139,VA,Page,,2010,11.9,10894,12360,1466
51139,VA,Page,,2011,11,11091,12466,1375
51139,VA,Page,,2012,10,10955,12172,1217
51139,VA,Page,,2013,9,10860,11934,1074
51139,VA,Page,,2014,7.9,10925,11863,938
51139,VA,Page,,2015,6.8,10891,11684,793
51139,VA,Page,,2016,5.5,10971,11606,635
51139,VA,Page,,2017,5.1,11373,11981,608
51139,VA,Page,,2018,4.1,11512,12009,497
51139,VA,Page,,2019,3.8,11726,12190,464
51139,VA,Page,,2020,7.3,11143,12022,879
51139,VA,Page,,2021,4.6,11344,11897,553
51141,VA,Patrick,,2007,4.4,8665,9062,397
51141,VA,Patrick,,2008,7,8511,9148,637
51141,VA,Patrick,,2009,11.3,8244,9299,1055
51141,VA,Patrick,,2010,13,7262,8346,1084
51141,VA,Patrick,,2011,10.8,7169,8036,867
51141,VA,Patrick,,2012,8.9,7255,7968,713
51141,VA,Patrick,,2013,8.1,7166,7798,632
51141,VA,Patrick,,2014,6.6,7239,7747,508
51141,VA,Patrick,,2015,5.3,7258,7667,409
51141,VA,Patrick,,2016,4.8,7582,7962,380
51141,VA,Patrick,,2017,4.2,7436,7762,326
51141,VA,Patrick,,2018,3.8,7221,7508,287
51141,VA,Patrick,,2019,3.4,7209,7464,255
51141,VA,Patrick,,2020,6.8,6743,7236,493
51141,VA,Patrick,,2021,4.5,6701,7016,315
51143,VA,Pittsylvania,,2007,6.2,29128,31042,1914
51143,VA,Pittsylvania,,2008,7.2,29473,31744,2271
51143,VA,Pittsylvania,,2009,10.8,28511,31966,3455
51143,VA,Pittsylvania,,2010,11.1,27529,30963,3434
51143,VA,Pittsylvania,,2011,9.1,28290,31113,2823
51143,VA,Pittsylvania,,2012,7.6,28344,30684,2340
51143,VA,Pittsylvania,,2013,6.9,28347,30437,2090
51143,VA,Pittsylvania,,2014,6.2,28461,30353,1892
51143,VA,Pittsylvania,,2015,5.2,28606,30185,1579
51143,VA,Pittsylvania,,2016,4.7,28343,29732,1389
51143,VA,Pittsylvania,,2017,4.2,29632,30945,1313
51143,VA,Pittsylvania,,2018,3.5,29709,30789,1080
51143,VA,Pittsylvania,,2019,3.3,29440,30447,1007
51143,VA,Pittsylvania,,2020,6.4,28049,29972,1923
51143,VA,Pittsylvania,,2021,4,28119,29293,1174
51145,VA,Powhatan,,2007,2.5,13924,14288,364
51145,VA,Powhatan,,2008,3.6,14021,14548,527
51145,VA,Powhatan,,2009,6.4,13310,14225,915
51145,VA,Powhatan,,2010,7.2,12550,13529,979
51145,VA,Powhatan,,2011,6.2,12691,13533,842
51145,VA,Powhatan,,2012,5.5,12791,13540,749
51145,VA,Powhatan,,2013,5,12894,13567,673
51145,VA,Powhatan,,2014,4.4,13101,13711,610
51145,VA,Powhatan,,2015,3.9,12915,13442,527
51145,VA,Powhatan,,2016,3.5,13180,13656,476
51145,VA,Powhatan,,2017,3.3,13408,13863,455
51145,VA,Powhatan,,2018,2.6,13792,14167,375
51145,VA,Powhatan,,2019,2.5,14153,14517,364
51145,VA,Powhatan,,2020,4.8,13491,14172,681
51145,VA,Powhatan,,2021,2.9,13492,13893,401
51147,VA,Prince Edward,,2007,5,8620,9070,450
51147,VA,Prince Edward,,2008,5.9,9075,9648,573
51147,VA,Prince Edward,,2009,9.1,9130,10041,911
51147,VA,Prince Edward,,2010,9.9,9280,10298,1018
51147,VA,Prince Edward,,2011,9,9437,10368,931
51147,VA,Prince Edward,,2012,8.3,9408,10263,855
51147,VA,Prince Edward,,2013,8.2,9166,9985,819
51147,VA,Prince Edward,,2014,7.5,9300,10055,755
51147,VA,Prince Edward,,2015,6.2,9473,10096,623
51147,VA,Prince Edward,,2016,5.3,9632,10166,534
51147,VA,Prince Edward,,2017,4.8,9841,10336,495
51147,VA,Prince Edward,,2018,3.8,10105,10503,398
51147,VA,Prince Edward,,2019,3.7,10167,10559,392
51147,VA,Prince Edward,,2020,6.4,9494,10144,650
51147,VA,Prince Edward,,2021,4.8,9498,9976,478
51149,VA,Prince George,,2007,3.5,14192,14704,512
51149,VA,Prince George,,2008,4.6,14282,14971,689
51149,VA,Prince George,,2009,7.1,14048,15118,1070
51149,VA,Prince George,,2010,8.2,12832,13985,1153
51149,VA,Prince George,,2011,7.8,13378,14507,1129
51149,VA,Prince George,,2012,7.3,13574,14638,1064
51149,VA,Prince George,,2013,6.8,13733,14740,1007
51149,VA,Prince George,,2014,6.2,13894,14812,918
51149,VA,Prince George,,2015,5.3,14133,14928,795
51149,VA,Prince George,,2016,4.8,14234,14949,715
51149,VA,Prince George,,2017,4.4,14398,15063,665
51149,VA,Prince George,,2018,3.6,14590,15134,544
51149,VA,Prince George,,2019,3.3,14840,15349,509
51149,VA,Prince George,,2020,6.4,14016,14981,965
51149,VA,Prince George,,2021,4.5,13998,14660,662
51153,VA,Prince William,,2007,2.7,194996,200343,5347
51153,VA,Prince William,,2008,3.6,198411,205732,7321
51153,VA,Prince William,,2009,5.6,197618,209271,11653
51153,VA,Prince William,,2010,6.2,204995,218644,13649
51153,VA,Prince William,,2011,5.6,212158,224848,12690
51153,VA,Prince William,,2012,5.2,216702,228525,11823
51153,VA,Prince William,,2013,5.1,219435,231198,11763
51153,VA,Prince William,,2014,4.8,221468,232639,11171
51153,VA,Prince William,,2015,4.1,222831,232296,9465
51153,VA,Prince William,,2016,3.6,226848,235285,8437
51153,VA,Prince William,,2017,3.4,233452,241599,8147
51153,VA,Prince William,,2018,2.7,238264,244923,6659
51153,VA,Prince William,,2019,2.5,244236,250537,6301
51153,VA,Prince William,,2020,6.5,231644,247678,16034
51153,VA,Prince William,,2021,4,232243,241803,9560
51155,VA,Pulaski,,2007,5.9,16698,17753,1055
51155,VA,Pulaski,,2008,6.9,16911,18161,1250
51155,VA,Pulaski,,2009,11.1,16192,18218,2026
51155,VA,Pulaski,,2010,11.3,15083,17011,1928
51155,VA,Pulaski,,2011,8.7,15392,16855,1463
51155,VA,Pulaski,,2012,7.3,15628,16857,1229
51155,VA,Pulaski,,2013,7.4,15605,16853,1248
51155,VA,Pulaski,,2014,6,15523,16511,988
51155,VA,Pulaski,,2015,5,15556,16373,817
51155,VA,Pulaski,,2016,5.9,15331,16285,954
51155,VA,Pulaski,,2017,5.3,15492,16355,863
51155,VA,Pulaski,,2018,3.4,15579,16131,552
51155,VA,Pulaski,,2019,3.4,15874,16425,551
51155,VA,Pulaski,,2020,7.8,14938,16208,1270
51155,VA,Pulaski,,2021,4,15308,15938,630
51157,VA,Rappahannock,,2007,2.7,4198,4315,117
51157,VA,Rappahannock,,2008,3.8,4113,4274,161
51157,VA,Rappahannock,,2009,5.9,3994,4246,252
51157,VA,Rappahannock,,2010,6.5,3769,4030,261
51157,VA,Rappahannock,,2011,5.6,3773,3997,224
51157,VA,Rappahannock,,2012,5.3,3748,3958,210
51157,VA,Rappahannock,,2013,5,3722,3918,196
51157,VA,Rappahannock,,2014,4.7,3632,3811,179
51157,VA,Rappahannock,,2015,4.1,3596,3749,153
51157,VA,Rappahannock,,2016,3.5,3588,3717,129
51157,VA,Rappahannock,,2017,3.5,3554,3682,128
51157,VA,Rappahannock,,2018,2.7,3576,3676,100
51157,VA,Rappahannock,,2019,2.5,3716,3811,95
51157,VA,Rappahannock,,2020,4.6,3461,3626,165
51157,VA,Rappahannock,,2021,2.9,3480,3584,104
51159,VA,Richmond,,2007,4.7,3342,3506,164
51159,VA,Richmond,,2008,5.4,3669,3879,210
51159,VA,Richmond,,2009,7.9,3784,4108,324
51159,VA,Richmond,,2010,7.2,4056,4371,315
51159,VA,Richmond,,2011,6.6,3977,4259,282
51159,VA,Richmond,,2012,6.3,3674,3920,246
51159,VA,Richmond,,2013,6,3702,3940,238
51159,VA,Richmond,,2014,5.3,3773,3986,213
51159,VA,Richmond,,2015,4.5,3739,3915,176
51159,VA,Richmond,,2016,3.6,3771,3913,142
51159,VA,Richmond,,2017,3.6,3936,4083,147
51159,VA,Richmond,,2018,3.1,3965,4091,126
51159,VA,Richmond,,2019,2.9,3997,4118,121
51159,VA,Richmond,,2020,4.9,3844,4040,196
51159,VA,Richmond,,2021,3.5,3767,3904,137
51161,VA,Roanoke,,2007,2.7,47652,48986,1334
51161,VA,Roanoke,,2008,3.4,47992,49704,1712
51161,VA,Roanoke,,2009,6,45783,48708,2925
51161,VA,Roanoke,,2010,6.5,46114,49317,3203
51161,VA,Roanoke,,2011,5.7,46833,49648,2815
51161,VA,Roanoke,,2012,5.1,46965,49504,2539
51161,VA,Roanoke,,2013,4.9,47408,49848,2440
51161,VA,Roanoke,,2014,4.5,47911,50161,2250
51161,VA,Roanoke,,2015,3.9,47365,49273,1908
51161,VA,Roanoke,,2016,3.5,47475,49206,1731
51161,VA,Roanoke,,2017,3.4,47703,49368,1665
51161,VA,Roanoke,,2018,2.7,48227,49560,1333
51161,VA,Roanoke,,2019,2.5,49061,50320,1259
51161,VA,Roanoke,,2020,5.1,46600,49086,2486
51161,VA,Roanoke,,2021,3.1,46394,47898,1504
51163,VA,Rockbridge,,2007,3.2,10891,11246,355
51163,VA,Rockbridge,,2008,4.4,10980,11491,511
51163,VA,Rockbridge,,2009,6.6,10948,11720,772
51163,VA,Rockbridge,,2010,7.7,10297,11158,861
51163,VA,Rockbridge,,2011,6.8,10249,10993,744
51163,VA,Rockbridge,,2012,6,10110,10752,642
51163,VA,Rockbridge,,2013,5.7,9828,10419,591
51163,VA,Rockbridge,,2014,5.2,9794,10334,540
51163,VA,Rockbridge,,2015,4.6,9882,10363,481
51163,VA,Rockbridge,,2016,4.3,10024,10475,451
51163,VA,Rockbridge,,2017,4.1,10235,10672,437
51163,VA,Rockbridge,,2018,3,10357,10674,317
51163,VA,Rockbridge,,2019,2.7,10646,10940,294
51163,VA,Rockbridge,,2020,5.5,9866,10438,572
51163,VA,Rockbridge,,2021,3.7,9998,10381,383
51165,VA,Rockingham,,2007,2.7,40419,41537,1118
51165,VA,Rockingham,,2008,3.6,40674,42199,1525
51165,VA,Rockingham,,2009,6,39370,41878,2508
51165,VA,Rockingham,,2010,6.9,37637,40427,2790
51165,VA,Rockingham,,2011,6,38769,41252,2483
51165,VA,Rockingham,,2012,5.6,38549,40816,2267
51165,VA,Rockingham,,2013,5,38627,40640,2013
51165,VA,Rockingham,,2014,4.6,38662,40524,1862
51165,VA,Rockingham,,2015,4.1,38639,40273,1634
51165,VA,Rockingham,,2016,3.5,39212,40616,1404
51165,VA,Rockingham,,2017,3.2,39664,40983,1319
51165,VA,Rockingham,,2018,2.6,40401,41497,1096
51165,VA,Rockingham,,2019,2.3,42064,43074,1010
51165,VA,Rockingham,,2020,4.7,39820,41777,1957
51165,VA,Rockingham,,2021,2.9,40151,41368,1217
51167,VA,Russell,,2007,5.6,11144,11800,656
51167,VA,Russell,,2008,6.2,11144,11882,738
51167,VA,Russell,,2009,10.7,11126,12461,1335
51167,VA,Russell,,2010,10.5,10839,12109,1270
51167,VA,Russell,,2011,9.5,10794,11924,1130
51167,VA,Russell,,2012,8.5,10760,11758,998
51167,VA,Russell,,2013,8.3,10638,11598,960
51167,VA,Russell,,2014,7.7,10434,11308,874
51167,VA,Russell,,2015,6.5,10723,11465,742
51167,VA,Russell,,2016,6.4,10538,11253,715
51167,VA,Russell,,2017,5.2,10948,11543,595
51167,VA,Russell,,2018,4.2,10818,11295,477
51167,VA,Russell,,2019,4.1,10914,11384,470
51167,VA,Russell,,2020,6.6,10453,11193,740
51167,VA,Russell,,2021,4.3,10233,10695,462
51169,VA,Scott,,2007,5,9332,9823,491
51169,VA,Scott,,2008,5.8,9512,10102,590
51169,VA,Scott,,2009,9.8,8944,9911,967
51169,VA,Scott,,2010,8.6,9214,10086,872
51169,VA,Scott,,2011,7.3,9398,10135,737
51169,VA,Scott,,2012,7.4,9324,10069,745
51169,VA,Scott,,2013,6.8,9321,10003,682
51169,VA,Scott,,2014,5.7,9254,9817,563
51169,VA,Scott,,2015,5.1,9052,9537,485
51169,VA,Scott,,2016,4.8,8982,9436,454
51169,VA,Scott,,2017,4,9015,9392,377
51169,VA,Scott,,2018,3.2,8895,9191,296
51169,VA,Scott,,2019,3.1,8937,9221,284
51169,VA,Scott,,2020,5.3,8522,9003,481
51169,VA,Scott,,2021,3.6,8477,8792,315
51171,VA,Shenandoah,,2007,3.4,19335,20024,689
51171,VA,Shenandoah,,2008,5,19260,20278,1018
51171,VA,Shenandoah,,2009,8.4,18628,20327,1699
51171,VA,Shenandoah,,2010,8.4,19108,20865,1757
51171,VA,Shenandoah,,2011,7,19571,21047,1476
51171,VA,Shenandoah,,2012,6.2,19504,20800,1296
51171,VA,Shenandoah,,2013,5.5,19798,20945,1147
51171,VA,Shenandoah,,2014,4.9,20253,21298,1045
51171,VA,Shenandoah,,2015,4.2,20230,21120,890
51171,VA,Shenandoah,,2016,3.7,20084,20856,772
51171,VA,Shenandoah,,2017,3.3,21100,21831,731
51171,VA,Shenandoah,,2018,2.8,21761,22392,631
51171,VA,Shenandoah,,2019,2.5,21987,22553,566
51171,VA,Shenandoah,,2020,5.3,21008,22175,1167
51171,VA,Shenandoah,,2021,3.6,20802,21572,770
51173,VA,Smyth,,2007,5.9,14217,15106,889
51173,VA,Smyth,,2008,6.6,14143,15137,994
51173,VA,Smyth,,2009,11.3,13509,15233,1724
51173,VA,Smyth,,2010,12.4,12040,13740,1700
51173,VA,Smyth,,2011,10.9,12234,13728,1494
51173,VA,Smyth,,2012,9.4,12218,13486,1268
51173,VA,Smyth,,2013,8.9,12210,13397,1187
51173,VA,Smyth,,2014,7.8,12439,13485,1046
51173,VA,Smyth,,2015,6.4,12641,13509,868
51173,VA,Smyth,,2016,5.7,12909,13691,782
51173,VA,Smyth,,2017,4.9,13317,14009,692
51173,VA,Smyth,,2018,3.9,13251,13794,543
51173,VA,Smyth,,2019,3.7,13366,13876,510
51173,VA,Smyth,,2020,6.4,12562,13425,863
51173,VA,Smyth,,2021,4,12977,13524,547
51175,VA,Southampton,,2007,3.9,7383,7681,298
51175,VA,Southampton,,2008,5.2,7688,8109,421
51175,VA,Southampton,,2009,8.1,7471,8132,661
51175,VA,Southampton,,2010,8.8,8675,9510,835
51175,VA,Southampton,,2011,7.7,8704,9426,722
51175,VA,Southampton,,2012,6.2,8896,9479,583
51175,VA,Southampton,,2013,5.5,8739,9244,505
51175,VA,Southampton,,2014,4.8,8716,9156,440
51175,VA,Southampton,,2015,4,8869,9234,365
51175,VA,Southampton,,2016,3.9,8699,9049,350
51175,VA,Southampton,,2017,3.6,8796,9120,324
51175,VA,Southampton,,2018,2.8,8869,9120,251
51175,VA,Southampton,,2019,2.6,9003,9246,243
51175,VA,Southampton,,2020,4.9,8649,9094,445
51175,VA,Southampton,,2021,3.5,8435,8739,304
51177,VA,Spotsylvania,,2007,2.7,62909,64682,1773
51177,VA,Spotsylvania,,2008,3.7,63683,66122,2439
51177,VA,Spotsylvania,,2009,5.7,61441,65184,3743
51177,VA,Spotsylvania,,2010,7.2,58892,63445,4553
51177,VA,Spotsylvania,,2011,6.7,59890,64187,4297
51177,VA,Spotsylvania,,2012,6,60219,64049,3830
51177,VA,Spotsylvania,,2013,5.7,60530,64172,3642
51177,VA,Spotsylvania,,2014,5.3,60922,64336,3414
51177,VA,Spotsylvania,,2015,4.6,61127,64057,2930
51177,VA,Spotsylvania,,2016,4,62413,65027,2614
51177,VA,Spotsylvania,,2017,3.7,63568,66005,2437
51177,VA,Spotsylvania,,2018,3,64787,66813,2026
51177,VA,Spotsylvania,,2019,2.9,67072,69053,1981
51177,VA,Spotsylvania,,2020,5.9,63987,68029,4042
51177,VA,Spotsylvania,,2021,3.8,64156,66679,2523
51179,VA,Stafford,,2007,2.8,62697,64522,1825
51179,VA,Stafford,,2008,3.7,63567,66023,2456
51179,VA,Stafford,,2009,5.6,62102,65781,3679
51179,VA,Stafford,,2010,6.7,59719,63985,4266
51179,VA,Stafford,,2011,6.2,61043,65045,4002
51179,VA,Stafford,,2012,5.7,61712,65422,3710
51179,VA,Stafford,,2013,5.5,62452,66106,3654
51179,VA,Stafford,,2014,5.2,63415,66910,3495
51179,VA,Stafford,,2015,4.4,63975,66918,2943
51179,VA,Stafford,,2016,3.9,65749,68383,2634
51179,VA,Stafford,,2017,3.6,67592,70099,2507
51179,VA,Stafford,,2018,2.9,69742,71845,2103
51179,VA,Stafford,,2019,2.7,72525,74556,2031
51179,VA,Stafford,,2020,5.6,69723,73839,4116
51179,VA,Stafford,,2021,3.6,69867,72503,2636
51181,VA,Surry,,2007,3.7,3596,3733,137
51181,VA,Surry,,2008,4.8,3629,3813,184
51181,VA,Surry,,2009,7.7,3451,3737,286
51181,VA,Surry,,2010,9.2,3361,3700,339
51181,VA,Surry,,2011,8.4,3437,3753,316
51181,VA,Surry,,2012,7.6,3401,3682,281
51181,VA,Surry,,2013,7.1,3374,3633,259
51181,VA,Surry,,2014,6.1,3452,3676,224
51181,VA,Surry,,2015,5,3545,3731,186
51181,VA,Surry,,2016,5.2,3471,3660,189
51181,VA,Surry,,2017,4.3,3609,3773,164
51181,VA,Surry,,2018,3.4,3660,3788,128
51181,VA,Surry,,2019,3.4,3590,3716,126
51181,VA,Surry,,2020,5.7,3398,3603,205
51181,VA,Surry,,2021,3.8,3349,3482,133
51183,VA,Sussex,,2007,4.8,4256,4472,216
51183,VA,Sussex,,2008,6.3,4222,4505,283
51183,VA,Sussex,,2009,10.3,4002,4464,462
51183,VA,Sussex,,2010,11.7,3791,4291,500
51183,VA,Sussex,,2011,10.5,3917,4375,458
51183,VA,Sussex,,2012,9.6,3860,4270,410
51183,VA,Sussex,,2013,9.1,3804,4183,379
51183,VA,Sussex,,2014,7.7,3804,4120,316
51183,VA,Sussex,,2015,6.8,3812,4088,276
51183,VA,Sussex,,2016,6.2,3708,3952,244
51183,VA,Sussex,,2017,5.9,3628,3855,227
51183,VA,Sussex,,2018,4.9,3611,3797,186
51183,VA,Sussex,,2019,4.5,3646,3818,172
51183,VA,Sussex,,2020,8.6,3373,3689,316
51183,VA,Sussex,,2021,6.5,3359,3593,234
51185,VA,Tazewell,,2007,4.9,19347,20335,988
51185,VA,Tazewell,,2008,4.8,19750,20736,986
51185,VA,Tazewell,,2009,7.7,19919,21580,1661
51185,VA,Tazewell,,2010,9,16771,18427,1656
51185,VA,Tazewell,,2011,8,16726,18172,1446
51185,VA,Tazewell,,2012,8.1,16485,17940,1455
51185,VA,Tazewell,,2013,8.4,16174,17665,1491
51185,VA,Tazewell,,2014,8,15895,17273,1378
51185,VA,Tazewell,,2015,7.3,15454,16670,1216
51185,VA,Tazewell,,2016,7.4,14787,15965,1178
51185,VA,Tazewell,,2017,5.6,15391,16303,912
51185,VA,Tazewell,,2018,4.4,15364,16065,701
51185,VA,Tazewell,,2019,4.3,15185,15867,682
51185,VA,Tazewell,,2020,7.6,14328,15510,1182
51185,VA,Tazewell,,2021,5.2,14210,14995,785
51187,VA,Warren,,2007,3.3,18811,19451,640
51187,VA,Warren,,2008,4.8,19102,20055,953
51187,VA,Warren,,2009,7.7,18309,19837,1528
51187,VA,Warren,,2010,8.3,18471,20137,1666
51187,VA,Warren,,2011,7.4,18604,20087,1483
51187,VA,Warren,,2012,6.6,18712,20028,1316
51187,VA,Warren,,2013,6,18887,20091,1204
51187,VA,Warren,,2014,5.5,18878,19983,1105
51187,VA,Warren,,2015,4.7,18773,19697,924
51187,VA,Warren,,2016,4,18940,19725,785
51187,VA,Warren,,2017,3.7,19315,20052,737
51187,VA,Warren,,2018,3,19752,20372,620
51187,VA,Warren,,2019,2.8,20236,20816,580
51187,VA,Warren,,2020,5.8,19165,20346,1181
51187,VA,Warren,,2021,3.5,19231,19936,705
51191,VA,Washington,,2007,4.9,25475,26789,1314
51191,VA,Washington,,2008,5.3,26043,27502,1459
51191,VA,Washington,,2009,8.7,24770,27125,2355
51191,VA,Washington,,2010,8.1,25226,27455,2229
51191,VA,Washington,,2011,7.1,25878,27852,1974
51191,VA,Washington,,2012,6.6,25896,27726,1830
51191,VA,Washington,,2013,6.2,26111,27842,1731
51191,VA,Washington,,2014,5.7,26146,27712,1566
51191,VA,Washington,,2015,4.7,25804,27083,1279
51191,VA,Washington,,2016,4.4,25687,26881,1194
51191,VA,Washington,,2017,4.1,25980,27081,1101
51191,VA,Washington,,2018,3.3,26027,26928,901
51191,VA,Washington,,2019,3.3,25776,26659,883
51191,VA,Washington,,2020,5.8,24474,25974,1500
51191,VA,Washington,,2021,3.6,24344,25246,902
51193,VA,Westmoreland,,2007,4.5,7949,8327,378
51193,VA,Westmoreland,,2008,5.4,8391,8874,483
51193,VA,Westmoreland,,2009,7.8,8462,9175,713
51193,VA,Westmoreland,,2010,8.3,8432,9193,761
51193,VA,Westmoreland,,2011,7.5,8684,9388,704
51193,VA,Westmoreland,,2012,7.1,8485,9136,651
51193,VA,Westmoreland,,2013,6.7,8489,9099,610
51193,VA,Westmoreland,,2014,6.3,8468,9042,574
51193,VA,Westmoreland,,2015,5.3,8478,8954,476
51193,VA,Westmoreland,,2016,4.5,8584,8989,405
51193,VA,Westmoreland,,2017,4.4,9027,9444,417
51193,VA,Westmoreland,,2018,3.6,9120,9463,343
51193,VA,Westmoreland,,2019,3.5,9300,9634,334
51193,VA,Westmoreland,,2020,5.8,8972,9527,555
51193,VA,Westmoreland,,2021,4.4,9087,9508,421
51195,VA,Wise,,2007,4.3,16737,17481,744
51195,VA,Wise,,2008,5,17195,18096,901
51195,VA,Wise,,2009,6.8,18181,19498,1317
51195,VA,Wise,,2010,8.5,15553,17005,1452
51195,VA,Wise,,2011,7.6,15911,17229,1318
51195,VA,Wise,,2012,8.8,14580,15979,1399
51195,VA,Wise,,2013,10.1,13561,15086,1525
51195,VA,Wise,,2014,9.3,13123,14471,1348
51195,VA,Wise,,2015,8.2,12701,13831,1130
51195,VA,Wise,,2016,8.3,12109,13211,1102
51195,VA,Wise,,2017,6.3,12804,13666,862
51195,VA,Wise,,2018,4.9,12683,13335,652
51195,VA,Wise,,2019,4.6,12895,13513,618
51195,VA,Wise,,2020,7.5,12138,13125,987
51195,VA,Wise,,2021,5.2,12058,12722,664
51197,VA,Wythe,,2007,4.8,14755,15503,748
51197,VA,Wythe,,2008,5.8,15243,16174,931
51197,VA,Wythe,,2009,10.7,14721,16481,1760
51197,VA,Wythe,,2010,11.3,12681,14302,1621
51197,VA,Wythe,,2011,9.2,13045,14360,1315
51197,VA,Wythe,,2012,7.6,13028,14096,1068
51197,VA,Wythe,,2013,7.6,12931,13995,1064
51197,VA,Wythe,,2014,6.3,12960,13834,874
51197,VA,Wythe,,2015,5.4,12961,13694,733
51197,VA,Wythe,,2016,5.6,12905,13673,768
51197,VA,Wythe,,2017,5,13457,14162,705
51197,VA,Wythe,,2018,3.7,13350,13861,511
51197,VA,Wythe,,2019,3.5,13410,13902,492
51197,VA,Wythe,,2020,7.7,12790,13859,1069
51197,VA,Wythe,,2021,4,12972,13516,544
51199,VA,York,,2007,2.7,30175,31008,833
51199,VA,York,,2008,3.6,30157,31269,1112
51199,VA,York,,2009,5.4,28902,30559,1657
51199,VA,York,,2010,6.3,29363,31326,1963
51199,VA,York,,2011,6.1,29904,31856,1952
51199,VA,York,,2012,5.7,29876,31672,1796
51199,VA,York,,2013,5.3,30175,31847,1672
51199,VA,York,,2014,4.9,30376,31944,1568
51199,VA,York,,2015,4.2,30763,32121,1358
51199,VA,York,,2016,3.8,30926,32155,1229
51199,VA,York,,2017,3.5,31676,32817,1141
51199,VA,York,,2018,2.8,32073,32983,910
51199,VA,York,,2019,2.6,32638,33521,883
51199,VA,York,,2020,5.5,30991,32801,1810
51199,VA,York,,2021,3.3,30888,31945,1057
51510,VA,Alexandria,,2007,2.4,87317,89472,2155
51510,VA,Alexandria,,2008,3,90246,93019,2773
51510,VA,Alexandria,,2009,4.9,90145,94797,4652
51510,VA,Alexandria,,2010,5,85872,90436,4564
51510,VA,Alexandria,,2011,4.4,88257,92366,4109
51510,VA,Alexandria,,2012,4,89424,93156,3732
51510,VA,Alexandria,,2013,4,90037,93742,3705
51510,VA,Alexandria,,2014,3.8,90355,93893,3538
51510,VA,Alexandria,,2015,3.2,91485,94551,3066
51510,VA,Alexandria,,2016,2.9,93776,96536,2760
51510,VA,Alexandria,,2017,2.8,97446,100279,2833
51510,VA,Alexandria,,2018,2.2,98733,101002,2269
51510,VA,Alexandria,,2019,2.1,100011,102166,2155
51510,VA,Alexandria,,2020,6,93425,99382,5957
51510,VA,Alexandria,,2021,3.8,93692,97365,3673
51520,VA,Bristol,,2007,5.5,7542,7985,443
51520,VA,Bristol,,2008,6.2,7591,8093,502
51520,VA,Bristol,,2009,10.2,7335,8166,831
51520,VA,Bristol,,2010,9,7270,7991,721
51520,VA,Bristol,,2011,8.3,7416,8084,668
51520,VA,Bristol,,2012,7.1,7417,7988,571
51520,VA,Bristol,,2013,6.8,7289,7822,533
51520,VA,Bristol,,2014,6.3,7261,7746,485
51520,VA,Bristol,,2015,5.3,7143,7541,398
51520,VA,Bristol,,2016,5,7084,7455,371
51520,VA,Bristol,,2017,4.5,7084,7415,331
51520,VA,Bristol,,2018,3.7,6978,7248,270
51520,VA,Bristol,,2019,3.7,7112,7386,274
51520,VA,Bristol,,2020,7.5,6988,7558,570
51520,VA,Bristol,,2021,4.7,6966,7313,347
51530,VA,Buena Vista,,2007,3.9,3249,3380,131
51530,VA,Buena Vista,,2008,5.5,3260,3450,190
51530,VA,Buena Vista,,2009,8.7,3164,3465,301
51530,VA,Buena Vista,,2010,10.2,2923,3255,332
51530,VA,Buena Vista,,2011,9.1,2940,3235,295
51530,VA,Buena Vista,,2012,7.7,3004,3255,251
51530,VA,Buena Vista,,2013,6.6,3094,3314,220
51530,VA,Buena Vista,,2014,5.7,3129,3317,188
51530,VA,Buena Vista,,2015,5,3141,3307,166
51530,VA,Buena Vista,,2016,5,3115,3279,164
51530,VA,Buena Vista,,2017,4.2,3245,3387,142
51530,VA,Buena Vista,,2018,3.1,3279,3384,105
51530,VA,Buena Vista,,2019,2.7,3414,3508,94
51530,VA,Buena Vista,,2020,5.6,3022,3200,178
51530,VA,Buena Vista,,2021,3.9,2846,2961,115
51540,VA,Charlottesville,,2007,3.3,20557,21259,702
51540,VA,Charlottesville,,2008,4.2,20790,21703,913
51540,VA,Charlottesville,,2009,6.6,20374,21811,1437
51540,VA,Charlottesville,,2010,6.2,21779,23229,1450
51540,VA,Charlottesville,,2011,5.6,21918,23212,1294
51540,VA,Charlottesville,,2012,5,22225,23400,1175
51540,VA,Charlottesville,,2013,4.6,22340,23410,1070
51540,VA,Charlottesville,,2014,4.2,23277,24308,1031
51540,VA,Charlottesville,,2015,3.6,23846,24746,900
51540,VA,Charlottesville,,2016,3.3,24088,24916,828
51540,VA,Charlottesville,,2017,3.1,25224,26018,794
51540,VA,Charlottesville,,2018,2.5,25564,26225,661
51540,VA,Charlottesville,,2019,2.3,25863,26484,621
51540,VA,Charlottesville,,2020,6.5,23641,25278,1637
51540,VA,Charlottesville,,2021,3.7,23706,24609,903
51550,VA,Chesapeake,,2007,3.3,110684,114407,3723
51550,VA,Chesapeake,,2008,4.2,111591,116435,4844
51550,VA,Chesapeake,,2009,6.5,107923,115430,7507
51550,VA,Chesapeake,,2010,7.4,105121,113482,8361
51550,VA,Chesapeake,,2011,6.9,106576,114467,7891
51550,VA,Chesapeake,,2012,6.3,107776,115007,7231
51550,VA,Chesapeake,,2013,5.8,109643,116363,6720
51550,VA,Chesapeake,,2014,5.2,111586,117670,6084
51550,VA,Chesapeake,,2015,4.5,111550,116777,5227
51550,VA,Chesapeake,,2016,4.2,113123,118086,4963
51550,VA,Chesapeake,,2017,3.7,117462,122020,4558
51550,VA,Chesapeake,,2018,3,119816,123520,3704
51550,VA,Chesapeake,,2019,2.8,122255,125827,3572
51550,VA,Chesapeake,,2020,6.1,115546,123014,7468
51550,VA,Chesapeake,,2021,3.8,115125,119733,4608
51570,VA,Colonial Heights,,2007,3.5,8889,9213,324
51570,VA,Colonial Heights,,2008,4.8,8871,9316,445
51570,VA,Colonial Heights,,2009,8,8464,9203,739
51570,VA,Colonial Heights,,2010,8.5,7824,8548,724
51570,VA,Colonial Heights,,2011,7.5,7904,8547,643
51570,VA,Colonial Heights,,2012,6.8,8016,8602,586
51570,VA,Colonial Heights,,2013,6.3,8112,8662,550
51570,VA,Colonial Heights,,2014,5.7,8236,8732,496
51570,VA,Colonial Heights,,2015,4.7,8295,8700,405
51570,VA,Colonial Heights,,2016,4.4,8338,8723,385
51570,VA,Colonial Heights,,2017,4,8477,8831,354
51570,VA,Colonial Heights,,2018,3.3,8533,8824,291
51570,VA,Colonial Heights,,2019,3.2,8393,8671,278
51570,VA,Colonial Heights,,2020,7.1,7783,8382,599
51570,VA,Colonial Heights,,2021,4.8,7778,8169,391
51580,VA,Covington,,2007,6.3,2540,2712,172
51580,VA,Covington,,2008,7.4,2481,2678,197
51580,VA,Covington,,2009,10.3,2473,2756,283
51580,VA,Covington,,2010,10.8,2402,2694,292
51580,VA,Covington,,2011,9.4,2409,2658,249
51580,VA,Covington,,2012,8.8,2407,2639,232
51580,VA,Covington,,2013,8.2,2350,2560,210
51580,VA,Covington,,2014,7.9,2299,2495,196
51580,VA,Covington,,2015,5.9,2283,2427,144
51580,VA,Covington,,2016,5.8,2247,2385,138
51580,VA,Covington,,2017,6,2322,2469,147
51580,VA,Covington,,2018,4.6,2311,2423,112
51580,VA,Covington,,2019,4.1,2339,2438,99
51580,VA,Covington,,2020,9.6,2182,2414,232
51580,VA,Covington,,2021,5.8,2147,2279,132
51590,VA,Danville,,2007,8,18214,19794,1580
51590,VA,Danville,,2008,9.9,18219,20219,2000
51590,VA,Danville,,2009,13.8,17437,20221,2784
51590,VA,Danville,,2010,13.8,17382,20163,2781
51590,VA,Danville,,2011,11.6,17894,20246,2352
51590,VA,Danville,,2012,10.1,17902,19924,2022
51590,VA,Danville,,2013,9.6,17895,19789,1894
51590,VA,Danville,,2014,8.5,17976,19649,1673
51590,VA,Danville,,2015,7.1,17819,19184,1365
51590,VA,Danville,,2016,6,17984,19125,1141
51590,VA,Danville,,2017,5.6,18991,20117,1126
51590,VA,Danville,,2018,5,18770,19763,993
51590,VA,Danville,,2019,4.9,18402,19360,958
51590,VA,Danville,,2020,9.7,17386,19244,1858
51590,VA,Danville,,2021,6.5,17190,18394,1204
51595,VA,Emporia,,2007,6.7,2300,2464,164
51595,VA,Emporia,,2008,8,2323,2524,201
51595,VA,Emporia,,2009,12.4,2234,2549,315
51595,VA,Emporia,,2010,12.7,2250,2576,326
51595,VA,Emporia,,2011,10.8,2277,2553,276
51595,VA,Emporia,,2012,10.3,2209,2464,255
51595,VA,Emporia,,2013,9.6,2151,2380,229
51595,VA,Emporia,,2014,8,2133,2319,186
51595,VA,Emporia,,2015,6.8,2098,2252,154
51595,VA,Emporia,,2016,6.3,2104,2246,142
51595,VA,Emporia,,2017,5.2,2260,2384,124
51595,VA,Emporia,,2018,4.7,2245,2356,111
51595,VA,Emporia,,2019,4.9,2218,2333,115
51595,VA,Emporia,,2020,11,2090,2347,257
51595,VA,Emporia,,2021,7.8,2153,2336,183
51600,VA,Fairfax,,2007,2.7,13524,13905,381
51600,VA,Fairfax,,2008,3.5,13888,14387,499
51600,VA,Fairfax,,2009,5.6,13761,14585,824
51600,VA,Fairfax,,2010,5.6,11967,12674,707
51600,VA,Fairfax,,2011,4.9,12070,12692,622
51600,VA,Fairfax,,2012,4.2,12373,12918,545
51600,VA,Fairfax,,2013,4.1,12585,13118,533
51600,VA,Fairfax,,2014,4,12755,13292,537
51600,VA,Fairfax,,2015,3.5,12409,12853,444
51600,VA,Fairfax,,2016,3,12602,12993,391
51600,VA,Fairfax,,2017,2.8,12710,13082,372
51600,VA,Fairfax,,2018,2.3,13104,13407,303
51600,VA,Fairfax,,2019,2.1,13063,13348,285
51600,VA,Fairfax,,2020,5.8,11962,12696,734
51600,VA,Fairfax,,2021,3.4,12004,12429,425
51610,VA,Falls Church,,2007,3.3,6444,6665,221
51610,VA,Falls Church,,2008,4.3,6609,6908,299
51610,VA,Falls Church,,2009,7,6777,7291,514
51610,VA,Falls Church,,2010,5,7018,7388,370
51610,VA,Falls Church,,2011,4.2,7188,7506,318
51610,VA,Falls Church,,2012,3.9,7417,7719,302
51610,VA,Falls Church,,2013,3.8,7547,7846,299
51610,VA,Falls Church,,2014,3.5,7542,7818,276
51610,VA,Falls Church,,2015,3,7641,7878,237
51610,VA,Falls Church,,2016,2.7,7778,7993,215
51610,VA,Falls Church,,2017,2.6,8188,8408,220
51610,VA,Falls Church,,2018,2.1,8385,8568,183
51610,VA,Falls Church,,2019,2.1,8462,8641,179
51610,VA,Falls Church,,2020,3.8,7951,8264,313
51610,VA,Falls Church,,2021,2.6,7979,8196,217
51620,VA,Franklin,,2007,5,3736,3931,195
51620,VA,Franklin,,2008,6.8,3687,3954,267
51620,VA,Franklin,,2009,10.3,3556,3965,409
51620,VA,Franklin,,2010,12.9,3239,3719,480
51620,VA,Franklin,,2011,11.4,3251,3668,417
51620,VA,Franklin,,2012,9.8,3356,3721,365
51620,VA,Franklin,,2013,9.1,3357,3693,336
51620,VA,Franklin,,2014,7.7,3346,3625,279
51620,VA,Franklin,,2015,6.6,3382,3622,240
51620,VA,Franklin,,2016,6,3329,3540,211
51620,VA,Franklin,,2017,5.2,3415,3604,189
51620,VA,Franklin,,2018,4.3,3468,3624,156
51620,VA,Franklin,,2019,3.9,3489,3632,143
51620,VA,Franklin,,2020,8.3,3343,3647,304
51620,VA,Franklin,,2021,6.9,3242,3481,239
51630,VA,Fredericksburg,,2007,4.8,11849,12452,603
51630,VA,Fredericksburg,,2008,6.5,12128,12972,844
51630,VA,Fredericksburg,,2009,9.6,11802,13049,1247
51630,VA,Fredericksburg,,2010,9.2,11298,12446,1148
51630,VA,Fredericksburg,,2011,8,12006,13052,1046
51630,VA,Fredericksburg,,2012,6.9,12638,13577,939
51630,VA,Fredericksburg,,2013,6.3,12894,13763,869
51630,VA,Fredericksburg,,2014,6,12894,13716,822
51630,VA,Fredericksburg,,2015,5.3,12712,13419,707
51630,VA,Fredericksburg,,2016,4.7,12936,13575,639
51630,VA,Fredericksburg,,2017,4.3,13128,13722,594
51630,VA,Fredericksburg,,2018,3.4,13617,14101,484
51630,VA,Fredericksburg,,2019,3.3,13835,14313,478
51630,VA,Fredericksburg,,2020,7.1,13175,14179,1004
51630,VA,Fredericksburg,,2021,4.7,13207,13853,646
51640,VA,Galax,,2007,6.1,2942,3133,191
51640,VA,Galax,,2008,6.6,2926,3132,206
51640,VA,Galax,,2009,9.9,2929,3250,321
51640,VA,Galax,,2010,11.2,2824,3179,355
51640,VA,Galax,,2011,10.3,2781,3099,318
51640,VA,Galax,,2012,8.7,2786,3051,265
51640,VA,Galax,,2013,8.4,2764,3018,254
51640,VA,Galax,,2014,7.2,2786,3003,217
51640,VA,Galax,,2015,5.4,2798,2957,159
51640,VA,Galax,,2016,4.9,2764,2905,141
51640,VA,Galax,,2017,4.1,2909,3034,125
51640,VA,Galax,,2018,3.4,2858,2959,101
51640,VA,Galax,,2019,3.2,2860,2954,94
51640,VA,Galax,,2020,7.7,2661,2884,223
51640,VA,Galax,,2021,4.1,2698,2813,115
51650,VA,Hampton,,2007,3.8,65927,68566,2639
51650,VA,Hampton,,2008,5.1,65685,69225,3540
51650,VA,Hampton,,2009,8,62217,67619,5402
51650,VA,Hampton,,2010,9.2,60658,66782,6124
51650,VA,Hampton,,2011,8.9,60425,66340,5915
51650,VA,Hampton,,2012,8.1,60530,65857,5327
51650,VA,Hampton,,2013,7.3,61010,65830,4820
51650,VA,Hampton,,2014,6.6,61431,65793,4362
51650,VA,Hampton,,2015,5.9,60682,64501,3819
51650,VA,Hampton,,2016,5.6,60438,64029,3591
51650,VA,Hampton,,2017,5,61795,65043,3248
51650,VA,Hampton,,2018,4,62286,64888,2602
51650,VA,Hampton,,2019,3.7,63068,65518,2450
51650,VA,Hampton,,2020,8.5,59493,64985,5492
51650,VA,Hampton,,2021,5.7,59278,62844,3566
51660,VA,Harrisonburg,,2007,3.1,22057,22773,716
51660,VA,Harrisonburg,,2008,4.5,21925,22958,1033
51660,VA,Harrisonburg,,2009,6.9,21558,23149,1591
51660,VA,Harrisonburg,,2010,8.5,21240,23202,1962
51660,VA,Harrisonburg,,2011,7.8,21903,23747,1844
51660,VA,Harrisonburg,,2012,7.2,22345,24084,1739
51660,VA,Harrisonburg,,2013,6.6,22446,24033,1587
51660,VA,Harrisonburg,,2014,6,22843,24296,1453
51660,VA,Harrisonburg,,2015,5.2,22722,23977,1255
51660,VA,Harrisonburg,,2016,4.7,23107,24259,1152
51660,VA,Harrisonburg,,2017,4.4,23915,25005,1090
51660,VA,Harrisonburg,,2018,3.5,23942,24799,857
51660,VA,Harrisonburg,,2019,3.2,24218,25018,800
51660,VA,Harrisonburg,,2020,6.4,22818,24374,1556
51660,VA,Harrisonburg,,2021,4,23027,23996,969
51670,VA,Hopewell,,2007,5,9931,10458,527
51670,VA,Hopewell,,2008,6.4,9977,10663,686
51670,VA,Hopewell,,2009,10.6,9480,10608,1128
51670,VA,Hopewell,,2010,11.8,8717,9884,1167
51670,VA,Hopewell,,2011,11.3,8779,9895,1116
51670,VA,Hopewell,,2012,9.9,8760,9719,959
51670,VA,Hopewell,,2013,9.5,8729,9650,921
51670,VA,Hopewell,,2014,8.8,8828,9682,854
51670,VA,Hopewell,,2015,7.5,8933,9655,722
51670,VA,Hopewell,,2016,6.4,9157,9786,629
51670,VA,Hopewell,,2017,6.1,9236,9833,597
51670,VA,Hopewell,,2018,4.8,9277,9740,463
51670,VA,Hopewell,,2019,4.3,9337,9754,417
51670,VA,Hopewell,,2020,10.8,8676,9723,1047
51670,VA,Hopewell,,2021,7.5,8662,9361,699
51678,VA,Lexington,,2007,5,2253,2371,118
51678,VA,Lexington,,2008,6.9,2257,2425,168
51678,VA,Lexington,,2009,9.9,2246,2492,246
51678,VA,Lexington,,2010,9.5,2085,2304,219
51678,VA,Lexington,,2011,9.1,2080,2289,209
51678,VA,Lexington,,2012,8.6,2083,2279,196
51678,VA,Lexington,,2013,8.3,2064,2251,187
51678,VA,Lexington,,2014,7.6,2106,2280,174
51678,VA,Lexington,,2015,6.7,2108,2260,152
51678,VA,Lexington,,2016,6,2130,2267,137
51678,VA,Lexington,,2017,6,2014,2142,128
51678,VA,Lexington,,2018,4.7,2000,2098,98
51678,VA,Lexington,,2019,4.6,2017,2115,98
51678,VA,Lexington,,2020,6.9,1902,2043,141
51678,VA,Lexington,,2021,4.9,1946,2047,101
51680,VA,Lynchburg,,2007,4,32288,33650,1362
51680,VA,Lynchburg,,2008,5.2,33301,35112,1811
51680,VA,Lynchburg,,2009,8.2,32130,35007,2877
51680,VA,Lynchburg,,2010,8.7,32781,35899,3118
51680,VA,Lynchburg,,2011,8,32834,35703,2869
51680,VA,Lynchburg,,2012,7.3,32933,35536,2603
51680,VA,Lynchburg,,2013,6.9,33266,35740,2474
51680,VA,Lynchburg,,2014,6.3,33853,36112,2259
51680,VA,Lynchburg,,2015,5.5,33791,35763,1972
51680,VA,Lynchburg,,2016,5.1,33738,35557,1819
51680,VA,Lynchburg,,2017,4.9,34606,36372,1766
51680,VA,Lynchburg,,2018,4,35146,36598,1452
51680,VA,Lynchburg,,2019,3.7,35617,36976,1359
51680,VA,Lynchburg,,2020,7.2,33263,35861,2598
51680,VA,Lynchburg,,2021,5.1,32939,34699,1760
51683,VA,Manassas,,2007,3.2,19163,19787,624
51683,VA,Manassas,,2008,4.5,19146,20058,912
51683,VA,Manassas,,2009,7.5,19026,20561,1535
51683,VA,Manassas,,2010,7.2,19494,21004,1510
51683,VA,Manassas,,2011,6.1,20072,21377,1305
51683,VA,Manassas,,2012,5.5,20695,21898,1203
51683,VA,Manassas,,2013,5.3,21075,22246,1171
51683,VA,Manassas,,2014,4.9,21102,22193,1091
51683,VA,Manassas,,2015,4.1,20794,21681,887
51683,VA,Manassas,,2016,3.6,20858,21626,768
51683,VA,Manassas,,2017,3.3,21114,21844,730
51683,VA,Manassas,,2018,2.7,21403,21990,587
51683,VA,Manassas,,2019,2.5,21537,22089,552
51683,VA,Manassas,,2020,6.5,20102,21506,1404
51683,VA,Manassas,,2021,3.9,20162,20983,821
51685,VA,Manassas Park,,2007,2.7,6383,6563,180
51685,VA,Manassas Park,,2008,4,6355,6623,268
51685,VA,Manassas Park,,2009,6.2,6473,6899,426
51685,VA,Manassas Park,,2010,6.4,7559,8076,517
51685,VA,Manassas Park,,2011,5.6,8140,8621,481
51685,VA,Manassas Park,,2012,5.2,8290,8743,453
51685,VA,Manassas Park,,2013,5,8371,8808,437
51685,VA,Manassas Park,,2014,4.7,7806,8190,384
51685,VA,Manassas Park,,2015,4.1,8022,8367,345
51685,VA,Manassas Park,,2016,3.6,8188,8493,305
51685,VA,Manassas Park,,2017,3.3,8629,8926,297
51685,VA,Manassas Park,,2018,2.7,9103,9355,252
51685,VA,Manassas Park,,2019,2.5,9377,9613,236
51685,VA,Manassas Park,,2020,6.6,9071,9716,645
51685,VA,Manassas Park,,2021,3.8,9104,9464,360
51690,VA,Martinsville,,2007,8.9,5422,5949,527
51690,VA,Martinsville,,2008,12.8,5198,5961,763
51690,VA,Martinsville,,2009,19.6,5025,6253,1228
51690,VA,Martinsville,,2010,17.8,5063,6161,1098
51690,VA,Martinsville,,2011,15.2,4998,5892,894
51690,VA,Martinsville,,2012,12.6,5009,5729,720
51690,VA,Martinsville,,2013,11,5067,5693,626
51690,VA,Martinsville,,2014,9.7,5017,5559,542
51690,VA,Martinsville,,2015,8.7,4909,5375,466
51690,VA,Martinsville,,2016,7,4807,5167,360
51690,VA,Martinsville,,2017,6.2,5214,5560,346
51690,VA,Martinsville,,2018,4.5,5272,5523,251
51690,VA,Martinsville,,2019,4,5314,5538,224
51690,VA,Martinsville,,2020,10.9,5034,5649,615
51690,VA,Martinsville,,2021,7.5,5115,5531,416
51700,VA,Newport News,,2007,3.9,84270,87649,3379
51700,VA,Newport News,,2008,5,84808,89268,4460
51700,VA,Newport News,,2009,7.6,87673,94857,7184
51700,VA,Newport News,,2010,8.5,83062,90822,7760
51700,VA,Newport News,,2011,8.1,83192,90550,7358
51700,VA,Newport News,,2012,7.3,83269,89872,6603
51700,VA,Newport News,,2013,6.6,84482,90463,5981
51700,VA,Newport News,,2014,6.1,85403,90995,5592
51700,VA,Newport News,,2015,5.4,84369,89143,4774
51700,VA,Newport News,,2016,5,84452,88936,4484
51700,VA,Newport News,,2017,4.6,85701,89790,4089
51700,VA,Newport News,,2018,3.6,86228,89443,3215
51700,VA,Newport News,,2019,3.4,87466,90560,3094
51700,VA,Newport News,,2020,8.6,81831,89574,7743
51700,VA,Newport News,,2021,5.6,81527,86364,4837
51710,VA,Norfolk,,2007,4.4,95475,99895,4420
51710,VA,Norfolk,,2008,5.7,95108,100841,5733
51710,VA,Norfolk,,2009,8.7,90574,99228,8654
51710,VA,Norfolk,,2010,9,102555,112640,10085
51710,VA,Norfolk,,2011,8.3,103387,112742,9355
51710,VA,Norfolk,,2012,7.5,104230,112642,8412
51710,VA,Norfolk,,2013,6.8,105086,112752,7666
51710,VA,Norfolk,,2014,6.2,105379,112403,7024
51710,VA,Norfolk,,2015,5.5,104840,110946,6106
51710,VA,Norfolk,,2016,5.2,104722,110464,5742
51710,VA,Norfolk,,2017,4.6,107538,112669,5131
51710,VA,Norfolk,,2018,3.6,108386,112435,4049
51710,VA,Norfolk,,2019,3.4,108973,112836,3863
51710,VA,Norfolk,,2020,8.7,102070,111753,9683
51710,VA,Norfolk,,2021,5.7,101694,107879,6185
51720,VA,Norton,,2007,4.4,1498,1567,69
51720,VA,Norton,,2008,5.6,1529,1620,91
51720,VA,Norton,,2009,6.5,1619,1732,113
51720,VA,Norton,,2010,7.4,1927,2082,155
51720,VA,Norton,,2011,6.9,1964,2109,145
51720,VA,Norton,,2012,7.5,1841,1990,149
51720,VA,Norton,,2013,8.1,1717,1869,152
51720,VA,Norton,,2014,7.6,1674,1811,137
51720,VA,Norton,,2015,6.8,1620,1739,119
51720,VA,Norton,,2016,6.7,1550,1662,112
51720,VA,Norton,,2017,5.2,1627,1717,90
51720,VA,Norton,,2018,3.9,1615,1681,66
51720,VA,Norton,,2019,3.6,1638,1699,61
51720,VA,Norton,,2020,7.3,1539,1661,122
51720,VA,Norton,,2021,4.9,1525,1604,79
51730,VA,Petersburg,,2007,6.7,13180,14134,954
51730,VA,Petersburg,,2008,7.9,13187,14311,1124
51730,VA,Petersburg,,2009,13.6,12568,14545,1977
51730,VA,Petersburg,,2010,14.3,11933,13922,1989
51730,VA,Petersburg,,2011,12.8,11934,13690,1756
51730,VA,Petersburg,,2012,11.7,11992,13585,1593
51730,VA,Petersburg,,2013,11.4,12190,13760,1570
51730,VA,Petersburg,,2014,10.5,12371,13827,1456
51730,VA,Petersburg,,2015,9.1,12320,13547,1227
51730,VA,Petersburg,,2016,7.7,12194,13214,1020
51730,VA,Petersburg,,2017,7.2,12308,13269,961
51730,VA,Petersburg,,2018,6.1,12311,13109,798
51730,VA,Petersburg,,2019,5.6,12343,13072,729
51730,VA,Petersburg,,2020,14.2,11221,13071,1850
51730,VA,Petersburg,,2021,10.5,11210,12529,1319
51735,VA,Poquoson,,2007,2.5,6172,6328,156
51735,VA,Poquoson,,2008,3.3,6179,6390,211
51735,VA,Poquoson,,2009,5.3,5893,6222,329
51735,VA,Poquoson,,2010,6.2,6004,6402,398
51735,VA,Poquoson,,2011,5.7,5998,6360,362
51735,VA,Poquoson,,2012,5.3,6016,6353,337
51735,VA,Poquoson,,2013,4.9,6041,6349,308
51735,VA,Poquoson,,2014,4.5,6039,6321,282
51735,VA,Poquoson,,2015,3.8,5988,6226,238
51735,VA,Poquoson,,2016,3.4,5963,6176,213
51735,VA,Poquoson,,2017,3.4,6113,6326,213
51735,VA,Poquoson,,2018,2.6,6255,6425,170
51735,VA,Poquoson,,2019,2.4,6376,6532,156
51735,VA,Poquoson,,2020,4.2,5980,6241,261
51735,VA,Poquoson,,2021,2.8,5960,6130,170
51740,VA,Portsmouth,,2007,4.5,44398,46501,2103
51740,VA,Portsmouth,,2008,5.6,43911,46497,2586
51740,VA,Portsmouth,,2009,8.7,41442,45386,3944
51740,VA,Portsmouth,,2010,9.8,41082,45555,4473
51740,VA,Portsmouth,,2011,9.3,41440,45701,4261
51740,VA,Portsmouth,,2012,8.6,41689,45630,3941
51740,VA,Portsmouth,,2013,7.9,41847,45461,3614
51740,VA,Portsmouth,,2014,7.1,41996,45226,3230
51740,VA,Portsmouth,,2015,6.1,41689,44417,2728
51740,VA,Portsmouth,,2016,6,41436,44103,2667
51740,VA,Portsmouth,,2017,5.3,42308,44681,2373
51740,VA,Portsmouth,,2018,4,42790,44594,1804
51740,VA,Portsmouth,,2019,3.9,43153,44890,1737
51740,VA,Portsmouth,,2020,9.4,40715,44953,4238
51740,VA,Portsmouth,,2021,6.7,40574,43482,2908
51750,VA,Radford,,2007,4.4,7429,7768,339
51750,VA,Radford,,2008,5.7,7536,7993,457
51750,VA,Radford,,2009,9.1,7235,7960,725
51750,VA,Radford,,2010,9.5,7057,7802,745
51750,VA,Radford,,2011,8.4,7391,8069,678
51750,VA,Radford,,2012,7.8,7463,8092,629
51750,VA,Radford,,2013,7.4,7722,8336,614
51750,VA,Radford,,2014,6.6,7933,8495,562
51750,VA,Radford,,2015,5.6,7859,8323,464
51750,VA,Radford,,2016,5.3,7826,8267,441
51750,VA,Radford,,2017,4.9,8006,8417,411
51750,VA,Radford,,2018,3.7,8373,8699,326
51750,VA,Radford,,2019,3.5,8498,8808,310
51750,VA,Radford,,2020,6.3,8010,8546,536
51750,VA,Radford,,2021,4.1,8204,8551,347
51760,VA,Richmond,,2007,4.7,94368,99048,4680
51760,VA,Richmond,,2008,6.2,95224,101541,6317
51760,VA,Richmond,,2009,9.8,91672,101605,9933
51760,VA,Richmond,,2010,9.7,96300,106682,10382
51760,VA,Richmond,,2011,8.5,98386,107496,9110
51760,VA,Richmond,,2012,7.3,101114,109135,8021
51760,VA,Richmond,,2013,6.6,103127,110460,7333
51760,VA,Richmond,,2014,6,105947,112740,6793
51760,VA,Richmond,,2015,5.1,107324,113141,5817
51760,VA,Richmond,,2016,4.6,109549,114798,5249
51760,VA,Richmond,,2017,4.3,112921,117943,5022
51760,VA,Richmond,,2018,3.5,114564,118719,4155
51760,VA,Richmond,,2019,3.3,116513,120429,3916
51760,VA,Richmond,,2020,8.8,109953,120511,10558
51760,VA,Richmond,,2021,5.5,109892,116270,6378
51770,VA,Roanoke,,2007,4.1,44462,46347,1885
51770,VA,Roanoke,,2008,4.9,44736,47042,2306
51770,VA,Roanoke,,2009,8.8,43316,47493,4177
51770,VA,Roanoke,,2010,8.9,45000,49374,4374
51770,VA,Roanoke,,2011,8,45430,49394,3964
51770,VA,Roanoke,,2012,7.1,46064,49563,3499
51770,VA,Roanoke,,2013,6.5,46540,49777,3237
51770,VA,Roanoke,,2014,5.8,47364,50256,2892
51770,VA,Roanoke,,2015,4.8,46728,49096,2368
51770,VA,Roanoke,,2016,4.2,46924,48997,2073
51770,VA,Roanoke,,2017,4.1,47397,49421,2024
51770,VA,Roanoke,,2018,3.2,47784,49366,1582
51770,VA,Roanoke,,2019,3,48170,49666,1496
51770,VA,Roanoke,,2020,7.7,45554,49330,3776
51770,VA,Roanoke,,2021,4.8,45355,47664,2309
51775,VA,Salem,,2007,3.2,12950,13378,428
51775,VA,Salem,,2008,3.9,13093,13630,537
51775,VA,Salem,,2009,6.5,12476,13346,870
51775,VA,Salem,,2010,7,11904,12806,902
51775,VA,Salem,,2011,6.3,12001,12814,813
51775,VA,Salem,,2012,5.8,12145,12896,751
51775,VA,Salem,,2013,5.7,12310,13052,742
51775,VA,Salem,,2014,5.1,12499,13166,667
51775,VA,Salem,,2015,4.4,12258,12816,558
51775,VA,Salem,,2016,3.9,12409,12909,500
51775,VA,Salem,,2017,3.7,12674,13160,486
51775,VA,Salem,,2018,2.9,12649,13033,384
51775,VA,Salem,,2019,2.8,12677,13037,360
51775,VA,Salem,,2020,5.8,12010,12745,735
51775,VA,Salem,,2021,3.6,11950,12390,440
51790,VA,Staunton,,2007,3.3,11230,11618,388
51790,VA,Staunton,,2008,4.6,11313,11861,548
51790,VA,Staunton,,2009,7.4,11060,11945,885
51790,VA,Staunton,,2010,8,10915,11864,949
51790,VA,Staunton,,2011,7.1,11139,11985,846
51790,VA,Staunton,,2012,6.3,11064,11807,743
51790,VA,Staunton,,2013,5.7,11278,11957,679
51790,VA,Staunton,,2014,5.1,11472,12083,611
51790,VA,Staunton,,2015,4.3,11348,11857,509
51790,VA,Staunton,,2016,3.8,11354,11808,454
51790,VA,Staunton,,2017,3.5,11551,11975,424
51790,VA,Staunton,,2018,2.8,11793,12135,342
51790,VA,Staunton,,2019,2.7,12066,12396,330
51790,VA,Staunton,,2020,6.3,11483,12253,770
51790,VA,Staunton,,2021,3.8,11397,11849,452
51800,VA,Suffolk,,2007,3.5,38414,39827,1413
51800,VA,Suffolk,,2008,4.4,39026,40828,1802
51800,VA,Suffolk,,2009,6.9,37961,40753,2792
51800,VA,Suffolk,,2010,7.8,38562,41816,3254
51800,VA,Suffolk,,2011,7.4,38738,41842,3104
51800,VA,Suffolk,,2012,6.9,38861,41732,2871
51800,VA,Suffolk,,2013,6.2,39393,41988,2595
51800,VA,Suffolk,,2014,5.7,40105,42508,2403
51800,VA,Suffolk,,2015,4.9,40380,42458,2078
51800,VA,Suffolk,,2016,4.6,41030,43013,1983
51800,VA,Suffolk,,2017,4,42616,44405,1789
51800,VA,Suffolk,,2018,3.2,43510,44945,1435
51800,VA,Suffolk,,2019,3,44444,45819,1375
51800,VA,Suffolk,,2020,6.4,42448,45344,2896
51800,VA,Suffolk,,2021,4.4,42283,44227,1944
51810,VA,Virginia Beach,,2007,3,216443,223066,6623
51810,VA,Virginia Beach,,2008,3.9,216685,225528,8843
51810,VA,Virginia Beach,,2009,6.1,207169,220666,13497
51810,VA,Virginia Beach,,2010,6.7,212040,227179,15139
51810,VA,Virginia Beach,,2011,6.1,214828,228853,14025
51810,VA,Virginia Beach,,2012,5.6,215847,228708,12861
51810,VA,Virginia Beach,,2013,5.3,218890,231089,12199
51810,VA,Virginia Beach,,2014,4.8,221324,232581,11257
51810,VA,Virginia Beach,,2015,4.2,219985,229696,9711
51810,VA,Virginia Beach,,2016,3.9,220574,229517,8943
51810,VA,Virginia Beach,,2017,3.5,225590,233787,8197
51810,VA,Virginia Beach,,2018,2.8,228003,234644,6641
51810,VA,Virginia Beach,,2019,2.7,230437,236742,6305
51810,VA,Virginia Beach,,2020,6.2,216547,230879,14332
51810,VA,Virginia Beach,,2021,3.7,215879,224179,8300
51820,VA,Waynesboro,,2007,3.7,9723,10100,377
51820,VA,Waynesboro,,2008,5.3,9872,10423,551
51820,VA,Waynesboro,,2009,8.7,9814,10750,936
51820,VA,Waynesboro,,2010,9.2,9250,10189,939
51820,VA,Waynesboro,,2011,8.1,9342,10161,819
51820,VA,Waynesboro,,2012,6.9,9333,10024,691
51820,VA,Waynesboro,,2013,5.9,9437,10030,593
51820,VA,Waynesboro,,2014,5.2,9574,10104,530
51820,VA,Waynesboro,,2015,4.7,9576,10050,474
51820,VA,Waynesboro,,2016,4.1,9788,10205,417
51820,VA,Waynesboro,,2017,4,10103,10520,417
51820,VA,Waynesboro,,2018,3.2,10285,10625,340
51820,VA,Waynesboro,,2019,2.9,10517,10826,309
51820,VA,Waynesboro,,2020,6.6,9949,10650,701
51820,VA,Waynesboro,,2021,4.1,9873,10298,425
51830,VA,Williamsburg,,2007,6.1,4816,5127,311
51830,VA,Williamsburg,,2008,9.2,4852,5345,493
51830,VA,Williamsburg,,2009,15.1,4734,5577,843
51830,VA,Williamsburg,,2010,10.4,5853,6530,677
51830,VA,Williamsburg,,2011,9,6130,6733,603
51830,VA,Williamsburg,,2012,8.2,6273,6832,559
51830,VA,Williamsburg,,2013,7.5,6360,6876,516
51830,VA,Williamsburg,,2014,7.2,6178,6658,480
51830,VA,Williamsburg,,2015,6.3,6264,6682,418
51830,VA,Williamsburg,,2016,5.4,6354,6720,366
51830,VA,Williamsburg,,2017,5.1,6454,6804,350
51830,VA,Williamsburg,,2018,4,6468,6737,269
51830,VA,Williamsburg,,2019,3.8,6565,6827,262
51830,VA,Williamsburg,,2020,8.1,6277,6831,554
51830,VA,Williamsburg,,2021,4.9,6259,6579,320
51840,VA,Winchester,,2007,3.5,13842,14339,497
51840,VA,Winchester,,2008,4.9,13640,14344,704
51840,VA,Winchester,,2009,8.3,13103,14283,1180
51840,VA,Winchester,,2010,8.5,12545,13705,1160
51840,VA,Winchester,,2011,7.4,13014,14053,1039
51840,VA,Winchester,,2012,6.5,13292,14223,931
51840,VA,Winchester,,2013,5.7,13547,14363,816
51840,VA,Winchester,,2014,5,13753,14481,728
51840,VA,Winchester,,2015,4.3,13640,14256,616
51840,VA,Winchester,,2016,3.9,13780,14345,565
51840,VA,Winchester,,2017,3.6,14083,14611,528
51840,VA,Winchester,,2018,2.9,14258,14690,432
51840,VA,Winchester,,2019,2.8,14539,14953,414
51840,VA,Winchester,,2020,5.9,13818,14688,870
51840,VA,Winchester,,2021,3.5,13932,14437,505
53000,WA,Washington,,2007,4.6,3244794,3401404,156610
53000,WA,Washington,,2008,5.2,3291664,3474043,182379
53000,WA,Washington,,2009,8.3,3176729,3463713,286984
53000,WA,Washington,,2010,9.1,3142109,3458451,316342
53000,WA,Washington,,2011,8.5,3144459,3437871,293412
53000,WA,Washington,,2012,7.7,3203294,3468738,265444
53000,WA,Washington,,2013,6.6,3230947,3460772,229825
53000,WA,Washington,,2014,5.9,3287904,3495153,207249
53000,WA,Washington,,2015,5.4,3361249,3554826,193577
53000,WA,Washington,,2016,5.2,3459527,3648558,189031
53000,WA,Washington,,2017,4.6,3554754,3727683,172929
53000,WA,Washington,,2018,4.4,3644274,3813320,169046
53000,WA,Washington,,2019,4.3,3764634,3933774,169140
53000,WA,Washington,,2020,8.5,3596814,3929477,332663
53000,WA,Washington,,2021,5.2,3708738,3913513,204775
53001,WA,Adams,,2007,6.4,7494,8010,516
53001,WA,Adams,,2008,6.4,7589,8110,521
53001,WA,Adams,,2009,8.4,7461,8142,681
53001,WA,Adams,,2010,9.5,7480,8265,785
53001,WA,Adams,,2011,9.1,7431,8173,742
53001,WA,Adams,,2012,8.3,7512,8195,683
53001,WA,Adams,,2013,8.2,7680,8366,686
53001,WA,Adams,,2014,6.9,7944,8537,593
53001,WA,Adams,,2015,6.7,8038,8617,579
53001,WA,Adams,,2016,6.3,8166,8717,551
53001,WA,Adams,,2017,5.6,8428,8932,504
53001,WA,Adams,,2018,5.4,8924,9433,509
53001,WA,Adams,,2019,5.7,9411,9985,574
53001,WA,Adams,,2020,7.2,8599,9267,668
53001,WA,Adams,,2021,5.5,9080,9611,531
53003,WA,Asotin,,2007,5.1,9733,10253,520
53003,WA,Asotin,,2008,6.5,9716,10393,677
53003,WA,Asotin,,2009,8.9,9259,10162,903
53003,WA,Asotin,,2010,8.5,9269,10133,864
53003,WA,Asotin,,2011,8,9166,9964,798
53003,WA,Asotin,,2012,7.1,9038,9733,695
53003,WA,Asotin,,2013,6.5,9151,9785,634
53003,WA,Asotin,,2014,5.2,9190,9694,504
53003,WA,Asotin,,2015,4.6,9234,9682,448
53003,WA,Asotin,,2016,4.9,9483,9972,489
53003,WA,Asotin,,2017,4.1,9868,10293,425
53003,WA,Asotin,,2018,4.3,9811,10250,439
53003,WA,Asotin,,2019,4.2,10029,10467,438
53003,WA,Asotin,,2020,5.1,9799,10331,532
53003,WA,Asotin,,2021,3.7,10235,10630,395
53005,WA,Benton,,2007,5.4,81360,85969,4609
53005,WA,Benton,,2008,5.3,84049,88736,4687
53005,WA,Benton,,2009,6.7,84898,90965,6067
53005,WA,Benton,,2010,7.1,85997,92564,6567
53005,WA,Benton,,2011,7.3,85344,92110,6766
53005,WA,Benton,,2012,8.5,83800,91611,7811
53005,WA,Benton,,2013,8.7,82314,90174,7860
53005,WA,Benton,,2014,7.3,83220,89740,6520
53005,WA,Benton,,2015,6.5,85797,91733,5936
53005,WA,Benton,,2016,6.2,88504,94362,5858
53005,WA,Benton,,2017,5.4,92105,97393,5288
53005,WA,Benton,,2018,5.2,94389,99575,5186
53005,WA,Benton,,2019,5.3,98586,104153,5567
53005,WA,Benton,,2020,7.9,97191,105564,8373
53005,WA,Benton,,2021,5.6,98915,104773,5858
53007,WA,Chelan,,2007,5.4,38383,40567,2184
53007,WA,Chelan,,2008,5.8,38474,40845,2371
53007,WA,Chelan,,2009,7.5,38159,41241,3082
53007,WA,Chelan,,2010,8.1,37974,41300,3326
53007,WA,Chelan,,2011,7.6,37941,41049,3108
53007,WA,Chelan,,2012,7.3,38238,41248,3010
53007,WA,Chelan,,2013,7.1,37491,40363,2872
53007,WA,Chelan,,2014,6,38656,41117,2461
53007,WA,Chelan,,2015,5.4,40344,42646,2302
53007,WA,Chelan,,2016,5.6,40878,43313,2435
53007,WA,Chelan,,2017,4.8,42367,44485,2118
53007,WA,Chelan,,2018,4.5,43317,45381,2064
53007,WA,Chelan,,2019,5,43236,45492,2256
53007,WA,Chelan,,2020,8.2,41025,44686,3661
53007,WA,Chelan,,2021,5.3,42496,44869,2373
53009,WA,Clallam,,2007,6.4,28038,29964,1926
53009,WA,Clallam,,2008,7.4,27831,30049,2218
53009,WA,Clallam,,2009,9.3,26921,29697,2776
53009,WA,Clallam,,2010,10,26094,29006,2912
53009,WA,Clallam,,2011,9.9,25391,28173,2782
53009,WA,Clallam,,2012,9.6,25310,27997,2687
53009,WA,Clallam,,2013,9.4,24731,27299,2568
53009,WA,Clallam,,2014,8.2,24504,26682,2178
53009,WA,Clallam,,2015,7.9,24680,26784,2104
53009,WA,Clallam,,2016,7.5,25285,27332,2047
53009,WA,Clallam,,2017,6.7,26016,27884,1868
53009,WA,Clallam,,2018,6.3,26474,28269,1795
53009,WA,Clallam,,2019,6.7,27175,29134,1959
53009,WA,Clallam,,2020,10.2,25951,28904,2953
53009,WA,Clallam,,2021,6.5,27460,29371,1911
53011,WA,Clark,,2007,6.2,196776,209683,12907
53011,WA,Clark,,2008,7.3,199107,214879,15772
53011,WA,Clark,,2009,12.3,187511,213889,26378
53011,WA,Clark,,2010,11.7,186782,211568,24786
53011,WA,Clark,,2011,10.5,186966,208902,21936
53011,WA,Clark,,2012,8.6,190460,208427,17967
53011,WA,Clark,,2013,8.3,190863,208097,17234
53011,WA,Clark,,2014,6.8,194712,208941,14229
53011,WA,Clark,,2015,6.2,200966,214327,13361
53011,WA,Clark,,2016,6,207736,220996,13260
53011,WA,Clark,,2017,5,217404,228847,11443
53011,WA,Clark,,2018,4.8,223243,234402,11159
53011,WA,Clark,,2019,4.8,235442,247294,11852
53011,WA,Clark,,2020,8.4,223280,243828,20548
53011,WA,Clark,,2021,5.5,232586,246019,13433
53013,WA,Columbia,,2007,7.3,1417,1528,111
53013,WA,Columbia,,2008,7.4,1448,1563,115
53013,WA,Columbia,,2009,10.2,1404,1564,160
53013,WA,Columbia,,2010,8.5,1756,1919,163
53013,WA,Columbia,,2011,8.4,1682,1836,154
53013,WA,Columbia,,2012,7.6,1676,1813,137
53013,WA,Columbia,,2013,7.8,1627,1765,138
53013,WA,Columbia,,2014,7,1617,1738,121
53013,WA,Columbia,,2015,6.3,1586,1693,107
53013,WA,Columbia,,2016,6.4,1610,1720,110
53013,WA,Columbia,,2017,5.5,1684,1782,98
53013,WA,Columbia,,2018,5.5,1703,1802,99
53013,WA,Columbia,,2019,5.5,1737,1838,101
53013,WA,Columbia,,2020,7,1661,1786,125
53013,WA,Columbia,,2021,5.2,1718,1813,95
53015,WA,Cowlitz,,2007,6.9,40718,43743,3025
53015,WA,Cowlitz,,2008,8.5,40550,44306,3756
53015,WA,Cowlitz,,2009,12.5,38406,43883,5477
53015,WA,Cowlitz,,2010,11.7,40039,45349,5310
53015,WA,Cowlitz,,2011,10.7,39466,44216,4750
53015,WA,Cowlitz,,2012,9.8,39950,44297,4347
53015,WA,Cowlitz,,2013,9.6,39108,43270,4162
53015,WA,Cowlitz,,2014,7.8,40120,43534,3414
53015,WA,Cowlitz,,2015,7.5,40793,44093,3300
53015,WA,Cowlitz,,2016,7.1,41712,44876,3164
53015,WA,Cowlitz,,2017,6,43184,45930,2746
53015,WA,Cowlitz,,2018,5.9,43845,46590,2745
53015,WA,Cowlitz,,2019,6.1,45512,48468,2956
53015,WA,Cowlitz,,2020,9.1,44453,48928,4475
53015,WA,Cowlitz,,2021,6.4,45358,48443,3085
53017,WA,Douglas,,2007,5.2,19849,20929,1080
53017,WA,Douglas,,2008,5.5,20003,21174,1171
53017,WA,Douglas,,2009,7.4,20100,21711,1611
53017,WA,Douglas,,2010,8.8,17769,19478,1709
53017,WA,Douglas,,2011,8.5,17487,19104,1617
53017,WA,Douglas,,2012,8.3,17583,19181,1598
53017,WA,Douglas,,2013,8.1,17362,18895,1533
53017,WA,Douglas,,2014,6.9,17961,19292,1331
53017,WA,Douglas,,2015,6.2,18547,19772,1225
53017,WA,Douglas,,2016,6.8,19154,20545,1391
53017,WA,Douglas,,2017,5.6,20021,21201,1180
53017,WA,Douglas,,2018,5.3,20718,21874,1156
53017,WA,Douglas,,2019,5.7,21063,22336,1273
53017,WA,Douglas,,2020,8.3,19783,21571,1788
53017,WA,Douglas,,2021,5.5,20745,21948,1203
53019,WA,Ferry,,2007,8.7,2711,2969,258
53019,WA,Ferry,,2008,9.2,2718,2993,275
53019,WA,Ferry,,2009,12.4,2635,3007,372
53019,WA,Ferry,,2010,16,2160,2571,411
53019,WA,Ferry,,2011,15.8,2090,2481,391
53019,WA,Ferry,,2012,14.4,2069,2418,349
53019,WA,Ferry,,2013,13.2,2152,2480,328
53019,WA,Ferry,,2014,11.1,2174,2445,271
53019,WA,Ferry,,2015,9.9,2228,2472,244
53019,WA,Ferry,,2016,10.1,2240,2493,253
53019,WA,Ferry,,2017,10.9,2248,2522,274
53019,WA,Ferry,,2018,11.5,2230,2521,291
53019,WA,Ferry,,2019,11.4,2243,2533,290
53019,WA,Ferry,,2020,11.6,2151,2432,281
53019,WA,Ferry,,2021,8.9,2121,2327,206
53021,WA,Franklin,,2007,6.8,30205,32414,2209
53021,WA,Franklin,,2008,6.4,31911,34094,2183
53021,WA,Franklin,,2009,7.8,33192,35989,2797
53021,WA,Franklin,,2010,8,34543,37530,2987
53021,WA,Franklin,,2011,8.1,35227,38342,3115
53021,WA,Franklin,,2012,8.9,35508,38976,3468
53021,WA,Franklin,,2013,9.2,34802,38342,3540
53021,WA,Franklin,,2014,8.1,34902,37979,3077
53021,WA,Franklin,,2015,7.4,36088,38958,2870
53021,WA,Franklin,,2016,7.3,36952,39864,2912
53021,WA,Franklin,,2017,6.2,38334,40886,2552
53021,WA,Franklin,,2018,6.1,39356,41895,2539
53021,WA,Franklin,,2019,6.5,40623,43462,2839
53021,WA,Franklin,,2020,8.7,40032,43838,3806
53021,WA,Franklin,,2021,6.6,40954,43835,2881
53023,WA,Garfield,,2007,5.3,963,1017,54
53023,WA,Garfield,,2008,4.8,972,1021,49
53023,WA,Garfield,,2009,6.7,939,1006,67
53023,WA,Garfield,,2010,7.4,964,1041,77
53023,WA,Garfield,,2011,6.8,953,1023,70
53023,WA,Garfield,,2012,7,946,1017,71
53023,WA,Garfield,,2013,7.2,913,984,71
53023,WA,Garfield,,2014,6.5,897,959,62
53023,WA,Garfield,,2015,6,874,930,56
53023,WA,Garfield,,2016,5.8,867,920,53
53023,WA,Garfield,,2017,5.3,861,909,48
53023,WA,Garfield,,2018,5.7,858,910,52
53023,WA,Garfield,,2019,5.7,865,917,52
53023,WA,Garfield,,2020,8.5,746,815,69
53023,WA,Garfield,,2021,5.8,773,821,48
53025,WA,Grant,,2007,6.4,37898,40473,2575
53025,WA,Grant,,2008,6.7,38173,40910,2737
53025,WA,Grant,,2009,9.2,37603,41414,3811
53025,WA,Grant,,2010,9.9,38144,42318,4174
53025,WA,Grant,,2011,9.1,38492,42352,3860
53025,WA,Grant,,2012,8.7,39903,43708,3805
53025,WA,Grant,,2013,8.5,40239,43959,3720
53025,WA,Grant,,2014,7.2,41532,44765,3233
53025,WA,Grant,,2015,7.1,41531,44688,3157
53025,WA,Grant,,2016,7,41462,44585,3123
53025,WA,Grant,,2017,6.2,42534,45324,2790
53025,WA,Grant,,2018,6.2,43883,46785,2902
53025,WA,Grant,,2019,6.9,44452,47768,3316
53025,WA,Grant,,2020,8.8,42845,46989,4144
53025,WA,Grant,,2021,6.6,44357,47490,3133
53027,WA,Grays Harbor,,2007,7.7,28994,31429,2435
53027,WA,Grays Harbor,,2008,8,29287,31850,2563
53027,WA,Grays Harbor,,2009,12.3,27029,30818,3789
53027,WA,Grays Harbor,,2010,12.6,26460,30288,3828
53027,WA,Grays Harbor,,2011,12.3,25687,29276,3589
53027,WA,Grays Harbor,,2012,11.9,25229,28650,3421
53027,WA,Grays Harbor,,2013,11.6,24810,28081,3271
53027,WA,Grays Harbor,,2014,9.9,24462,27137,2675
53027,WA,Grays Harbor,,2015,8.8,24532,26897,2365
53027,WA,Grays Harbor,,2016,8.2,25019,27256,2237
53027,WA,Grays Harbor,,2017,7,26015,27960,1945
53027,WA,Grays Harbor,,2018,6.7,26508,28408,1900
53027,WA,Grays Harbor,,2019,7.2,27140,29252,2112
53027,WA,Grays Harbor,,2020,11.7,25357,28733,3376
53027,WA,Grays Harbor,,2021,7.8,26828,29083,2255
53029,WA,Island,,2007,5.4,31147,32933,1786
53029,WA,Island,,2008,5.7,31166,33049,1883
53029,WA,Island,,2009,8.3,29635,32300,2665
53029,WA,Island,,2010,8.4,30364,33158,2794
53029,WA,Island,,2011,8.1,29702,32336,2634
53029,WA,Island,,2012,7.5,29998,32416,2418
53029,WA,Island,,2013,7.3,29438,31749,2311
53029,WA,Island,,2014,6.4,29643,31680,2037
53029,WA,Island,,2015,5.9,29885,31766,1881
53029,WA,Island,,2016,5.8,30860,32764,1904
53029,WA,Island,,2017,5.1,32360,34102,1742
53029,WA,Island,,2018,5.2,33058,34869,1811
53029,WA,Island,,2019,5.2,34454,36329,1875
53029,WA,Island,,2020,8.2,33268,36239,2971
53029,WA,Island,,2021,5.6,34466,36507,2041
53031,WA,Jefferson,,2007,5.2,12966,13678,712
53031,WA,Jefferson,,2008,5.8,12915,13706,791
53031,WA,Jefferson,,2009,8.3,11826,12891,1065
53031,WA,Jefferson,,2010,9.3,11324,12492,1168
53031,WA,Jefferson,,2011,9.4,10819,11945,1126
53031,WA,Jefferson,,2012,9.1,10783,11867,1084
53031,WA,Jefferson,,2013,9.2,10360,11407,1047
53031,WA,Jefferson,,2014,7.8,10304,11175,871
53031,WA,Jefferson,,2015,6.9,10422,11196,774
53031,WA,Jefferson,,2016,7,10714,11516,802
53031,WA,Jefferson,,2017,6,11249,11968,719
53031,WA,Jefferson,,2018,5.7,11628,12337,709
53031,WA,Jefferson,,2019,5.8,12249,13000,751
53031,WA,Jefferson,,2020,9.5,11686,12908,1222
53031,WA,Jefferson,,2021,6.2,12008,12802,794
53033,WA,King,,2007,3.1,1034460,1067828,33368
53033,WA,King,,2008,3.8,1047485,1088536,41051
53033,WA,King,,2009,7,1017652,1094788,77136
53033,WA,King,,2010,8.4,1005539,1097736,92197
53033,WA,King,,2011,7.5,1023172,1106635,83463
53033,WA,King,,2012,6.3,1056990,1127689,70699
53033,WA,King,,2013,4.4,1086876,1137057,50181
53033,WA,King,,2014,4.5,1112394,1164823,52429
53033,WA,King,,2015,4.1,1136052,1185074,49022
53033,WA,King,,2016,3.8,1166951,1213173,46222
53033,WA,King,,2017,3.6,1187422,1231166,43744
53033,WA,King,,2018,3.3,1218696,1260655,41959
53033,WA,King,,2019,2.7,1250766,1285974,35208
53033,WA,King,,2020,7.8,1178362,1278594,100232
53033,WA,King,,2021,4.3,1223432,1278003,54571
53035,WA,Kitsap,,2007,4.8,116957,122892,5935
53035,WA,Kitsap,,2008,5.2,118252,124727,6475
53035,WA,Kitsap,,2009,7.1,114167,122953,8786
53035,WA,Kitsap,,2010,7.8,109149,118347,9198
53035,WA,Kitsap,,2011,7.5,107556,116334,8778
53035,WA,Kitsap,,2012,7.2,107371,115743,8372
53035,WA,Kitsap,,2013,7.1,105576,113595,8019
53035,WA,Kitsap,,2014,5.9,106681,113427,6746
53035,WA,Kitsap,,2015,5.4,109174,115388,6214
53035,WA,Kitsap,,2016,5.5,111789,118285,6496
53035,WA,Kitsap,,2017,4.8,115114,120912,5798
53035,WA,Kitsap,,2018,4.6,118498,124212,5714
53035,WA,Kitsap,,2019,4.7,123742,129785,6043
53035,WA,Kitsap,,2020,7.7,118545,128417,9872
53035,WA,Kitsap,,2021,5,121720,128186,6466
53037,WA,Kittitas,,2007,5.3,19264,20337,1073
53037,WA,Kittitas,,2008,6.1,19649,20935,1286
53037,WA,Kittitas,,2009,8.4,18746,20476,1730
53037,WA,Kittitas,,2010,8.8,19034,20882,1848
53037,WA,Kittitas,,2011,8.3,18856,20569,1713
53037,WA,Kittitas,,2012,8.1,18848,20499,1651
53037,WA,Kittitas,,2013,7.6,18651,20189,1538
53037,WA,Kittitas,,2014,6.7,18810,20169,1359
53037,WA,Kittitas,,2015,6,19591,20846,1255
53037,WA,Kittitas,,2016,5.9,20286,21549,1263
53037,WA,Kittitas,,2017,5.2,21191,22362,1171
53037,WA,Kittitas,,2018,5.4,20949,22154,1205
53037,WA,Kittitas,,2019,5.5,22546,23853,1307
53037,WA,Kittitas,,2020,8.9,20321,22318,1997
53037,WA,Kittitas,,2021,6.3,20406,21787,1381
53039,WA,Klickitat,,2007,7.3,9027,9739,712
53039,WA,Klickitat,,2008,7.9,9363,10162,799
53039,WA,Klickitat,,2009,9.7,9632,10661,1029
53039,WA,Klickitat,,2010,11,8980,10094,1114
53039,WA,Klickitat,,2011,10.6,8966,10033,1067
53039,WA,Klickitat,,2012,9.4,8957,9884,927
53039,WA,Klickitat,,2013,9.2,8813,9707,894
53039,WA,Klickitat,,2014,7.5,8848,9567,719
53039,WA,Klickitat,,2015,7,8796,9454,658
53039,WA,Klickitat,,2016,6.7,9002,9649,647
53039,WA,Klickitat,,2017,5.9,9350,9931,581
53039,WA,Klickitat,,2018,5.6,9577,10149,572
53039,WA,Klickitat,,2019,6,9767,10388,621
53039,WA,Klickitat,,2020,8.2,8941,9738,797
53039,WA,Klickitat,,2021,6,9495,10105,610
53041,WA,Lewis,,2007,7.7,28760,31159,2399
53041,WA,Lewis,,2008,8.5,28788,31475,2687
53041,WA,Lewis,,2009,12.3,27173,30994,3821
53041,WA,Lewis,,2010,11.9,29213,33162,3949
53041,WA,Lewis,,2011,11.5,28412,32103,3691
53041,WA,Lewis,,2012,11,28485,32009,3524
53041,WA,Lewis,,2013,10.4,28070,31311,3241
53041,WA,Lewis,,2014,8.8,27793,30479,2686
53041,WA,Lewis,,2015,8.2,28657,31203,2546
53041,WA,Lewis,,2016,7.7,29483,31938,2455
53041,WA,Lewis,,2017,6.5,31087,33251,2164
53041,WA,Lewis,,2018,6.2,31989,34120,2131
53041,WA,Lewis,,2019,6.3,33050,35263,2213
53041,WA,Lewis,,2020,9.4,31557,34813,3256
53041,WA,Lewis,,2021,6.3,32614,34798,2184
53043,WA,Lincoln,,2007,5.7,4428,4697,269
53043,WA,Lincoln,,2008,5.7,4551,4825,274
53043,WA,Lincoln,,2009,7.9,4380,4757,377
53043,WA,Lincoln,,2010,7.5,4832,5226,394
53043,WA,Lincoln,,2011,7.3,4872,5253,381
53043,WA,Lincoln,,2012,6.6,4882,5229,347
53043,WA,Lincoln,,2013,6.7,4745,5086,341
53043,WA,Lincoln,,2014,5.6,4749,5031,282
53043,WA,Lincoln,,2015,5.7,4601,4877,276
53043,WA,Lincoln,,2016,5.5,4626,4894,268
53043,WA,Lincoln,,2017,4.9,4730,4972,242
53043,WA,Lincoln,,2018,4.8,4857,5104,247
53043,WA,Lincoln,,2019,5.1,4831,5092,261
53043,WA,Lincoln,,2020,6.7,4367,4680,313
53043,WA,Lincoln,,2021,4.9,4462,4691,229
53045,WA,Mason,,2007,6.4,23541,25152,1611
53045,WA,Mason,,2008,7.3,23625,25494,1869
53045,WA,Mason,,2009,10,22473,24966,2493
53045,WA,Mason,,2010,10.8,21748,24392,2644
53045,WA,Mason,,2011,10.6,21022,23508,2486
53045,WA,Mason,,2012,10,21067,23413,2346
53045,WA,Mason,,2013,9.8,21048,23335,2287
53045,WA,Mason,,2014,8.1,21213,23090,1877
53045,WA,Mason,,2015,7.6,21259,23007,1748
53045,WA,Mason,,2016,7.4,21769,23519,1750
53045,WA,Mason,,2017,6.5,22345,23892,1547
53045,WA,Mason,,2018,6.3,23041,24587,1546
53045,WA,Mason,,2019,6.4,23846,25490,1644
53045,WA,Mason,,2020,9.8,22935,25435,2500
53045,WA,Mason,,2021,7,23362,25112,1750
53047,WA,Okanogan,,2007,6.9,19189,20606,1417
53047,WA,Okanogan,,2008,6.7,19930,21370,1440
53047,WA,Okanogan,,2009,8.9,19729,21665,1936
53047,WA,Okanogan,,2010,9.7,19753,21876,2123
53047,WA,Okanogan,,2011,9.2,19160,21111,1951
53047,WA,Okanogan,,2012,8.7,19218,21045,1827
53047,WA,Okanogan,,2013,8.4,19212,20976,1764
53047,WA,Okanogan,,2014,6.9,19804,21276,1472
53047,WA,Okanogan,,2015,6.7,19803,21230,1427
53047,WA,Okanogan,,2016,6.5,20015,21415,1400
53047,WA,Okanogan,,2017,6.7,19611,21018,1407
53047,WA,Okanogan,,2018,6.4,19399,20728,1329
53047,WA,Okanogan,,2019,6.8,19241,20655,1414
53047,WA,Okanogan,,2020,8.9,17729,19464,1735
53047,WA,Okanogan,,2021,6.6,18246,19538,1292
53049,WA,Pacific,,2007,7.4,8589,9277,688
53049,WA,Pacific,,2008,7.9,8475,9203,728
53049,WA,Pacific,,2009,11.9,7994,9073,1079
53049,WA,Pacific,,2010,12.7,7483,8574,1091
53049,WA,Pacific,,2011,12.1,7119,8103,984
53049,WA,Pacific,,2012,11.1,7235,8136,901
53049,WA,Pacific,,2013,11.1,7103,7986,883
53049,WA,Pacific,,2014,9.6,7084,7838,754
53049,WA,Pacific,,2015,8.7,7385,8091,706
53049,WA,Pacific,,2016,7.9,7637,8295,658
53049,WA,Pacific,,2017,6.9,7793,8375,582
53049,WA,Pacific,,2018,6.9,7881,8461,580
53049,WA,Pacific,,2019,7.1,8012,8628,616
53049,WA,Pacific,,2020,11,7385,8296,911
53049,WA,Pacific,,2021,7.9,7894,8569,675
53051,WA,Pend Oreille,,2007,7.7,4874,5281,407
53051,WA,Pend Oreille,,2008,8.9,5025,5516,491
53051,WA,Pend Oreille,,2009,13.6,4695,5431,736
53051,WA,Pend Oreille,,2010,13.9,4316,5014,698
53051,WA,Pend Oreille,,2011,12.7,4184,4790,606
53051,WA,Pend Oreille,,2012,11.7,4216,4776,560
53051,WA,Pend Oreille,,2013,11.7,4128,4674,546
53051,WA,Pend Oreille,,2014,9.7,4125,4570,445
53051,WA,Pend Oreille,,2015,9.4,4165,4596,431
53051,WA,Pend Oreille,,2016,8.8,4254,4663,409
53051,WA,Pend Oreille,,2017,7.3,4405,4752,347
53051,WA,Pend Oreille,,2018,7.1,4525,4871,346
53051,WA,Pend Oreille,,2019,8.1,4687,5098,411
53051,WA,Pend Oreille,,2020,10.1,4652,5175,523
53051,WA,Pend Oreille,,2021,7.6,4747,5138,391
53053,WA,Pierce,,2007,5.2,366729,386920,20191
53053,WA,Pierce,,2008,5.9,370985,394313,23328
53053,WA,Pierce,,2009,9,353966,388901,34935
53053,WA,Pierce,,2010,9.5,351104,387830,36726
53053,WA,Pierce,,2011,9.1,348050,382903,34853
53053,WA,Pierce,,2012,8.5,352308,385098,32790
53053,WA,Pierce,,2013,8.1,352522,383769,31247
53053,WA,Pierce,,2014,6.8,358653,384834,26181
53053,WA,Pierce,,2015,6.2,367880,392279,24399
53053,WA,Pierce,,2016,5.9,380954,404970,24016
53053,WA,Pierce,,2017,5.3,395846,417889,22043
53053,WA,Pierce,,2018,5.1,406220,428250,22030
53053,WA,Pierce,,2019,5.2,423850,447296,23446
53053,WA,Pierce,,2020,9.5,410559,453641,43082
53053,WA,Pierce,,2021,6.1,421606,448785,27179
53055,WA,San Juan,,2007,3.8,8158,8477,319
53055,WA,San Juan,,2008,3.9,8430,8769,339
53055,WA,San Juan,,2009,6.2,7820,8337,517
53055,WA,San Juan,,2010,6.6,7754,8302,548
53055,WA,San Juan,,2011,6.5,7485,8005,520
53055,WA,San Juan,,2012,5.9,7614,8089,475
53055,WA,San Juan,,2013,5.8,7329,7784,455
53055,WA,San Juan,,2014,4.9,7311,7684,373
53055,WA,San Juan,,2015,4.7,7363,7724,361
53055,WA,San Juan,,2016,4.6,7518,7879,361
53055,WA,San Juan,,2017,3.9,7909,8229,320
53055,WA,San Juan,,2018,3.9,8007,8330,323
53055,WA,San Juan,,2019,3.9,8398,8737,339
53055,WA,San Juan,,2020,8.1,7467,8126,659
53055,WA,San Juan,,2021,5,7959,8376,417
53057,WA,Skagit,,2007,5.2,54864,57865,3001
53057,WA,Skagit,,2008,5.9,55270,58746,3476
53057,WA,Skagit,,2009,9.4,51882,57257,5375
53057,WA,Skagit,,2010,9.9,52141,57861,5720
53057,WA,Skagit,,2011,9.5,51172,56527,5355
53057,WA,Skagit,,2012,8.8,51805,56829,5024
53057,WA,Skagit,,2013,8.4,51920,56680,4760
53057,WA,Skagit,,2014,7,52423,56370,3947
53057,WA,Skagit,,2015,6.6,52969,56687,3718
53057,WA,Skagit,,2016,6.4,54287,58012,3725
53057,WA,Skagit,,2017,5.4,56407,59620,3213
53057,WA,Skagit,,2018,5.2,57759,60906,3147
53057,WA,Skagit,,2019,5.5,60383,63910,3527
53057,WA,Skagit,,2020,9.6,57472,63553,6081
53057,WA,Skagit,,2021,6.3,58077,61981,3904
53059,WA,Skamania,,2007,7.3,4681,5050,369
53059,WA,Skamania,,2008,8.9,4693,5149,456
53059,WA,Skamania,,2009,12.2,4386,4993,607
53059,WA,Skamania,,2010,11.6,4470,5059,589
53059,WA,Skamania,,2011,11,4466,5018,552
53059,WA,Skamania,,2012,9.7,4520,5005,485
53059,WA,Skamania,,2013,9.8,4505,4992,487
53059,WA,Skamania,,2014,8,4542,4936,394
53059,WA,Skamania,,2015,7.2,4591,4946,355
53059,WA,Skamania,,2016,6.8,4731,5078,347
53059,WA,Skamania,,2017,6,4994,5313,319
53059,WA,Skamania,,2018,5.5,5085,5383,298
53059,WA,Skamania,,2019,5.5,5366,5678,312
53059,WA,Skamania,,2020,9.2,4956,5457,501
53059,WA,Skamania,,2021,6.4,5161,5511,350
53061,WA,Snohomish,,2007,3.5,350897,363448,12551
53061,WA,Snohomish,,2008,4.4,355754,372224,16470
53061,WA,Snohomish,,2009,8.3,343643,374720,31077
53061,WA,Snohomish,,2010,9.9,345153,383222,38069
53061,WA,Snohomish,,2011,9,348470,383026,34556
53061,WA,Snohomish,,2012,7.4,358508,387127,28619
53061,WA,Snohomish,,2013,5.1,368625,388242,19617
53061,WA,Snohomish,,2014,5,377774,397747,19973
53061,WA,Snohomish,,2015,4.5,385767,404003,18236
53061,WA,Snohomish,,2016,4.2,397875,415292,17417
53061,WA,Snohomish,,2017,3.9,404794,421436,16642
53061,WA,Snohomish,,2018,3.6,413908,429470,15562
53061,WA,Snohomish,,2019,3,424765,437889,13124
53061,WA,Snohomish,,2020,8.8,400158,438858,38700
53061,WA,Snohomish,,2021,5,415354,437145,21791
53063,WA,Spokane,,2007,5.2,221229,233409,12180
53063,WA,Spokane,,2008,5.8,225197,239134,13937
53063,WA,Spokane,,2009,8.6,214705,234821,20116
53063,WA,Spokane,,2010,9.1,212013,233321,21308
53063,WA,Spokane,,2011,8.7,208676,228524,19848
53063,WA,Spokane,,2012,8.3,210343,229378,19035
53063,WA,Spokane,,2013,8,209018,227147,18129
53063,WA,Spokane,,2014,6.8,209870,225104,15234
53063,WA,Spokane,,2015,6.3,213461,227863,14402
53063,WA,Spokane,,2016,6,220625,234673,14048
53063,WA,Spokane,,2017,5.3,227979,240744,12765
53063,WA,Spokane,,2018,5.2,233903,246687,12784
53063,WA,Spokane,,2019,5.3,244022,257815,13793
53063,WA,Spokane,,2020,8.4,242217,264531,22314
53063,WA,Spokane,,2021,5.4,246886,260902,14016
53065,WA,Stevens,,2007,7.8,17144,18598,1454
53065,WA,Stevens,,2008,8.3,17303,18862,1559
53065,WA,Stevens,,2009,12.2,16269,18521,2252
53065,WA,Stevens,,2010,11.9,16441,18655,2214
53065,WA,Stevens,,2011,11.1,16049,18060,2011
53065,WA,Stevens,,2012,10.8,16143,18099,1956
53065,WA,Stevens,,2013,10.6,15832,17708,1876
53065,WA,Stevens,,2014,9.1,15788,17361,1573
53065,WA,Stevens,,2015,8.7,15924,17432,1508
53065,WA,Stevens,,2016,8.1,16446,17894,1448
53065,WA,Stevens,,2017,7.2,16868,18168,1300
53065,WA,Stevens,,2018,7.1,17176,18484,1308
53065,WA,Stevens,,2019,7.1,17813,19182,1369
53065,WA,Stevens,,2020,9,17374,19102,1728
53065,WA,Stevens,,2021,6.7,17738,19010,1272
53067,WA,Thurston,,2007,4.8,121714,127860,6146
53067,WA,Thurston,,2008,5.2,124703,131604,6901
53067,WA,Thurston,,2009,7.3,119725,129173,9448
53067,WA,Thurston,,2010,8.1,114417,124535,10118
53067,WA,Thurston,,2011,8.1,112328,122196,9868
53067,WA,Thurston,,2012,7.7,113263,122762,9499
53067,WA,Thurston,,2013,7.4,113589,122701,9112
53067,WA,Thurston,,2014,6.3,115445,123222,7777
53067,WA,Thurston,,2015,5.8,118488,125761,7273
53067,WA,Thurston,,2016,5.6,122677,129896,7219
53067,WA,Thurston,,2017,4.9,128322,134916,6594
53067,WA,Thurston,,2018,4.7,132256,138851,6595
53067,WA,Thurston,,2019,4.9,137010,144136,7126
53067,WA,Thurston,,2020,8,135613,147482,11869
53067,WA,Thurston,,2021,5.2,137708,145252,7544
53069,WA,Wahkiakum,,2007,7.2,1544,1664,120
53069,WA,Wahkiakum,,2008,7.5,1638,1771,133
53069,WA,Wahkiakum,,2009,13.5,1370,1583,213
53069,WA,Wahkiakum,,2010,13.9,1235,1434,199
53069,WA,Wahkiakum,,2011,12.9,1225,1407,182
53069,WA,Wahkiakum,,2012,11.7,1206,1366,160
53069,WA,Wahkiakum,,2013,11.8,1140,1292,152
53069,WA,Wahkiakum,,2014,9.4,1154,1274,120
53069,WA,Wahkiakum,,2015,8.7,1179,1291,112
53069,WA,Wahkiakum,,2016,8.5,1179,1289,110
53069,WA,Wahkiakum,,2017,7.1,1217,1310,93
53069,WA,Wahkiakum,,2018,6.6,1251,1340,89
53069,WA,Wahkiakum,,2019,6.7,1296,1389,93
53069,WA,Wahkiakum,,2020,8.7,1273,1394,121
53069,WA,Wahkiakum,,2021,6.6,1267,1357,90
53071,WA,Walla Walla,,2007,5.3,27600,29136,1536
53071,WA,Walla Walla,,2008,5.1,28881,30427,1546
53071,WA,Walla Walla,,2009,6.3,28591,30518,1927
53071,WA,Walla Walla,,2010,7.2,27811,29975,2164
53071,WA,Walla Walla,,2011,7.2,27274,29382,2108
53071,WA,Walla Walla,,2012,6.8,27472,29483,2011
53071,WA,Walla Walla,,2013,7,26425,28404,1979
53071,WA,Walla Walla,,2014,6,26722,28420,1698
53071,WA,Walla Walla,,2015,5.7,26459,28056,1597
53071,WA,Walla Walla,,2016,5.3,27206,28734,1528
53071,WA,Walla Walla,,2017,4.9,27577,28990,1413
53071,WA,Walla Walla,,2018,4.7,28136,29520,1384
53071,WA,Walla Walla,,2019,5,28984,30506,1522
53071,WA,Walla Walla,,2020,6.6,28997,31044,2047
53071,WA,Walla Walla,,2021,4.6,30137,31593,1456
53073,WA,Whatcom,,2007,4.6,101362,106236,4874
53073,WA,Whatcom,,2008,5.2,103050,108685,5635
53073,WA,Whatcom,,2009,7.9,97426,105730,8304
53073,WA,Whatcom,,2010,8.6,93541,102301,8760
53073,WA,Whatcom,,2011,8.1,93557,101769,8212
53073,WA,Whatcom,,2012,7.5,95113,102772,7659
53073,WA,Whatcom,,2013,7.3,94643,102057,7414
53073,WA,Whatcom,,2014,6.4,94713,101159,6446
53073,WA,Whatcom,,2015,5.8,98270,104286,6016
53073,WA,Whatcom,,2016,5.7,101059,107213,6154
53073,WA,Whatcom,,2017,4.9,105060,110492,5432
53073,WA,Whatcom,,2018,4.7,107001,112320,5319
53073,WA,Whatcom,,2019,5.1,110694,116635,5941
53073,WA,Whatcom,,2020,9.1,106333,116973,10640
53073,WA,Whatcom,,2021,6,106929,113751,6822
53075,WA,Whitman,,2007,4.2,19432,20280,848
53075,WA,Whitman,,2008,4.2,20345,21246,901
53075,WA,Whitman,,2009,5.2,20298,21421,1123
53075,WA,Whitman,,2010,6.1,20772,22111,1339
53075,WA,Whitman,,2011,5.8,21068,22366,1298
53075,WA,Whitman,,2012,6,21024,22372,1348
53075,WA,Whitman,,2013,5.9,20894,22205,1311
53075,WA,Whitman,,2014,5.1,21009,22132,1123
53075,WA,Whitman,,2015,4.7,21694,22767,1073
53075,WA,Whitman,,2016,4.9,21989,23132,1143
53075,WA,Whitman,,2017,4.3,22413,23423,1010
53075,WA,Whitman,,2018,4.4,22652,23687,1035
53075,WA,Whitman,,2019,4.4,23347,24433,1086
53075,WA,Whitman,,2020,5.7,20921,22190,1269
53075,WA,Whitman,,2021,4.5,21370,22366,996
53077,WA,Yakima,,2007,6.9,111701,119936,8235
53077,WA,Yakima,,2008,7.2,114367,123195,8828
53077,WA,Yakima,,2009,8.3,113028,123294,10266
53077,WA,Yakima,,2010,9.6,108095,119568,11473
53077,WA,Yakima,,2011,9.7,107479,118970,11491
53077,WA,Yakima,,2012,9.7,108705,120381,11676
53077,WA,Yakima,,2013,9.8,107243,118863,11620
53077,WA,Yakima,,2014,8.4,109163,119231,10068
53077,WA,Yakima,,2015,7.8,112179,121715,9536
53077,WA,Yakima,,2016,7.4,116529,125890,9361
53077,WA,Yakima,,2017,6.7,117646,126111,8465
53077,WA,Yakima,,2018,6.3,121562,129750,8188
53077,WA,Yakima,,2019,7.1,123998,133513,9515
53077,WA,Yakima,,2020,9.4,120855,133379,12524
53077,WA,Yakima,,2021,7,122071,131217,9146
54000,WV,West Virginia,,2007,4.8,765517,804305,38788
54000,WV,West Virginia,,2008,4.7,768294,806254,37960
54000,WV,West Virginia,,2009,8.3,743870,811270,67400
54000,WV,West Virginia,,2010,8.7,739891,810101,70210
54000,WV,West Virginia,,2011,7.8,743346,806568,63222
54000,WV,West Virginia,,2012,7.2,749587,808022,58435
54000,WV,West Virginia,,2013,6.7,745849,799481,53632
54000,WV,West Virginia,,2014,6.5,743955,795733,51778
54000,WV,West Virginia,,2015,6.6,739455,791526,52071
54000,WV,West Virginia,,2016,6.1,737205,785104,47899
54000,WV,West Virginia,,2017,5.2,743786,784744,40958
54000,WV,West Virginia,,2018,5.2,752726,793715,40989
54000,WV,West Virginia,,2019,4.9,757484,796776,39292
54000,WV,West Virginia,,2020,8.2,719175,783027,63852
54000,WV,West Virginia,,2021,5,749132,788826,39694
54001,WV,Barbour,,2007,5.7,6297,6681,384
54001,WV,Barbour,,2008,5.3,6318,6671,353
54001,WV,Barbour,,2009,9.4,6216,6859,643
54001,WV,Barbour,,2010,10.1,6171,6863,692
54001,WV,Barbour,,2011,9.1,6153,6771,618
54001,WV,Barbour,,2012,8,6186,6727,541
54001,WV,Barbour,,2013,7.1,6242,6716,474
54001,WV,Barbour,,2014,6.6,6432,6888,456
54001,WV,Barbour,,2015,7.2,6476,6979,503
54001,WV,Barbour,,2016,6.8,6508,6983,475
54001,WV,Barbour,,2017,5.8,6454,6854,400
54001,WV,Barbour,,2018,5.9,6522,6932,410
54001,WV,Barbour,,2019,6,6772,7201,429
54001,WV,Barbour,,2020,8.1,6611,7196,585
54001,WV,Barbour,,2021,5.3,6786,7165,379
54003,WV,Berkeley,,2007,4.3,43619,45592,1973
54003,WV,Berkeley,,2008,5.2,43729,46105,2376
54003,WV,Berkeley,,2009,9.1,42201,46436,4235
54003,WV,Berkeley,,2010,8.6,46578,50958,4380
54003,WV,Berkeley,,2011,7.5,47346,51171,3825
54003,WV,Berkeley,,2012,6.4,48918,52283,3365
54003,WV,Berkeley,,2013,5.6,49687,52621,2934
54003,WV,Berkeley,,2014,5.4,50199,53053,2854
54003,WV,Berkeley,,2015,4.8,51968,54578,2610
54003,WV,Berkeley,,2016,4,52110,54260,2150
54003,WV,Berkeley,,2017,3.6,54471,56532,2061
54003,WV,Berkeley,,2018,4,55703,58029,2326
54003,WV,Berkeley,,2019,3.6,56939,59048,2109
54003,WV,Berkeley,,2020,6.1,54586,58110,3524
54003,WV,Berkeley,,2021,3.6,57999,60140,2141
54005,WV,Boone,,2007,5,8909,9374,465
54005,WV,Boone,,2008,4.2,8946,9341,395
54005,WV,Boone,,2009,8.3,8569,9349,780
54005,WV,Boone,,2010,8.8,8024,8800,776
54005,WV,Boone,,2011,7.8,7995,8676,681
54005,WV,Boone,,2012,10.1,8018,8914,896
54005,WV,Boone,,2013,9.5,7842,8662,820
54005,WV,Boone,,2014,9.1,7725,8499,774
54005,WV,Boone,,2015,9.5,7490,8277,787
54005,WV,Boone,,2016,9.1,7284,8014,730
54005,WV,Boone,,2017,6.4,7112,7600,488
54005,WV,Boone,,2018,6,7067,7520,453
54005,WV,Boone,,2019,5.5,6982,7387,405
54005,WV,Boone,,2020,10.3,6606,7361,755
54005,WV,Boone,,2021,6.1,6818,7259,441
54007,WV,Braxton,,2007,5.8,5626,5971,345
54007,WV,Braxton,,2008,5.6,5546,5872,326
54007,WV,Braxton,,2009,8.9,5402,5928,526
54007,WV,Braxton,,2010,11.1,5049,5679,630
54007,WV,Braxton,,2011,10.8,4894,5488,594
54007,WV,Braxton,,2012,10.4,4840,5404,564
54007,WV,Braxton,,2013,10.2,4792,5335,543
54007,WV,Braxton,,2014,9.3,4784,5273,489
54007,WV,Braxton,,2015,8.7,5042,5523,481
54007,WV,Braxton,,2016,8.8,5026,5509,483
54007,WV,Braxton,,2017,7.5,4886,5283,397
54007,WV,Braxton,,2018,7,4791,5149,358
54007,WV,Braxton,,2019,7.4,4852,5242,390
54007,WV,Braxton,,2020,10.1,4672,5195,523
54007,WV,Braxton,,2021,6.7,4753,5097,344
54009,WV,Brooke,,2007,6.3,10185,10864,679
54009,WV,Brooke,,2008,6.2,10380,11065,685
54009,WV,Brooke,,2009,11.8,9811,11124,1313
54009,WV,Brooke,,2010,11.5,9659,10909,1250
54009,WV,Brooke,,2011,9.5,9685,10703,1018
54009,WV,Brooke,,2012,8.4,9747,10646,899
54009,WV,Brooke,,2013,7.6,9591,10383,792
54009,WV,Brooke,,2014,7.1,9473,10199,726
54009,WV,Brooke,,2015,7.1,9475,10204,729
54009,WV,Brooke,,2016,7.1,9306,10012,706
54009,WV,Brooke,,2017,6.1,9236,9835,599
54009,WV,Brooke,,2018,6,9357,9954,597
54009,WV,Brooke,,2019,5.2,9468,9988,520
54009,WV,Brooke,,2020,8.7,8899,9752,853
54009,WV,Brooke,,2021,6.1,9336,9939,603
54011,WV,Cabell,,2007,4.3,43314,45255,1941
54011,WV,Cabell,,2008,4.2,43159,45046,1887
54011,WV,Cabell,,2009,7.2,41308,44521,3213
54011,WV,Cabell,,2010,7.2,40108,43230,3122
54011,WV,Cabell,,2011,6.9,39927,42907,2980
54011,WV,Cabell,,2012,6.3,40347,43059,2712
54011,WV,Cabell,,2013,5.7,40033,42456,2423
54011,WV,Cabell,,2014,5.4,40245,42541,2296
54011,WV,Cabell,,2015,5.3,39572,41790,2218
54011,WV,Cabell,,2016,4.8,39356,41349,1993
54011,WV,Cabell,,2017,4.6,39869,41770,1901
54011,WV,Cabell,,2018,4.7,39497,41426,1929
54011,WV,Cabell,,2019,4.2,39714,41444,1730
54011,WV,Cabell,,2020,7.8,38200,41429,3229
54011,WV,Cabell,,2021,4.6,39500,41419,1919
54013,WV,Calhoun,,2007,7.4,2532,2735,203
54013,WV,Calhoun,,2008,7.4,2568,2772,204
54013,WV,Calhoun,,2009,13.7,2461,2851,390
54013,WV,Calhoun,,2010,14,2496,2904,408
54013,WV,Calhoun,,2011,12.3,2509,2862,353
54013,WV,Calhoun,,2012,10.7,2535,2839,304
54013,WV,Calhoun,,2013,10,2593,2881,288
54013,WV,Calhoun,,2014,9.6,2650,2930,280
54013,WV,Calhoun,,2015,12.2,2450,2790,340
54013,WV,Calhoun,,2016,12.9,2292,2630,338
54013,WV,Calhoun,,2017,10.8,2159,2421,262
54013,WV,Calhoun,,2018,10.3,2189,2441,252
54013,WV,Calhoun,,2019,13,2229,2562,333
54013,WV,Calhoun,,2020,15.7,2099,2491,392
54013,WV,Calhoun,,2021,10.3,2237,2495,258
54015,WV,Clay,,2007,7.4,3219,3475,256
54015,WV,Clay,,2008,6.8,3247,3483,236
54015,WV,Clay,,2009,12,3128,3553,425
54015,WV,Clay,,2010,14.2,3127,3643,516
54015,WV,Clay,,2011,12,3137,3566,429
54015,WV,Clay,,2012,11.7,3114,3525,411
54015,WV,Clay,,2013,11.9,3068,3482,414
54015,WV,Clay,,2014,10.7,2989,3347,358
54015,WV,Clay,,2015,10.9,2946,3307,361
54015,WV,Clay,,2016,10.4,2930,3269,339
54015,WV,Clay,,2017,8.6,2896,3170,274
54015,WV,Clay,,2018,8.3,2888,3149,261
54015,WV,Clay,,2019,8.6,2879,3149,270
54015,WV,Clay,,2020,12.3,2723,3105,382
54015,WV,Clay,,2021,7.7,2815,3051,236
54017,WV,Doddridge,,2007,5.1,2656,2800,144
54017,WV,Doddridge,,2008,5.3,2646,2794,148
54017,WV,Doddridge,,2009,8.4,2612,2850,238
54017,WV,Doddridge,,2010,7.2,3074,3311,237
54017,WV,Doddridge,,2011,6.9,3094,3324,230
54017,WV,Doddridge,,2012,6.1,3199,3406,207
54017,WV,Doddridge,,2013,5.3,3336,3522,186
54017,WV,Doddridge,,2014,4.9,3489,3669,180
54017,WV,Doddridge,,2015,5.4,3488,3687,199
54017,WV,Doddridge,,2016,5.2,3597,3794,197
54017,WV,Doddridge,,2017,4.3,3744,3911,167
54017,WV,Doddridge,,2018,3.9,3841,3996,155
54017,WV,Doddridge,,2019,4.5,3825,4004,179
54017,WV,Doddridge,,2020,6,3668,3901,233
54017,WV,Doddridge,,2021,4.1,3708,3867,159
54019,WV,Fayette,,2007,5.7,16966,17996,1030
54019,WV,Fayette,,2008,5,17078,17978,900
54019,WV,Fayette,,2009,9.1,16429,18066,1637
54019,WV,Fayette,,2010,10,15795,17545,1750
54019,WV,Fayette,,2011,8.7,16176,17719,1543
54019,WV,Fayette,,2012,8.4,16101,17570,1469
54019,WV,Fayette,,2013,8.5,15551,17000,1449
54019,WV,Fayette,,2014,8.2,15380,16756,1376
54019,WV,Fayette,,2015,8.4,15083,16464,1381
54019,WV,Fayette,,2016,7.9,14752,16024,1272
54019,WV,Fayette,,2017,6.4,14819,15833,1014
54019,WV,Fayette,,2018,6.3,15037,16043,1006
54019,WV,Fayette,,2019,5.7,15322,16246,924
54019,WV,Fayette,,2020,9.8,14449,16014,1565
54019,WV,Fayette,,2021,6.2,14987,15981,994
54021,WV,Gilmer,,2007,4.3,2947,3078,131
54021,WV,Gilmer,,2008,4.1,2980,3107,127
54021,WV,Gilmer,,2009,7.1,2977,3205,228
54021,WV,Gilmer,,2010,8.9,2525,2772,247
54021,WV,Gilmer,,2011,7.9,2591,2814,223
54021,WV,Gilmer,,2012,7.5,2563,2771,208
54021,WV,Gilmer,,2013,6.6,2573,2754,181
54021,WV,Gilmer,,2014,6.4,2591,2768,177
54021,WV,Gilmer,,2015,7.6,2528,2737,209
54021,WV,Gilmer,,2016,8.2,2337,2547,210
54021,WV,Gilmer,,2017,7.2,2245,2418,173
54021,WV,Gilmer,,2018,6.2,2239,2388,149
54021,WV,Gilmer,,2019,6.8,2214,2375,161
54021,WV,Gilmer,,2020,9.9,2066,2294,228
54021,WV,Gilmer,,2021,6.9,2160,2321,161
54023,WV,Grant,,2007,5.5,4976,5267,291
54023,WV,Grant,,2008,5.7,4916,5214,298
54023,WV,Grant,,2009,10.7,4542,5085,543
54023,WV,Grant,,2010,9.8,5517,6116,599
54023,WV,Grant,,2011,8.7,5644,6184,540
54023,WV,Grant,,2012,8.5,5644,6169,525
54023,WV,Grant,,2013,8.1,5516,6001,485
54023,WV,Grant,,2014,7.6,5420,5863,443
54023,WV,Grant,,2015,7.4,5399,5830,431
54023,WV,Grant,,2016,5.9,5619,5974,355
54023,WV,Grant,,2017,5.6,5602,5935,333
54023,WV,Grant,,2018,5.6,5544,5874,330
54023,WV,Grant,,2019,5.5,5639,5967,328
54023,WV,Grant,,2020,6.3,5539,5914,375
54023,WV,Grant,,2021,4.5,5726,5994,268
54025,WV,Greenbrier,,2007,6.4,14508,15500,992
54025,WV,Greenbrier,,2008,5.9,14084,14974,890
54025,WV,Greenbrier,,2009,10,13336,14822,1486
54025,WV,Greenbrier,,2010,8.8,14061,15416,1355
54025,WV,Greenbrier,,2011,8.1,14294,15558,1264
54025,WV,Greenbrier,,2012,7.7,14295,15488,1193
54025,WV,Greenbrier,,2013,7.4,14342,15482,1140
54025,WV,Greenbrier,,2014,6.8,14243,15280,1037
54025,WV,Greenbrier,,2015,6.4,14548,15543,995
54025,WV,Greenbrier,,2016,5.4,14885,15735,850
54025,WV,Greenbrier,,2017,4.9,15057,15828,771
54025,WV,Greenbrier,,2018,5,14991,15782,791
54025,WV,Greenbrier,,2019,4.7,15255,16000,745
54025,WV,Greenbrier,,2020,7.9,14316,15538,1222
54025,WV,Greenbrier,,2021,4.5,15043,15744,701
54027,WV,Hampshire,,2007,3.8,9241,9607,366
54027,WV,Hampshire,,2008,4.6,8942,9378,436
54027,WV,Hampshire,,2009,8.8,8449,9261,812
54027,WV,Hampshire,,2010,9.1,8864,9752,888
54027,WV,Hampshire,,2011,8.6,8950,9789,839
54027,WV,Hampshire,,2012,7.7,8989,9734,745
54027,WV,Hampshire,,2013,6.9,8918,9582,664
54027,WV,Hampshire,,2014,6.2,8911,9500,589
54027,WV,Hampshire,,2015,5.4,9209,9739,530
54027,WV,Hampshire,,2016,4.4,9495,9927,432
54027,WV,Hampshire,,2017,3.9,9986,10394,408
54027,WV,Hampshire,,2018,4.2,10057,10499,442
54027,WV,Hampshire,,2019,3.9,10266,10682,416
54027,WV,Hampshire,,2020,5.4,10076,10649,573
54027,WV,Hampshire,,2021,3.4,10670,11043,373
54029,WV,Hancock,,2007,6.1,13440,14306,866
54029,WV,Hancock,,2008,6.3,13698,14625,927
54029,WV,Hancock,,2009,12.1,12831,14590,1759
54029,WV,Hancock,,2010,12.2,12439,14160,1721
54029,WV,Hancock,,2011,10.3,12443,13877,1434
54029,WV,Hancock,,2012,9,12512,13743,1231
54029,WV,Hancock,,2013,8,12333,13409,1076
54029,WV,Hancock,,2014,7.9,12209,13253,1044
54029,WV,Hancock,,2015,7.6,12146,13147,1001
54029,WV,Hancock,,2016,7,11995,12899,904
54029,WV,Hancock,,2017,6.1,12114,12896,782
54029,WV,Hancock,,2018,5.8,12255,13010,755
54029,WV,Hancock,,2019,5.2,12421,13099,678
54029,WV,Hancock,,2020,9.8,11712,12982,1270
54029,WV,Hancock,,2021,6.3,12277,13098,821
54031,WV,Hardy,,2007,4.4,6842,7159,317
54031,WV,Hardy,,2008,4.9,6481,6818,337
54031,WV,Hardy,,2009,9.6,6087,6733,646
54031,WV,Hardy,,2010,11.6,5041,5703,662
54031,WV,Hardy,,2011,10.2,5104,5685,581
54031,WV,Hardy,,2012,10.3,4994,5565,571
54031,WV,Hardy,,2013,9.4,4945,5458,513
54031,WV,Hardy,,2014,8.3,4952,5400,448
54031,WV,Hardy,,2015,7.3,5129,5533,404
54031,WV,Hardy,,2016,5.7,5409,5736,327
54031,WV,Hardy,,2017,4.9,5649,5940,291
54031,WV,Hardy,,2018,5.4,5519,5836,317
54031,WV,Hardy,,2019,5.2,5508,5808,300
54031,WV,Hardy,,2020,7,5341,5746,405
54031,WV,Hardy,,2021,4.9,5393,5672,279
54033,WV,Harrison,,2007,4.5,29130,30497,1367
54033,WV,Harrison,,2008,4.2,29491,30795,1304
54033,WV,Harrison,,2009,7,29149,31340,2191
54033,WV,Harrison,,2010,7.6,28833,31213,2380
54033,WV,Harrison,,2011,6.9,29197,31375,2178
54033,WV,Harrison,,2012,6.3,29445,31424,1979
54033,WV,Harrison,,2013,5.5,30071,31822,1751
54033,WV,Harrison,,2014,5.3,30415,32109,1694
54033,WV,Harrison,,2015,6.2,30244,32228,1984
54033,WV,Harrison,,2016,5.8,30555,32448,1893
54033,WV,Harrison,,2017,4.8,31759,33369,1610
54033,WV,Harrison,,2018,4.5,32885,34422,1537
54033,WV,Harrison,,2019,4.5,33043,34589,1546
54033,WV,Harrison,,2020,7.8,31085,33700,2615
54033,WV,Harrison,,2021,4.7,32186,33767,1581
54035,WV,Jackson,,2007,5.1,11345,11956,611
54035,WV,Jackson,,2008,5.5,11238,11887,649
54035,WV,Jackson,,2009,12.2,10290,11716,1426
54035,WV,Jackson,,2010,11.4,10896,12298,1402
54035,WV,Jackson,,2011,10,10803,12004,1201
54035,WV,Jackson,,2012,8.3,11020,12011,991
54035,WV,Jackson,,2013,6.8,11219,12036,817
54035,WV,Jackson,,2014,6.5,11163,11944,781
54035,WV,Jackson,,2015,7,11202,12050,848
54035,WV,Jackson,,2016,6.5,11263,12045,782
54035,WV,Jackson,,2017,5.7,11398,12087,689
54035,WV,Jackson,,2018,3.9,15706,16351,645
54035,WV,Jackson,,2019,5.1,12689,13365,676
54035,WV,Jackson,,2020,8.5,11444,12502,1058
54035,WV,Jackson,,2021,5.7,11356,12040,684
54037,WV,Jefferson,,2007,3.4,24171,25017,846
54037,WV,Jefferson,,2008,4.1,23685,24706,1021
54037,WV,Jefferson,,2009,7.1,22796,24543,1747
54037,WV,Jefferson,,2010,6.7,25043,26832,1789
54037,WV,Jefferson,,2011,6.1,25570,27219,1649
54037,WV,Jefferson,,2012,5.2,26095,27531,1436
54037,WV,Jefferson,,2013,4.7,26142,27443,1301
54037,WV,Jefferson,,2014,4.6,25920,27162,1242
54037,WV,Jefferson,,2015,4,26973,28100,1127
54037,WV,Jefferson,,2016,3.4,27683,28648,965
54037,WV,Jefferson,,2017,3.1,28556,29470,914
54037,WV,Jefferson,,2018,3.3,28991,29982,991
54037,WV,Jefferson,,2019,3.1,29615,30570,955
54037,WV,Jefferson,,2020,5.8,27945,29674,1729
54037,WV,Jefferson,,2021,3.1,29451,30391,940
54039,WV,Kanawha,,2007,4.2,87393,91237,3844
54039,WV,Kanawha,,2008,3.8,88417,91922,3505
54039,WV,Kanawha,,2009,6.7,85897,92093,6196
54039,WV,Kanawha,,2010,7.4,85647,92476,6829
54039,WV,Kanawha,,2011,6.9,85319,91648,6329
54039,WV,Kanawha,,2012,6.4,85560,91383,5823
54039,WV,Kanawha,,2013,5.8,84281,89513,5232
54039,WV,Kanawha,,2014,5.8,84347,89517,5170
54039,WV,Kanawha,,2015,5.9,82145,87250,5105
54039,WV,Kanawha,,2016,5.5,80899,85575,4676
54039,WV,Kanawha,,2017,5.1,79331,83582,4251
54039,WV,Kanawha,,2018,5.1,79012,83247,4235
54039,WV,Kanawha,,2019,4.6,78800,82607,3807
54039,WV,Kanawha,,2020,8.6,75166,82265,7099
54039,WV,Kanawha,,2021,5.2,77575,81818,4243
54041,WV,Lewis,,2007,5.4,6921,7315,394
54041,WV,Lewis,,2008,4.5,7056,7391,335
54041,WV,Lewis,,2009,7.9,7074,7678,604
54041,WV,Lewis,,2010,8.8,6368,6983,615
54041,WV,Lewis,,2011,7.3,6648,7169,521
54041,WV,Lewis,,2012,6.8,6882,7384,502
54041,WV,Lewis,,2013,6.3,6900,7367,467
54041,WV,Lewis,,2014,6.2,6795,7246,451
54041,WV,Lewis,,2015,8,6489,7057,568
54041,WV,Lewis,,2016,8.5,6268,6850,582
54041,WV,Lewis,,2017,6.6,6128,6563,435
54041,WV,Lewis,,2018,5.5,6363,6733,370
54041,WV,Lewis,,2019,6.2,6382,6806,424
54041,WV,Lewis,,2020,10.7,5538,6201,663
54041,WV,Lewis,,2021,7,5765,6196,431
54043,WV,Lincoln,,2007,5.7,7499,7954,455
54043,WV,Lincoln,,2008,5.1,7621,8028,407
54043,WV,Lincoln,,2009,10.4,7300,8143,843
54043,WV,Lincoln,,2010,11.8,6938,7866,928
54043,WV,Lincoln,,2011,10.4,6872,7669,797
54043,WV,Lincoln,,2012,10,6931,7699,768
54043,WV,Lincoln,,2013,9.5,6836,7554,718
54043,WV,Lincoln,,2014,9.4,6874,7589,715
54043,WV,Lincoln,,2015,9.5,6729,7437,708
54043,WV,Lincoln,,2016,8.5,6688,7312,624
54043,WV,Lincoln,,2017,6.9,6711,7205,494
54043,WV,Lincoln,,2018,6.8,6697,7187,490
54043,WV,Lincoln,,2019,6.4,6758,7217,459
54043,WV,Lincoln,,2020,9.9,6404,7105,701
54043,WV,Lincoln,,2021,6.6,6621,7086,465
54045,WV,Logan,,2007,5.5,12079,12783,704
54045,WV,Logan,,2008,4.5,12488,13076,588
54045,WV,Logan,,2009,8.7,12188,13344,1156
54045,WV,Logan,,2010,10.2,11388,12675,1287
54045,WV,Logan,,2011,8.7,11786,12907,1121
54045,WV,Logan,,2012,9.4,11680,12896,1216
54045,WV,Logan,,2013,9.7,11185,12390,1205
54045,WV,Logan,,2014,10.4,10756,11998,1242
54045,WV,Logan,,2015,11,10345,11620,1275
54045,WV,Logan,,2016,10.2,10052,11195,1143
54045,WV,Logan,,2017,7.5,10035,10844,809
54045,WV,Logan,,2018,6.8,10100,10839,739
54045,WV,Logan,,2019,5.9,10505,11169,664
54045,WV,Logan,,2020,11.9,9752,11063,1311
54045,WV,Logan,,2021,6.6,10376,11111,735
54047,WV,McDowell,,2007,7.8,6358,6895,537
54047,WV,McDowell,,2008,6.4,6687,7143,456
54047,WV,McDowell,,2009,12.4,6538,7460,922
54047,WV,McDowell,,2010,13.2,5513,6353,840
54047,WV,McDowell,,2011,11.7,5886,6663,777
54047,WV,McDowell,,2012,11.7,5819,6589,770
54047,WV,McDowell,,2013,12.6,5416,6197,781
54047,WV,McDowell,,2014,12.9,5070,5819,749
54047,WV,McDowell,,2015,12.5,4726,5399,673
54047,WV,McDowell,,2016,12.2,4481,5102,621
54047,WV,McDowell,,2017,9,4280,4701,421
54047,WV,McDowell,,2018,9.3,4086,4503,417
54047,WV,McDowell,,2019,9.2,4052,4461,409
54047,WV,McDowell,,2020,12.2,3869,4408,539
54047,WV,McDowell,,2021,8.2,3936,4289,353
54049,WV,Marion,,2007,4.5,24880,26041,1161
54049,WV,Marion,,2008,3.9,25229,26248,1019
54049,WV,Marion,,2009,6.4,24694,26373,1679
54049,WV,Marion,,2010,7.3,24669,26605,1936
54049,WV,Marion,,2011,6.7,24948,26735,1787
54049,WV,Marion,,2012,6.2,25177,26848,1671
54049,WV,Marion,,2013,5.9,25205,26780,1575
54049,WV,Marion,,2014,5.9,25118,26687,1569
54049,WV,Marion,,2015,6.7,24564,26326,1762
54049,WV,Marion,,2016,6.5,24069,25754,1685
54049,WV,Marion,,2017,5.3,24153,25502,1349
54049,WV,Marion,,2018,5.6,24026,25462,1436
54049,WV,Marion,,2019,5.1,24423,25734,1311
54049,WV,Marion,,2020,8.5,22801,24922,2121
54049,WV,Marion,,2021,5.2,23773,25080,1307
54051,WV,Marshall,,2007,5.6,13927,14747,820
54051,WV,Marshall,,2008,5.5,13893,14707,814
54051,WV,Marshall,,2009,9.4,13468,14868,1400
54051,WV,Marshall,,2010,9.7,13242,14660,1418
54051,WV,Marshall,,2011,8.7,13080,14326,1246
54051,WV,Marshall,,2012,7.8,13209,14324,1115
54051,WV,Marshall,,2013,7.2,13283,14316,1033
54051,WV,Marshall,,2014,7.5,13300,14379,1079
54051,WV,Marshall,,2015,8.3,13035,14211,1176
54051,WV,Marshall,,2016,8,12986,14111,1125
54051,WV,Marshall,,2017,6,13221,14059,838
54051,WV,Marshall,,2018,5.7,13467,14286,819
54051,WV,Marshall,,2019,6.4,13258,14163,905
54051,WV,Marshall,,2020,9.7,12071,13373,1302
54051,WV,Marshall,,2021,6.2,12532,13367,835
54053,WV,Mason,,2007,7.2,9537,10282,745
54053,WV,Mason,,2008,7.6,9313,10075,762
54053,WV,Mason,,2009,12.6,8985,10279,1294
54053,WV,Mason,,2010,11.5,9966,11266,1300
54053,WV,Mason,,2011,10.6,9864,11034,1170
54053,WV,Mason,,2012,9.5,9855,10894,1039
54053,WV,Mason,,2013,9.3,9593,10573,980
54053,WV,Mason,,2014,9.2,9273,10217,944
54053,WV,Mason,,2015,8.3,9241,10078,837
54053,WV,Mason,,2016,7.1,9345,10063,718
54053,WV,Mason,,2017,6.7,9384,10061,677
54053,WV,Mason,,2018,6.9,9332,10022,690
54053,WV,Mason,,2019,6,9676,10291,615
54053,WV,Mason,,2020,8.3,9397,10245,848
54053,WV,Mason,,2021,5.5,9609,10171,562
54055,WV,Mercer,,2007,4.4,23519,24608,1089
54055,WV,Mercer,,2008,4.4,23825,24915,1090
54055,WV,Mercer,,2009,7,23456,25231,1775
54055,WV,Mercer,,2010,8.5,22003,24041,2038
54055,WV,Mercer,,2011,8.4,21734,23715,1981
54055,WV,Mercer,,2012,8.1,21534,23427,1893
54055,WV,Mercer,,2013,7.6,21400,23150,1750
54055,WV,Mercer,,2014,7.5,20748,22429,1681
54055,WV,Mercer,,2015,7.1,20650,22225,1575
54055,WV,Mercer,,2016,6.7,20302,21760,1458
54055,WV,Mercer,,2017,5.8,20200,21453,1253
54055,WV,Mercer,,2018,6.2,19881,21194,1313
54055,WV,Mercer,,2019,5.7,19784,20982,1198
54055,WV,Mercer,,2020,9.1,18854,20745,1891
54055,WV,Mercer,,2021,6,19377,20622,1245
54057,WV,Mineral,,2007,5,12627,13287,660
54057,WV,Mineral,,2008,4.9,12793,13458,665
54057,WV,Mineral,,2009,7.9,12681,13763,1082
54057,WV,Mineral,,2010,9.4,11192,12349,1157
54057,WV,Mineral,,2011,8.6,11126,12178,1052
54057,WV,Mineral,,2012,8.2,11104,12093,989
54057,WV,Mineral,,2013,7.8,10984,11908,924
54057,WV,Mineral,,2014,7.8,10970,11899,929
54057,WV,Mineral,,2015,7.2,10915,11757,842
54057,WV,Mineral,,2016,6,11235,11947,712
54057,WV,Mineral,,2017,5.3,11636,12285,649
54057,WV,Mineral,,2018,5.4,11738,12412,674
54057,WV,Mineral,,2019,5.7,11904,12629,725
54057,WV,Mineral,,2020,7.4,11178,12071,893
54057,WV,Mineral,,2021,4.7,11645,12215,570
54059,WV,Mingo,,2007,6,8214,8736,522
54059,WV,Mingo,,2008,4.6,8564,8977,413
54059,WV,Mingo,,2009,9.5,8064,8914,850
54059,WV,Mingo,,2010,9.9,8255,9157,902
54059,WV,Mingo,,2011,8.4,8426,9195,769
54059,WV,Mingo,,2012,9.4,8139,8983,844
54059,WV,Mingo,,2013,11.1,7547,8487,940
54059,WV,Mingo,,2014,11.8,6859,7775,916
54059,WV,Mingo,,2015,12.9,6362,7303,941
54059,WV,Mingo,,2016,12.6,5899,6751,852
54059,WV,Mingo,,2017,8.6,6212,6799,587
54059,WV,Mingo,,2018,7.5,6392,6909,517
54059,WV,Mingo,,2019,6.8,6432,6901,469
54059,WV,Mingo,,2020,14,5779,6722,943
54059,WV,Mingo,,2021,9,5663,6220,557
54061,WV,Monongalia,,2007,3.3,45430,46983,1553
54061,WV,Monongalia,,2008,3,46702,48154,1452
54061,WV,Monongalia,,2009,4.7,47214,49568,2354
54061,WV,Monongalia,,2010,5.6,45590,48286,2696
54061,WV,Monongalia,,2011,5.4,45935,48559,2624
54061,WV,Monongalia,,2012,5,47253,49746,2493
54061,WV,Monongalia,,2013,4.5,47855,50098,2243
54061,WV,Monongalia,,2014,4.3,48594,50802,2208
54061,WV,Monongalia,,2015,4.6,48736,51084,2348
54061,WV,Monongalia,,2016,4.3,49222,51452,2230
54061,WV,Monongalia,,2017,3.7,51190,53171,1981
54061,WV,Monongalia,,2018,4,52038,54228,2190
54061,WV,Monongalia,,2019,3.6,52791,54788,1997
54061,WV,Monongalia,,2020,6.2,50857,54222,3365
54061,WV,Monongalia,,2021,3.9,53636,55827,2191
54063,WV,Monroe,,2007,4.9,5613,5905,292
54063,WV,Monroe,,2008,4.8,5540,5822,282
54063,WV,Monroe,,2009,7.8,5355,5807,452
54063,WV,Monroe,,2010,8,5296,5757,461
54063,WV,Monroe,,2011,7.7,5332,5778,446
54063,WV,Monroe,,2012,7,5334,5735,401
54063,WV,Monroe,,2013,6.2,5331,5685,354
54063,WV,Monroe,,2014,5.8,5294,5617,323
54063,WV,Monroe,,2015,5.4,5502,5818,316
54063,WV,Monroe,,2016,4.6,5725,5998,273
54063,WV,Monroe,,2017,4.4,5670,5932,262
54063,WV,Monroe,,2018,4.8,5572,5850,278
54063,WV,Monroe,,2019,4.4,5738,6001,263
54063,WV,Monroe,,2020,6.9,5578,5994,416
54063,WV,Monroe,,2021,3.6,5869,6090,221
54065,WV,Morgan,,2007,5,6677,7025,348
54065,WV,Morgan,,2008,5.7,6532,6929,397
54065,WV,Morgan,,2009,9.5,6216,6866,650
54065,WV,Morgan,,2010,9.1,6966,7667,701
54065,WV,Morgan,,2011,8.1,6971,7582,611
54065,WV,Morgan,,2012,7.1,7053,7589,536
54065,WV,Morgan,,2013,6.1,6992,7449,457
54065,WV,Morgan,,2014,5.8,7036,7472,436
54065,WV,Morgan,,2015,5.4,7158,7563,405
54065,WV,Morgan,,2016,4.4,7342,7679,337
54065,WV,Morgan,,2017,4,7553,7864,311
54065,WV,Morgan,,2018,4.2,7703,8044,341
54065,WV,Morgan,,2019,3.9,7897,8217,320
54065,WV,Morgan,,2020,5.9,7752,8241,489
54065,WV,Morgan,,2021,3.5,8236,8532,296
54067,WV,Nicholas,,2007,5.2,10143,10705,562
54067,WV,Nicholas,,2008,5,10055,10583,528
54067,WV,Nicholas,,2009,9.3,9677,10667,990
54067,WV,Nicholas,,2010,10.1,9828,10927,1099
54067,WV,Nicholas,,2011,8.9,9973,10943,970
54067,WV,Nicholas,,2012,9,9856,10826,970
54067,WV,Nicholas,,2013,9.5,9397,10381,984
54067,WV,Nicholas,,2014,8.9,9239,10147,908
54067,WV,Nicholas,,2015,8.8,9158,10046,888
54067,WV,Nicholas,,2016,8.8,8770,9619,849
54067,WV,Nicholas,,2017,7.2,8646,9313,667
54067,WV,Nicholas,,2018,6.4,8786,9382,596
54067,WV,Nicholas,,2019,6.3,8873,9474,601
54067,WV,Nicholas,,2020,10.3,8328,9281,953
54067,WV,Nicholas,,2021,6,8541,9085,544
54069,WV,Ohio,,2007,4.4,19979,20906,927
54069,WV,Ohio,,2008,4.5,20030,20980,950
54069,WV,Ohio,,2009,8.1,19502,21232,1730
54069,WV,Ohio,,2010,7.9,20065,21796,1731
54069,WV,Ohio,,2011,7.1,19800,21317,1517
54069,WV,Ohio,,2012,6.1,20053,21367,1314
54069,WV,Ohio,,2013,5.6,20158,21358,1200
54069,WV,Ohio,,2014,5.5,20025,21184,1159
54069,WV,Ohio,,2015,5.5,19764,20909,1145
54069,WV,Ohio,,2016,5.6,19546,20695,1149
54069,WV,Ohio,,2017,4.7,20055,21045,990
54069,WV,Ohio,,2018,4.5,20563,21540,977
54069,WV,Ohio,,2019,4.5,20241,21201,960
54069,WV,Ohio,,2020,8.2,18585,20250,1665
54069,WV,Ohio,,2021,5.1,19292,20333,1041
54071,WV,Pendleton,,2007,3.9,3626,3774,148
54071,WV,Pendleton,,2008,4.7,3513,3685,172
54071,WV,Pendleton,,2009,8.1,3261,3550,289
54071,WV,Pendleton,,2010,8.6,3339,3655,316
54071,WV,Pendleton,,2011,7,3391,3647,256
54071,WV,Pendleton,,2012,6.6,3399,3638,239
54071,WV,Pendleton,,2013,5.4,3390,3584,194
54071,WV,Pendleton,,2014,4.8,3346,3515,169
54071,WV,Pendleton,,2015,4.5,3454,3618,164
54071,WV,Pendleton,,2016,3.9,3523,3665,142
54071,WV,Pendleton,,2017,3.8,3447,3582,135
54071,WV,Pendleton,,2018,3.7,3438,3569,131
54071,WV,Pendleton,,2019,3.9,3555,3699,144
54071,WV,Pendleton,,2020,4.8,3460,3635,175
54071,WV,Pendleton,,2021,3,3651,3763,112
54073,WV,Pleasants,,2007,6,2950,3139,189
54073,WV,Pleasants,,2008,6.3,2926,3123,197
54073,WV,Pleasants,,2009,10.9,2865,3217,352
54073,WV,Pleasants,,2010,10.6,2623,2934,311
54073,WV,Pleasants,,2011,9.5,2638,2915,277
54073,WV,Pleasants,,2012,8.4,2635,2878,243
54073,WV,Pleasants,,2013,7.2,2688,2896,208
54073,WV,Pleasants,,2014,7,2793,3003,210
54073,WV,Pleasants,,2015,8.3,2768,3019,251
54073,WV,Pleasants,,2016,8.2,2721,2964,243
54073,WV,Pleasants,,2017,7.1,2634,2834,200
54073,WV,Pleasants,,2018,6.1,2696,2872,176
54073,WV,Pleasants,,2019,6.9,2712,2912,200
54073,WV,Pleasants,,2020,10.9,2384,2677,293
54073,WV,Pleasants,,2021,7.2,2503,2696,193
54075,WV,Pocahontas,,2007,7.7,3436,3721,285
54075,WV,Pocahontas,,2008,7.7,3310,3585,275
54075,WV,Pocahontas,,2009,12.7,3143,3601,458
54075,WV,Pocahontas,,2010,11.5,3358,3795,437
54075,WV,Pocahontas,,2011,10.8,3280,3677,397
54075,WV,Pocahontas,,2012,9.8,3264,3619,355
54075,WV,Pocahontas,,2013,8.5,3294,3599,305
54075,WV,Pocahontas,,2014,8.5,3265,3569,304
54075,WV,Pocahontas,,2015,8,3343,3632,289
54075,WV,Pocahontas,,2016,6.7,3490,3739,249
54075,WV,Pocahontas,,2017,5.9,3545,3769,224
54075,WV,Pocahontas,,2018,6.1,3605,3838,233
54075,WV,Pocahontas,,2019,5.7,3680,3901,221
54075,WV,Pocahontas,,2020,9,3455,3797,342
54075,WV,Pocahontas,,2021,5,3724,3920,196
54077,WV,Preston,,2007,4.5,14062,14732,670
54077,WV,Preston,,2008,4.3,14354,14992,638
54077,WV,Preston,,2009,7.6,14196,15360,1164
54077,WV,Preston,,2010,8.4,13668,14917,1249
54077,WV,Preston,,2011,7.4,13544,14630,1086
54077,WV,Preston,,2012,6.8,13776,14784,1008
54077,WV,Preston,,2013,6.5,13702,14649,947
54077,WV,Preston,,2014,5.9,13747,14611,864
54077,WV,Preston,,2015,6.1,13909,14811,902
54077,WV,Preston,,2016,5.7,14044,14900,856
54077,WV,Preston,,2017,5,14549,15307,758
54077,WV,Preston,,2018,5.2,14686,15486,800
54077,WV,Preston,,2019,4.6,14849,15565,716
54077,WV,Preston,,2020,7.2,14140,15234,1094
54077,WV,Preston,,2021,4.5,14943,15649,706
54079,WV,Putnam,,2007,3.9,26157,27223,1066
54079,WV,Putnam,,2008,3.6,26737,27723,986
54079,WV,Putnam,,2009,6.5,25974,27789,1815
54079,WV,Putnam,,2010,7.6,24356,26356,2000
54079,WV,Putnam,,2011,7.1,24411,26285,1874
54079,WV,Putnam,,2012,6.2,24751,26387,1636
54079,WV,Putnam,,2013,5.6,24532,25993,1461
54079,WV,Putnam,,2014,5.5,24725,26151,1426
54079,WV,Putnam,,2015,5.5,24430,25842,1412
54079,WV,Putnam,,2016,4.9,24594,25859,1265
54079,WV,Putnam,,2017,4.7,25153,26396,1243
54079,WV,Putnam,,2018,4.8,25347,26638,1291
54079,WV,Putnam,,2019,4.4,25768,26945,1177
54079,WV,Putnam,,2020,7.2,24901,26841,1940
54079,WV,Putnam,,2021,4.2,25751,26881,1130
54081,WV,Raleigh,,2007,4.7,30953,32469,1516
54081,WV,Raleigh,,2008,4.3,31125,32525,1400
54081,WV,Raleigh,,2009,7.7,30195,32728,2533
54081,WV,Raleigh,,2010,8.2,29784,32428,2644
54081,WV,Raleigh,,2011,7,30701,33011,2310
54081,WV,Raleigh,,2012,7,30546,32851,2305
54081,WV,Raleigh,,2013,7.2,29535,31828,2293
54081,WV,Raleigh,,2014,7,29284,31505,2221
54081,WV,Raleigh,,2015,7.2,28484,30696,2212
54081,WV,Raleigh,,2016,7,27931,30031,2100
54081,WV,Raleigh,,2017,5.4,27991,29579,1588
54081,WV,Raleigh,,2018,5.1,28457,30002,1545
54081,WV,Raleigh,,2019,4.7,29080,30513,1433
54081,WV,Raleigh,,2020,8.7,27493,30123,2630
54081,WV,Raleigh,,2021,5.2,28502,30080,1578
54083,WV,Randolph,,2007,5.4,12284,12979,695
54083,WV,Randolph,,2008,5.9,11967,12714,747
54083,WV,Randolph,,2009,9.5,11474,12682,1208
54083,WV,Randolph,,2010,10.5,10912,12193,1281
54083,WV,Randolph,,2011,9.5,10926,12069,1143
54083,WV,Randolph,,2012,8.4,11056,12073,1017
54083,WV,Randolph,,2013,7.1,11083,11933,850
54083,WV,Randolph,,2014,7.1,11071,11918,847
54083,WV,Randolph,,2015,6.8,11213,12037,824
54083,WV,Randolph,,2016,6,11511,12245,734
54083,WV,Randolph,,2017,5.4,11556,12215,659
54083,WV,Randolph,,2018,5.4,11493,12152,659
54083,WV,Randolph,,2019,6,11662,12400,738
54083,WV,Randolph,,2020,9,11091,12184,1093
54083,WV,Randolph,,2021,5.6,11386,12058,672
54085,WV,Ritchie,,2007,5.4,4343,4591,248
54085,WV,Ritchie,,2008,5.9,4243,4510,267
54085,WV,Ritchie,,2009,10,3955,4395,440
54085,WV,Ritchie,,2010,9.7,3873,4290,417
54085,WV,Ritchie,,2011,8.8,3926,4307,381
54085,WV,Ritchie,,2012,7.1,4071,4383,312
54085,WV,Ritchie,,2013,6.1,4284,4560,276
54085,WV,Ritchie,,2014,6.1,4355,4638,283
54085,WV,Ritchie,,2015,6.8,4236,4546,310
54085,WV,Ritchie,,2016,6.5,4279,4578,299
54085,WV,Ritchie,,2017,5.5,4187,4431,244
54085,WV,Ritchie,,2018,5.3,4126,4356,230
54085,WV,Ritchie,,2019,5.7,4154,4406,252
54085,WV,Ritchie,,2020,8.2,3996,4352,356
54085,WV,Ritchie,,2021,5.6,4089,4330,241
54087,WV,Roane,,2007,6.8,5177,5553,376
54087,WV,Roane,,2008,6.9,5121,5502,381
54087,WV,Roane,,2009,12.8,4850,5563,713
54087,WV,Roane,,2010,13.6,4753,5504,751
54087,WV,Roane,,2011,12.6,4721,5401,680
54087,WV,Roane,,2012,11,4734,5319,585
54087,WV,Roane,,2013,10.2,4812,5361,549
54087,WV,Roane,,2014,9.8,4807,5332,525
54087,WV,Roane,,2015,11.2,4685,5278,593
54087,WV,Roane,,2016,10.3,4681,5219,538
54087,WV,Roane,,2017,8.7,4615,5056,441
54087,WV,Roane,,2018,7.7,4610,4996,386
54087,WV,Roane,,2019,9.6,4634,5126,492
54087,WV,Roane,,2020,12.1,4470,5085,615
54087,WV,Roane,,2021,8.5,4592,5017,425
54089,WV,Summers,,2007,6.3,4420,4718,298
54089,WV,Summers,,2008,5.4,4367,4617,250
54089,WV,Summers,,2009,8.5,4244,4636,392
54089,WV,Summers,,2010,9.5,4325,4778,453
54089,WV,Summers,,2011,9,4266,4689,423
54089,WV,Summers,,2012,8.5,4238,4634,396
54089,WV,Summers,,2013,7.5,4211,4554,343
54089,WV,Summers,,2014,7,4207,4524,317
54089,WV,Summers,,2015,6.9,4259,4573,314
54089,WV,Summers,,2016,6.1,4304,4585,281
54089,WV,Summers,,2017,5.9,4146,4406,260
54089,WV,Summers,,2018,6,3996,4252,256
54089,WV,Summers,,2019,5.5,4110,4350,240
54089,WV,Summers,,2020,7.6,4007,4337,330
54089,WV,Summers,,2021,4.7,4261,4471,210
54091,WV,Taylor,,2007,5.1,6536,6889,353
54091,WV,Taylor,,2008,4.8,6581,6912,331
54091,WV,Taylor,,2009,7.6,6567,7110,543
54091,WV,Taylor,,2010,7.7,6863,7436,573
54091,WV,Taylor,,2011,7.2,6890,7427,537
54091,WV,Taylor,,2012,6.6,7066,7566,500
54091,WV,Taylor,,2013,5.6,7335,7769,434
54091,WV,Taylor,,2014,5.2,7409,7817,408
54091,WV,Taylor,,2015,5.8,7374,7832,458
54091,WV,Taylor,,2016,5.6,7401,7844,443
54091,WV,Taylor,,2017,4.9,7469,7855,386
54091,WV,Taylor,,2018,4.8,7485,7861,376
54091,WV,Taylor,,2019,4.9,7531,7917,386
54091,WV,Taylor,,2020,7.2,7167,7724,557
54091,WV,Taylor,,2021,4.6,7485,7848,363
54093,WV,Tucker,,2007,6.4,2781,2971,190
54093,WV,Tucker,,2008,7,2702,2904,202
54093,WV,Tucker,,2009,12.1,2531,2881,350
54093,WV,Tucker,,2010,11,2933,3297,364
54093,WV,Tucker,,2011,9.1,2927,3221,294
54093,WV,Tucker,,2012,7.8,2943,3192,249
54093,WV,Tucker,,2013,6.7,3055,3276,221
54093,WV,Tucker,,2014,6.3,3180,3392,212
54093,WV,Tucker,,2015,6,3258,3465,207
54093,WV,Tucker,,2016,5.4,3299,3487,188
54093,WV,Tucker,,2017,5.2,3245,3422,177
54093,WV,Tucker,,2018,5.4,3179,3361,182
54093,WV,Tucker,,2019,5.2,3176,3350,174
54093,WV,Tucker,,2020,8.2,3036,3306,270
54093,WV,Tucker,,2021,5.4,3243,3427,184
54095,WV,Tyler,,2007,6.6,3409,3648,239
54095,WV,Tyler,,2008,6.8,3353,3596,243
54095,WV,Tyler,,2009,11.2,3220,3628,408
54095,WV,Tyler,,2010,11.4,3141,3547,406
54095,WV,Tyler,,2011,10.3,3228,3597,369
54095,WV,Tyler,,2012,8.8,3334,3657,323
54095,WV,Tyler,,2013,8.6,3321,3634,313
54095,WV,Tyler,,2014,8.9,3311,3635,324
54095,WV,Tyler,,2015,9.1,3359,3697,338
54095,WV,Tyler,,2016,8.9,3242,3559,317
54095,WV,Tyler,,2017,7.7,2986,3235,249
54095,WV,Tyler,,2018,7.2,2906,3131,225
54095,WV,Tyler,,2019,7.7,2919,3163,244
54095,WV,Tyler,,2020,10.5,2697,3012,315
54095,WV,Tyler,,2021,8,2742,2980,238
54097,WV,Upshur,,2007,4.6,10240,10738,498
54097,WV,Upshur,,2008,4.6,10153,10642,489
54097,WV,Upshur,,2009,9,9755,10718,963
54097,WV,Upshur,,2010,9.3,9396,10356,960
54097,WV,Upshur,,2011,8.5,9368,10234,866
54097,WV,Upshur,,2012,7.5,9233,9987,754
54097,WV,Upshur,,2013,7,8944,9621,677
54097,WV,Upshur,,2014,6.6,8997,9635,638
54097,WV,Upshur,,2015,7.8,9005,9771,766
54097,WV,Upshur,,2016,7.5,9095,9837,742
54097,WV,Upshur,,2017,6.2,8884,9467,583
54097,WV,Upshur,,2018,5.6,8955,9490,535
54097,WV,Upshur,,2019,6,9078,9654,576
54097,WV,Upshur,,2020,9.3,8671,9564,893
54097,WV,Upshur,,2021,6.2,9080,9681,601
54099,WV,Wayne,,2007,4.9,16734,17603,869
54099,WV,Wayne,,2008,5.1,16580,17469,889
54099,WV,Wayne,,2009,8.5,15786,17250,1464
54099,WV,Wayne,,2010,8.5,15472,16916,1444
54099,WV,Wayne,,2011,7.9,15185,16492,1307
54099,WV,Wayne,,2012,7.3,15187,16390,1203
54099,WV,Wayne,,2013,6.9,14960,16061,1101
54099,WV,Wayne,,2014,6.7,14927,16006,1079
54099,WV,Wayne,,2015,6.9,14657,15751,1094
54099,WV,Wayne,,2016,6.6,14552,15582,1030
54099,WV,Wayne,,2017,5.8,14768,15681,913
54099,WV,Wayne,,2018,5.9,14829,15754,925
54099,WV,Wayne,,2019,5.4,14920,15776,856
54099,WV,Wayne,,2020,8.2,14287,15570,1283
54099,WV,Wayne,,2021,5.1,14771,15573,802
54101,WV,Webster,,2007,5.9,3147,3346,199
54101,WV,Webster,,2008,6,3075,3271,196
54101,WV,Webster,,2009,11.2,2889,3254,365
54101,WV,Webster,,2010,10.2,3356,3736,380
54101,WV,Webster,,2011,9.2,3295,3627,332
54101,WV,Webster,,2012,10.3,3227,3598,371
54101,WV,Webster,,2013,10.2,3159,3517,358
54101,WV,Webster,,2014,8.4,3178,3471,293
54101,WV,Webster,,2015,7.4,3253,3512,259
54101,WV,Webster,,2016,8.4,3209,3502,293
54101,WV,Webster,,2017,6.3,3109,3319,210
54101,WV,Webster,,2018,6.3,3001,3202,201
54101,WV,Webster,,2019,6.3,3107,3316,209
54101,WV,Webster,,2020,9.2,2965,3265,300
54101,WV,Webster,,2021,6.2,3041,3241,200
54103,WV,Wetzel,,2007,7.2,5814,6265,451
54103,WV,Wetzel,,2008,7.7,5750,6233,483
54103,WV,Wetzel,,2009,12.5,5515,6305,790
54103,WV,Wetzel,,2010,11.8,6184,7009,825
54103,WV,Wetzel,,2011,10.3,6309,7036,727
54103,WV,Wetzel,,2012,9.1,6602,7259,657
54103,WV,Wetzel,,2013,9,6633,7289,656
54103,WV,Wetzel,,2014,10.1,6586,7324,738
54103,WV,Wetzel,,2015,9.8,6531,7238,707
54103,WV,Wetzel,,2016,9.2,6557,7225,668
54103,WV,Wetzel,,2017,7.6,6267,6780,513
54103,WV,Wetzel,,2018,7.1,6157,6625,468
54103,WV,Wetzel,,2019,7.3,6148,6629,481
54103,WV,Wetzel,,2020,9.8,5858,6497,639
54103,WV,Wetzel,,2021,6.7,6249,6698,449
54105,WV,Wirt,,2007,6.3,2316,2471,155
54105,WV,Wirt,,2008,6.5,2287,2447,160
54105,WV,Wirt,,2009,13,2118,2434,316
54105,WV,Wirt,,2010,12.5,2003,2290,287
54105,WV,Wirt,,2011,11.3,2019,2275,256
54105,WV,Wirt,,2012,10.6,2051,2294,243
54105,WV,Wirt,,2013,10,2087,2320,233
54105,WV,Wirt,,2014,9.5,2067,2284,217
54105,WV,Wirt,,2015,10.1,2050,2281,231
54105,WV,Wirt,,2016,8.8,2042,2239,197
54105,WV,Wirt,,2017,7.9,2036,2211,175
54105,WV,Wirt,,2018,6.9,2081,2235,154
54105,WV,Wirt,,2019,7.9,2133,2315,182
54105,WV,Wirt,,2020,10.6,1996,2232,236
54105,WV,Wirt,,2021,7.6,2098,2271,173
54107,WV,Wood,,2007,4.9,38799,40804,2005
54107,WV,Wood,,2008,5.1,38713,40801,2088
54107,WV,Wood,,2009,9.2,37106,40851,3745
54107,WV,Wood,,2010,8.9,35800,39296,3496
54107,WV,Wood,,2011,8,35517,38617,3100
54107,WV,Wood,,2012,7,35845,38551,2706
54107,WV,Wood,,2013,6.1,36133,38493,2360
54107,WV,Wood,,2014,5.8,35938,38168,2230
54107,WV,Wood,,2015,6.1,35206,37513,2307
54107,WV,Wood,,2016,5.7,34816,36940,2124
54107,WV,Wood,,2017,5.5,34363,36362,1999
54107,WV,Wood,,2018,5.4,34451,36410,1959
54107,WV,Wood,,2019,5.1,34924,36809,1885
54107,WV,Wood,,2020,8.6,32991,36102,3111
54107,WV,Wood,,2021,5.3,34608,36539,1931
54109,WV,Wyoming,,2007,6.5,7616,8142,526
54109,WV,Wyoming,,2008,5.1,7562,7968,406
54109,WV,Wyoming,,2009,10.7,7326,8203,877
54109,WV,Wyoming,,2010,10.4,7530,8406,876
54109,WV,Wyoming,,2011,8.6,7595,8308,713
54109,WV,Wyoming,,2012,8.9,7633,8377,744
54109,WV,Wyoming,,2013,9.1,7537,8296,759
54109,WV,Wyoming,,2014,9.4,7271,8021,750
54109,WV,Wyoming,,2015,9.4,7095,7833,738
54109,WV,Wyoming,,2016,10.2,6685,7444,759
54109,WV,Wyoming,,2017,7.1,6419,6908,489
54109,WV,Wyoming,,2018,6.9,6399,6872,473
54109,WV,Wyoming,,2019,7,6200,6667,467
54109,WV,Wyoming,,2020,9.7,6164,6829,665
54109,WV,Wyoming,,2021,5.8,6767,7183,416
55000,WI,Wisconsin,,2007,4.8,2938876,3087598,148722
55000,WI,Wisconsin,,2008,4.9,2945874,3098931,153057
55000,WI,Wisconsin,,2009,9,2833292,3112494,279202
55000,WI,Wisconsin,,2010,8.5,2820620,3082935,262315
55000,WI,Wisconsin,,2011,7.6,2839987,3072157,232170
55000,WI,Wisconsin,,2012,6.9,2857150,3070033,212883
55000,WI,Wisconsin,,2013,6.7,2871988,3077801,205813
55000,WI,Wisconsin,,2014,5.3,2913764,3077981,164217
55000,WI,Wisconsin,,2015,4.4,2947048,3084207,137159
55000,WI,Wisconsin,,2016,3.9,2988744,3110466,121722
55000,WI,Wisconsin,,2017,3.3,3039348,3141757,102409
55000,WI,Wisconsin,,2018,3,3036071,3129386,93315
55000,WI,Wisconsin,,2019,3.2,3021491,3120590,99099
55000,WI,Wisconsin,,2020,6.3,2909004,3105882,196878
55000,WI,Wisconsin,,2021,3.8,3016039,3134439,118400
55001,WI,Adams,,2007,6.5,9446,10100,654
55001,WI,Adams,,2008,7.1,9366,10077,711
55001,WI,Adams,,2009,11,8934,10038,1104
55001,WI,Adams,,2010,12.2,8022,9135,1113
55001,WI,Adams,,2011,11.5,7990,9029,1039
55001,WI,Adams,,2012,10.8,8002,8967,965
55001,WI,Adams,,2013,10.8,7779,8721,942
55001,WI,Adams,,2014,8.7,7652,8383,731
55001,WI,Adams,,2015,7.1,7713,8302,589
55001,WI,Adams,,2016,5.9,7770,8255,485
55001,WI,Adams,,2017,5,7842,8258,416
55001,WI,Adams,,2018,4.7,7821,8205,384
55001,WI,Adams,,2019,4.8,7790,8186,396
55001,WI,Adams,,2020,9.6,7354,8138,784
55001,WI,Adams,,2021,6.2,7524,8020,496
55003,WI,Ashland,,2007,5.9,8522,9056,534
55003,WI,Ashland,,2008,6.1,8459,9006,547
55003,WI,Ashland,,2009,10.4,8222,9179,957
55003,WI,Ashland,,2010,10.9,7495,8409,914
55003,WI,Ashland,,2011,9.9,7463,8281,818
55003,WI,Ashland,,2012,9.1,7473,8221,748
55003,WI,Ashland,,2013,9.1,7416,8156,740
55003,WI,Ashland,,2014,7.4,7447,8041,594
55003,WI,Ashland,,2015,6.1,7418,7901,483
55003,WI,Ashland,,2016,5.3,7510,7929,419
55003,WI,Ashland,,2017,4.5,7559,7917,358
55003,WI,Ashland,,2018,4.2,7597,7932,335
55003,WI,Ashland,,2019,4.6,7544,7904,360
55003,WI,Ashland,,2020,8.6,7037,7700,663
55003,WI,Ashland,,2021,5,7324,7713,389
55005,WI,Barron,,2007,5.8,23575,25028,1453
55005,WI,Barron,,2008,5.8,23690,25144,1454
55005,WI,Barron,,2009,9.4,22872,25250,2378
55005,WI,Barron,,2010,9.1,21635,23801,2166
55005,WI,Barron,,2011,8.3,21730,23690,1960
55005,WI,Barron,,2012,7.8,21838,23679,1841
55005,WI,Barron,,2013,7.4,21874,23633,1759
55005,WI,Barron,,2014,5.7,22676,24043,1367
55005,WI,Barron,,2015,4.9,23207,24396,1189
55005,WI,Barron,,2016,4.4,23203,24277,1074
55005,WI,Barron,,2017,3.5,23916,24774,858
55005,WI,Barron,,2018,3.3,24157,24991,834
55005,WI,Barron,,2019,3.8,23554,24479,925
55005,WI,Barron,,2020,6.1,22692,24170,1478
55005,WI,Barron,,2021,3.9,23434,24374,940
55007,WI,Bayfield,,2007,6.5,7636,8166,530
55007,WI,Bayfield,,2008,6.8,7521,8066,545
55007,WI,Bayfield,,2009,9.5,7294,8063,769
55007,WI,Bayfield,,2010,10.9,6852,7687,835
55007,WI,Bayfield,,2011,10.5,6909,7720,811
55007,WI,Bayfield,,2012,10.6,6955,7781,826
55007,WI,Bayfield,,2013,10.9,6908,7753,845
55007,WI,Bayfield,,2014,9.4,6817,7528,711
55007,WI,Bayfield,,2015,8.1,6894,7505,611
55007,WI,Bayfield,,2016,6.7,7003,7507,504
55007,WI,Bayfield,,2017,5.1,7211,7602,391
55007,WI,Bayfield,,2018,4.8,7230,7597,367
55007,WI,Bayfield,,2019,5.3,7187,7591,404
55007,WI,Bayfield,,2020,9.2,6871,7569,698
55007,WI,Bayfield,,2021,5.7,7169,7606,437
55009,WI,Brown,,2007,4.5,132783,139062,6279
55009,WI,Brown,,2008,4.6,133165,139615,6450
55009,WI,Brown,,2009,8.1,130122,141515,11393
55009,WI,Brown,,2010,7.7,126621,137237,10616
55009,WI,Brown,,2011,7,127649,137281,9632
55009,WI,Brown,,2012,6.5,128632,137514,8882
55009,WI,Brown,,2013,6.2,129515,138007,8492
55009,WI,Brown,,2014,4.8,131689,138288,6599
55009,WI,Brown,,2015,4,133376,138906,5530
55009,WI,Brown,,2016,3.5,135820,140794,4974
55009,WI,Brown,,2017,2.9,138992,143180,4188
55009,WI,Brown,,2018,2.7,139237,143144,3907
55009,WI,Brown,,2019,3,138014,142219,4205
55009,WI,Brown,,2020,6.1,133226,141840,8614
55009,WI,Brown,,2021,3.4,137757,142598,4841
55011,WI,Buffalo,,2007,4.3,7881,8235,354
55011,WI,Buffalo,,2008,4.3,7804,8155,351
55011,WI,Buffalo,,2009,7.2,7738,8341,603
55011,WI,Buffalo,,2010,7.6,6654,7203,549
55011,WI,Buffalo,,2011,6.8,6472,6941,469
55011,WI,Buffalo,,2012,6.2,6222,6631,409
55011,WI,Buffalo,,2013,6.5,6123,6550,427
55011,WI,Buffalo,,2014,5.5,6096,6454,358
55011,WI,Buffalo,,2015,4.8,6206,6518,312
55011,WI,Buffalo,,2016,4.3,6268,6553,285
55011,WI,Buffalo,,2017,3.7,6355,6600,245
55011,WI,Buffalo,,2018,3.4,6394,6619,225
55011,WI,Buffalo,,2019,3.9,6219,6474,255
55011,WI,Buffalo,,2020,7.4,5941,6419,478
55011,WI,Buffalo,,2021,4.2,6105,6371,266
55013,WI,Burnett,,2007,6.7,7560,8107,547
55013,WI,Burnett,,2008,7.2,7351,7922,571
55013,WI,Burnett,,2009,11.3,7121,8024,903
55013,WI,Burnett,,2010,10.9,6752,7576,824
55013,WI,Burnett,,2011,10,6802,7560,758
55013,WI,Burnett,,2012,8.9,6859,7528,669
55013,WI,Burnett,,2013,8.4,6852,7482,630
55013,WI,Burnett,,2014,7.9,6774,7357,583
55013,WI,Burnett,,2015,6.8,6754,7249,495
55013,WI,Burnett,,2016,5.8,6735,7152,417
55013,WI,Burnett,,2017,4.8,7015,7368,353
55013,WI,Burnett,,2018,4.6,6987,7322,335
55013,WI,Burnett,,2019,5.1,6799,7162,363
55013,WI,Burnett,,2020,9.1,6610,7270,660
55013,WI,Burnett,,2021,5.3,7024,7415,391
55015,WI,Calumet,,2007,4.7,24356,25550,1194
55015,WI,Calumet,,2008,4.3,24596,25705,1109
55015,WI,Calumet,,2009,8,23674,25724,2050
55015,WI,Calumet,,2010,6.7,25477,27315,1838
55015,WI,Calumet,,2011,5.8,25878,27464,1586
55015,WI,Calumet,,2012,5.3,25837,27271,1434
55015,WI,Calumet,,2013,5.2,25755,27175,1420
55015,WI,Calumet,,2014,4.1,25996,27116,1120
55015,WI,Calumet,,2015,3.5,26443,27398,955
55015,WI,Calumet,,2016,3.1,26782,27650,868
55015,WI,Calumet,,2017,2.8,27217,27994,777
55015,WI,Calumet,,2018,2.6,27089,27802,713
55015,WI,Calumet,,2019,2.7,26875,27614,739
55015,WI,Calumet,,2020,4.7,26108,27404,1296
55015,WI,Calumet,,2021,2.8,26984,27758,774
55017,WI,Chippewa,,2007,5.3,32007,33797,1790
55017,WI,Chippewa,,2008,5.3,31644,33420,1776
55017,WI,Chippewa,,2009,8.8,30335,33271,2936
55017,WI,Chippewa,,2010,8.3,30454,33193,2739
55017,WI,Chippewa,,2011,7.6,30787,33303,2516
55017,WI,Chippewa,,2012,6.7,31011,33225,2214
55017,WI,Chippewa,,2013,6.7,30759,32966,2207
55017,WI,Chippewa,,2014,5.3,31269,33022,1753
55017,WI,Chippewa,,2015,4.6,31542,33064,1522
55017,WI,Chippewa,,2016,4.1,31887,33263,1376
55017,WI,Chippewa,,2017,3.5,32382,33548,1166
55017,WI,Chippewa,,2018,3.3,32370,33459,1089
55017,WI,Chippewa,,2019,3.6,32308,33517,1209
55017,WI,Chippewa,,2020,6.3,31163,33248,2085
55017,WI,Chippewa,,2021,3.9,32489,33814,1325
55019,WI,Clark,,2007,5.6,16794,17795,1001
55019,WI,Clark,,2008,5.6,16604,17591,987
55019,WI,Clark,,2009,9.8,16159,17924,1765
55019,WI,Clark,,2010,10.1,15514,17265,1751
55019,WI,Clark,,2011,8.2,15861,17276,1415
55019,WI,Clark,,2012,7.3,15829,17077,1248
55019,WI,Clark,,2013,7,15923,17122,1199
55019,WI,Clark,,2014,5.4,16035,16947,912
55019,WI,Clark,,2015,4.3,16641,17384,743
55019,WI,Clark,,2016,3.8,16817,17481,664
55019,WI,Clark,,2017,3,17477,18020,543
55019,WI,Clark,,2018,2.8,17570,18085,515
55019,WI,Clark,,2019,3.1,17244,17801,557
55019,WI,Clark,,2020,4.5,16830,17630,800
55019,WI,Clark,,2021,3.2,17339,17911,572
55021,WI,Columbia,,2007,5,29609,31153,1544
55021,WI,Columbia,,2008,5.1,29538,31134,1596
55021,WI,Columbia,,2009,8.7,28536,31243,2707
55021,WI,Columbia,,2010,8.3,29428,32089,2661
55021,WI,Columbia,,2011,7.7,29271,31710,2439
55021,WI,Columbia,,2012,7.1,29056,31289,2233
55021,WI,Columbia,,2013,6.5,29195,31221,2026
55021,WI,Columbia,,2014,5.2,29537,31157,1620
55021,WI,Columbia,,2015,4.3,29930,31265,1335
55021,WI,Columbia,,2016,3.5,30384,31490,1106
55021,WI,Columbia,,2017,2.9,30883,31816,933
55021,WI,Columbia,,2018,2.7,30724,31572,848
55021,WI,Columbia,,2019,2.9,30890,31819,929
55021,WI,Columbia,,2020,6,29655,31532,1877
55021,WI,Columbia,,2021,3.4,30897,31978,1081
55023,WI,Crawford,,2007,5.3,9205,9723,518
55023,WI,Crawford,,2008,6,9033,9611,578
55023,WI,Crawford,,2009,10.3,8458,9426,968
55023,WI,Crawford,,2010,10.3,7506,8367,861
55023,WI,Crawford,,2011,9,7672,8431,759
55023,WI,Crawford,,2012,8.3,7598,8288,690
55023,WI,Crawford,,2013,8.1,7460,8120,660
55023,WI,Crawford,,2014,7,7420,7975,555
55023,WI,Crawford,,2015,5.7,7432,7882,450
55023,WI,Crawford,,2016,4.8,7523,7899,376
55023,WI,Crawford,,2017,4.1,7579,7905,326
55023,WI,Crawford,,2018,3.7,7575,7862,287
55023,WI,Crawford,,2019,4,7308,7614,306
55023,WI,Crawford,,2020,7.4,6907,7457,550
55023,WI,Crawford,,2021,4.4,7186,7518,332
55025,WI,Dane,,2007,3.4,282907,292864,9957
55025,WI,Dane,,2008,3.5,286154,296424,10270
55025,WI,Dane,,2009,6,281543,299671,18128
55025,WI,Dane,,2010,5.8,276445,293554,17109
55025,WI,Dane,,2011,5.2,279539,294807,15268
55025,WI,Dane,,2012,4.8,282929,297195,14266
55025,WI,Dane,,2013,4.7,287097,301102,14005
55025,WI,Dane,,2014,3.6,294301,305442,11141
55025,WI,Dane,,2015,3.1,300430,310088,9658
55025,WI,Dane,,2016,2.8,308144,316992,8848
55025,WI,Dane,,2017,2.4,313791,321487,7696
55025,WI,Dane,,2018,2.2,313959,321110,7151
55025,WI,Dane,,2019,2.3,318339,325885,7546
55025,WI,Dane,,2020,4.8,308816,324532,15716
55025,WI,Dane,,2021,2.8,322279,331664,9385
55027,WI,Dodge,,2007,5,44568,46910,2342
55027,WI,Dodge,,2008,5.1,44901,47323,2422
55027,WI,Dodge,,2009,10.1,42710,47482,4772
55027,WI,Dodge,,2010,8.9,43170,47372,4202
55027,WI,Dodge,,2011,7.6,43897,47513,3616
55027,WI,Dodge,,2012,7,44325,47681,3356
55027,WI,Dodge,,2013,6.8,44131,47360,3229
55027,WI,Dodge,,2014,5.3,44958,47472,2514
55027,WI,Dodge,,2015,4.3,45384,47425,2041
55027,WI,Dodge,,2016,3.6,46043,47741,1698
55027,WI,Dodge,,2017,2.9,47160,48559,1399
55027,WI,Dodge,,2018,2.6,46878,48132,1254
55027,WI,Dodge,,2019,2.9,46321,47687,1366
55027,WI,Dodge,,2020,5.3,45349,47884,2535
55027,WI,Dodge,,2021,3.2,46971,48501,1530
55029,WI,Door,,2007,5.3,16104,17009,905
55029,WI,Door,,2008,5.5,16262,17200,938
55029,WI,Door,,2009,9.2,15842,17455,1613
55029,WI,Door,,2010,11.1,14017,15760,1743
55029,WI,Door,,2011,11.7,13736,15555,1819
55029,WI,Door,,2012,10.1,14145,15735,1590
55029,WI,Door,,2013,9.8,14191,15732,1541
55029,WI,Door,,2014,8.1,14112,15349,1237
55029,WI,Door,,2015,6.5,14433,15436,1003
55029,WI,Door,,2016,4.8,14712,15457,745
55029,WI,Door,,2017,3.8,15023,15617,594
55029,WI,Door,,2018,3.5,14919,15468,549
55029,WI,Door,,2019,3.6,14839,15389,550
55029,WI,Door,,2020,6.8,14089,15125,1036
55029,WI,Door,,2021,4.4,14973,15656,683
55031,WI,Douglas,,2007,4.9,22034,23173,1139
55031,WI,Douglas,,2008,5.3,22189,23433,1244
55031,WI,Douglas,,2009,8.6,21570,23591,2021
55031,WI,Douglas,,2010,8.2,21809,23748,1939
55031,WI,Douglas,,2011,7.3,21833,23563,1730
55031,WI,Douglas,,2012,6.8,21825,23405,1580
55031,WI,Douglas,,2013,6.6,22015,23564,1549
55031,WI,Douglas,,2014,5.6,22196,23512,1316
55031,WI,Douglas,,2015,4.8,22165,23293,1128
55031,WI,Douglas,,2016,5.1,22295,23499,1204
55031,WI,Douglas,,2017,4.4,22575,23619,1044
55031,WI,Douglas,,2018,3.9,22378,23294,916
55031,WI,Douglas,,2019,4,22217,23137,920
55031,WI,Douglas,,2020,9.1,21315,23453,2138
55031,WI,Douglas,,2021,4.4,22100,23110,1010
55033,WI,Dunn,,2007,4.4,24816,25963,1147
55033,WI,Dunn,,2008,4.5,24460,25608,1148
55033,WI,Dunn,,2009,7.6,23916,25870,1954
55033,WI,Dunn,,2010,7.8,21457,23262,1805
55033,WI,Dunn,,2011,7.1,21656,23323,1667
55033,WI,Dunn,,2012,6.5,21890,23405,1515
55033,WI,Dunn,,2013,6.3,22051,23538,1487
55033,WI,Dunn,,2014,5.1,22397,23611,1214
55033,WI,Dunn,,2015,4.4,22673,23715,1042
55033,WI,Dunn,,2016,4,23290,24257,967
55033,WI,Dunn,,2017,3.2,23728,24523,795
55033,WI,Dunn,,2018,3,23712,24451,739
55033,WI,Dunn,,2019,3.4,23430,24246,816
55033,WI,Dunn,,2020,5.6,22559,23890,1331
55033,WI,Dunn,,2021,3.6,23412,24274,862
55035,WI,Eau Claire,,2007,4.1,54918,57278,2360
55035,WI,Eau Claire,,2008,4.2,54738,57125,2387
55035,WI,Eau Claire,,2009,7.1,52939,56993,4054
55035,WI,Eau Claire,,2010,6.8,53258,57161,3903
55035,WI,Eau Claire,,2011,6.3,54016,57621,3605
55035,WI,Eau Claire,,2012,5.7,54878,58200,3322
55035,WI,Eau Claire,,2013,5.6,54654,57905,3251
55035,WI,Eau Claire,,2014,4.4,55365,57929,2564
55035,WI,Eau Claire,,2015,3.7,55864,58024,2160
55035,WI,Eau Claire,,2016,3.3,56769,58728,1959
55035,WI,Eau Claire,,2017,2.9,57765,59484,1719
55035,WI,Eau Claire,,2018,2.6,57728,59263,1535
55035,WI,Eau Claire,,2019,2.9,57380,59093,1713
55035,WI,Eau Claire,,2020,5.6,55713,59026,3313
55035,WI,Eau Claire,,2021,3.2,58133,60074,1941
55037,WI,Florence,,2007,5.8,2353,2499,146
55037,WI,Florence,,2008,6,2317,2464,147
55037,WI,Florence,,2009,10.8,2159,2421,262
55037,WI,Florence,,2010,10.2,2019,2248,229
55037,WI,Florence,,2011,9.7,1990,2204,214
55037,WI,Florence,,2012,8.2,2027,2208,181
55037,WI,Florence,,2013,8.2,2015,2196,181
55037,WI,Florence,,2014,7.4,2040,2202,162
55037,WI,Florence,,2015,6.6,2061,2206,145
55037,WI,Florence,,2016,5.8,2093,2221,128
55037,WI,Florence,,2017,4.7,2188,2295,107
55037,WI,Florence,,2018,3.8,2189,2276,87
55037,WI,Florence,,2019,4.5,2120,2220,100
55037,WI,Florence,,2020,8,2032,2209,177
55037,WI,Florence,,2021,4.8,2137,2244,107
55039,WI,Fond du Lac,,2007,4.6,54238,56879,2641
55039,WI,Fond du Lac,,2008,4.8,54298,57058,2760
55039,WI,Fond du Lac,,2009,9.4,51152,56468,5316
55039,WI,Fond du Lac,,2010,8.3,51832,56550,4718
55039,WI,Fond du Lac,,2011,7.1,52087,56084,3997
55039,WI,Fond du Lac,,2012,6.4,52476,56061,3585
55039,WI,Fond du Lac,,2013,6.1,53569,57054,3485
55039,WI,Fond du Lac,,2014,4.8,54285,57050,2765
55039,WI,Fond du Lac,,2015,4,54630,56896,2266
55039,WI,Fond du Lac,,2016,3.4,54835,56786,1951
55039,WI,Fond du Lac,,2017,2.8,55611,57223,1612
55039,WI,Fond du Lac,,2018,2.6,55920,57429,1509
55039,WI,Fond du Lac,,2019,2.8,55886,57497,1611
55039,WI,Fond du Lac,,2020,5.9,53054,56385,3331
55039,WI,Fond du Lac,,2021,3.2,55311,57149,1838
55041,WI,Forest,,2007,7,4672,5024,352
55041,WI,Forest,,2008,7,4551,4896,345
55041,WI,Forest,,2009,10.7,4463,4998,535
55041,WI,Forest,,2010,11.5,3764,4253,489
55041,WI,Forest,,2011,11.3,3700,4173,473
55041,WI,Forest,,2012,10.8,3687,4135,448
55041,WI,Forest,,2013,10.9,3634,4078,444
55041,WI,Forest,,2014,8.6,3672,4016,344
55041,WI,Forest,,2015,7.3,3693,3984,291
55041,WI,Forest,,2016,6.1,3745,3987,242
55041,WI,Forest,,2017,5,3836,4038,202
55041,WI,Forest,,2018,4.8,3798,3988,190
55041,WI,Forest,,2019,4.9,3828,4026,198
55041,WI,Forest,,2020,12.6,3437,3934,497
55041,WI,Forest,,2021,6.7,3692,3957,265
55043,WI,Grant,,2007,4.7,26887,28220,1333
55043,WI,Grant,,2008,4.9,26806,28179,1373
55043,WI,Grant,,2009,7.8,26572,28835,2263
55043,WI,Grant,,2010,7.5,25721,27797,2076
55043,WI,Grant,,2011,6.6,26019,27864,1845
55043,WI,Grant,,2012,5.9,26042,27669,1627
55043,WI,Grant,,2013,5.8,26026,27643,1617
55043,WI,Grant,,2014,4.7,26394,27708,1314
55043,WI,Grant,,2015,4.3,26891,28094,1203
55043,WI,Grant,,2016,3.8,27054,28126,1072
55043,WI,Grant,,2017,3.1,27397,28280,883
55043,WI,Grant,,2018,2.8,27550,28337,787
55043,WI,Grant,,2019,3.1,27037,27894,857
55043,WI,Grant,,2020,5.2,26171,27619,1448
55043,WI,Grant,,2021,3,26817,27648,831
55045,WI,Green,,2007,4.6,19413,20353,940
55045,WI,Green,,2008,4.7,19436,20403,967
55045,WI,Green,,2009,9.3,18521,20417,1896
55045,WI,Green,,2010,7.8,19617,21288,1671
55045,WI,Green,,2011,6.7,19667,21076,1409
55045,WI,Green,,2012,6.1,19530,20806,1276
55045,WI,Green,,2013,5.7,19672,20856,1184
55045,WI,Green,,2014,4.4,19890,20815,925
55045,WI,Green,,2015,3.7,20259,21042,783
55045,WI,Green,,2016,3.2,20466,21153,687
55045,WI,Green,,2017,2.7,20615,21192,577
55045,WI,Green,,2018,2.6,20595,21134,539
55045,WI,Green,,2019,2.7,20583,21160,577
55045,WI,Green,,2020,4.9,19488,20491,1003
55045,WI,Green,,2021,3,20290,20919,629
55047,WI,Green Lake,,2007,5.3,9935,10496,561
55047,WI,Green Lake,,2008,5.6,9837,10424,587
55047,WI,Green Lake,,2009,10,9254,10287,1033
55047,WI,Green Lake,,2010,9.1,9368,10311,943
55047,WI,Green Lake,,2011,8,9531,10357,826
55047,WI,Green Lake,,2012,7.4,9539,10300,761
55047,WI,Green Lake,,2013,7.9,9398,10202,804
55047,WI,Green Lake,,2014,6.3,9396,10031,635
55047,WI,Green Lake,,2015,5.3,9439,9966,527
55047,WI,Green Lake,,2016,4.8,9270,9733,463
55047,WI,Green Lake,,2017,3.7,9378,9740,362
55047,WI,Green Lake,,2018,3.3,9418,9739,321
55047,WI,Green Lake,,2019,3.7,9144,9494,350
55047,WI,Green Lake,,2020,6.9,8686,9328,642
55047,WI,Green Lake,,2021,4.3,8980,9386,406
55049,WI,Iowa,,2007,4.4,13423,14048,625
55049,WI,Iowa,,2008,4.7,13435,14100,665
55049,WI,Iowa,,2009,8.1,12928,14064,1136
55049,WI,Iowa,,2010,8.1,12665,13779,1114
55049,WI,Iowa,,2011,7.2,12738,13721,983
55049,WI,Iowa,,2012,6.6,12646,13534,888
55049,WI,Iowa,,2013,6.4,12670,13541,871
55049,WI,Iowa,,2014,5,12854,13537,683
55049,WI,Iowa,,2015,4.1,13093,13659,566
55049,WI,Iowa,,2016,3.4,13195,13661,466
55049,WI,Iowa,,2017,2.9,13440,13844,404
55049,WI,Iowa,,2018,2.6,13481,13839,358
55049,WI,Iowa,,2019,2.7,13362,13738,376
55049,WI,Iowa,,2020,6.2,12733,13568,835
55049,WI,Iowa,,2021,3.4,13249,13712,463
55051,WI,Iron,,2007,7.9,2821,3063,242
55051,WI,Iron,,2008,8,2789,3032,243
55051,WI,Iron,,2009,12.6,2626,3006,380
55051,WI,Iron,,2010,11.2,2560,2882,322
55051,WI,Iron,,2011,10.5,2459,2746,287
55051,WI,Iron,,2012,10.3,2492,2778,286
55051,WI,Iron,,2013,10.6,2436,2726,290
55051,WI,Iron,,2014,9.3,2425,2675,250
55051,WI,Iron,,2015,8.6,2388,2612,224
55051,WI,Iron,,2016,7.3,2438,2629,191
55051,WI,Iron,,2017,6.1,2455,2615,160
55051,WI,Iron,,2018,5.8,2434,2583,149
55051,WI,Iron,,2019,5.8,2403,2550,147
55051,WI,Iron,,2020,11.4,2285,2578,293
55051,WI,Iron,,2021,6.4,2415,2580,165
55053,WI,Jackson,,2007,5.5,9314,9861,547
55053,WI,Jackson,,2008,5.8,9250,9815,565
55053,WI,Jackson,,2009,9.3,9090,10022,932
55053,WI,Jackson,,2010,8.6,9259,10128,869
55053,WI,Jackson,,2011,7.8,9405,10200,795
55053,WI,Jackson,,2012,7.2,9562,10302,740
55053,WI,Jackson,,2013,7,9434,10145,711
55053,WI,Jackson,,2014,5.8,9604,10192,588
55053,WI,Jackson,,2015,4.7,9840,10321,481
55053,WI,Jackson,,2016,4.3,9859,10298,439
55053,WI,Jackson,,2017,3.3,10109,10456,347
55053,WI,Jackson,,2018,3.1,10275,10601,326
55053,WI,Jackson,,2019,3.7,9910,10288,378
55053,WI,Jackson,,2020,9.3,9085,10020,935
55053,WI,Jackson,,2021,5.2,9120,9616,496
55055,WI,Jefferson,,2007,4.8,40221,42241,2020
55055,WI,Jefferson,,2008,4.9,40414,42508,2094
55055,WI,Jefferson,,2009,9.6,38756,42865,4109
55055,WI,Jefferson,,2010,8.6,42510,46492,3982
55055,WI,Jefferson,,2011,7.4,42905,46326,3421
55055,WI,Jefferson,,2012,6.6,43132,46162,3030
55055,WI,Jefferson,,2013,6.2,43042,45899,2857
55055,WI,Jefferson,,2014,4.9,43512,45761,2249
55055,WI,Jefferson,,2015,4.1,43657,45541,1884
55055,WI,Jefferson,,2016,3.8,43852,45585,1733
55055,WI,Jefferson,,2017,3.2,44308,45756,1448
55055,WI,Jefferson,,2018,2.8,44900,46214,1314
55055,WI,Jefferson,,2019,3,44685,46051,1366
55055,WI,Jefferson,,2020,5.5,43114,45622,2508
55055,WI,Jefferson,,2021,3.3,45172,46726,1554
55057,WI,Juneau,,2007,5.9,12506,13295,789
55057,WI,Juneau,,2008,6,12587,13394,807
55057,WI,Juneau,,2009,10.4,12194,13616,1422
55057,WI,Juneau,,2010,9.8,12359,13697,1338
55057,WI,Juneau,,2011,9,12446,13671,1225
55057,WI,Juneau,,2012,8.3,12444,13564,1120
55057,WI,Juneau,,2013,8.1,12387,13474,1087
55057,WI,Juneau,,2014,6.4,12515,13366,851
55057,WI,Juneau,,2015,5,12799,13475,676
55057,WI,Juneau,,2016,4.3,12916,13498,582
55057,WI,Juneau,,2017,3.3,13181,13631,450
55057,WI,Juneau,,2018,3,13142,13552,410
55057,WI,Juneau,,2019,3.2,13088,13514,426
55057,WI,Juneau,,2020,7.2,12485,13459,974
55057,WI,Juneau,,2021,4.3,12951,13532,581
55059,WI,Kenosha,,2007,5,80126,84386,4260
55059,WI,Kenosha,,2008,5.5,80901,85616,4715
55059,WI,Kenosha,,2009,10.9,77135,86569,9434
55059,WI,Kenosha,,2010,10.1,77060,85715,8655
55059,WI,Kenosha,,2011,8.8,78378,85958,7580
55059,WI,Kenosha,,2012,8,79739,86713,6974
55059,WI,Kenosha,,2013,7.6,80302,86909,6607
55059,WI,Kenosha,,2014,6,81481,86666,5185
55059,WI,Kenosha,,2015,5,82773,87124,4351
55059,WI,Kenosha,,2016,4.6,84061,88081,4020
55059,WI,Kenosha,,2017,3.8,86235,89686,3451
55059,WI,Kenosha,,2018,3.5,86650,89794,3144
55059,WI,Kenosha,,2019,3.8,87016,90410,3394
55059,WI,Kenosha,,2020,7.1,83601,90015,6414
55059,WI,Kenosha,,2021,4.3,87289,91211,3922
55061,WI,Kewaunee,,2007,4.5,11186,11719,533
55061,WI,Kewaunee,,2008,4.5,11054,11573,519
55061,WI,Kewaunee,,2009,8.2,10662,11612,950
55061,WI,Kewaunee,,2010,8,10285,11183,898
55061,WI,Kewaunee,,2011,7.2,10347,11152,805
55061,WI,Kewaunee,,2012,6.4,10296,11005,709
55061,WI,Kewaunee,,2013,6.3,10239,10932,693
55061,WI,Kewaunee,,2014,5,10289,10827,538
55061,WI,Kewaunee,,2015,4,10433,10867,434
55061,WI,Kewaunee,,2016,3.6,10611,11005,394
55061,WI,Kewaunee,,2017,3.1,10878,11222,344
55061,WI,Kewaunee,,2018,2.9,10918,11239,321
55061,WI,Kewaunee,,2019,3.1,10712,11050,338
55061,WI,Kewaunee,,2020,4.6,10247,10744,497
55061,WI,Kewaunee,,2021,2.8,10572,10882,310
55063,WI,La Crosse,,2007,3.8,61952,64432,2480
55063,WI,La Crosse,,2008,4,62895,65497,2602
55063,WI,La Crosse,,2009,7,61588,66196,4608
55063,WI,La Crosse,,2010,6.5,61376,65661,4285
55063,WI,La Crosse,,2011,5.8,61620,65443,3823
55063,WI,La Crosse,,2012,5.4,62801,66357,3556
55063,WI,La Crosse,,2013,5.3,63241,66755,3514
55063,WI,La Crosse,,2014,4.3,63762,66625,2863
55063,WI,La Crosse,,2015,3.8,63958,66464,2506
55063,WI,La Crosse,,2016,3.5,65012,67388,2376
55063,WI,La Crosse,,2017,2.9,65900,67867,1967
55063,WI,La Crosse,,2018,2.6,65420,67166,1746
55063,WI,La Crosse,,2019,2.8,64578,66408,1830
55063,WI,La Crosse,,2020,5.4,62474,66060,3586
55063,WI,La Crosse,,2021,3,65207,67244,2037
55065,WI,Lafayette,,2007,4.1,8935,9314,379
55065,WI,Lafayette,,2008,4.3,8730,9119,389
55065,WI,Lafayette,,2009,7.6,8604,9307,703
55065,WI,Lafayette,,2010,7,8830,9498,668
55065,WI,Lafayette,,2011,6.2,8872,9461,589
55065,WI,Lafayette,,2012,5.5,8872,9390,518
55065,WI,Lafayette,,2013,5.3,8846,9346,500
55065,WI,Lafayette,,2014,4.2,9000,9391,391
55065,WI,Lafayette,,2015,3.6,9376,9725,349
55065,WI,Lafayette,,2016,3.1,9514,9818,304
55065,WI,Lafayette,,2017,2.5,9930,10186,256
55065,WI,Lafayette,,2018,2.3,10013,10246,233
55065,WI,Lafayette,,2019,2.5,9881,10136,255
55065,WI,Lafayette,,2020,4.3,9498,9924,426
55065,WI,Lafayette,,2021,2.6,9976,10241,265
55067,WI,Langlade,,2007,6.1,10039,10686,647
55067,WI,Langlade,,2008,6.1,10042,10700,658
55067,WI,Langlade,,2009,10.6,9869,11038,1169
55067,WI,Langlade,,2010,10.8,9083,10180,1097
55067,WI,Langlade,,2011,9.9,9042,10032,990
55067,WI,Langlade,,2012,9.1,9046,9957,911
55067,WI,Langlade,,2013,9,8923,9808,885
55067,WI,Langlade,,2014,7.4,8843,9552,709
55067,WI,Langlade,,2015,5.9,8886,9447,561
55067,WI,Langlade,,2016,5.1,9064,9548,484
55067,WI,Langlade,,2017,4.2,9266,9671,405
55067,WI,Langlade,,2018,3.9,9141,9515,374
55067,WI,Langlade,,2019,4,8969,9338,369
55067,WI,Langlade,,2020,6.5,8789,9402,613
55067,WI,Langlade,,2021,4.5,9091,9521,430
55069,WI,Lincoln,,2007,5.6,14702,15566,864
55069,WI,Lincoln,,2008,5.8,14681,15581,900
55069,WI,Lincoln,,2009,11.7,13830,15667,1837
55069,WI,Lincoln,,2010,11.1,13920,15664,1744
55069,WI,Lincoln,,2011,9.6,13819,15287,1468
55069,WI,Lincoln,,2012,9,13730,15087,1357
55069,WI,Lincoln,,2013,8.3,13919,15173,1254
55069,WI,Lincoln,,2014,6.1,14415,15356,941
55069,WI,Lincoln,,2015,4.9,14475,15217,742
55069,WI,Lincoln,,2016,4.3,14570,15218,648
55069,WI,Lincoln,,2017,3.5,14996,15544,548
55069,WI,Lincoln,,2018,3.1,14843,15319,476
55069,WI,Lincoln,,2019,3.5,14582,15115,533
55069,WI,Lincoln,,2020,5.9,13990,14875,885
55069,WI,Lincoln,,2021,3.7,14379,14926,547
55071,WI,Manitowoc,,2007,5.4,42310,44704,2394
55071,WI,Manitowoc,,2008,5,43027,45306,2279
55071,WI,Manitowoc,,2009,10.4,41680,46514,4834
55071,WI,Manitowoc,,2010,9.7,40294,44618,4324
55071,WI,Manitowoc,,2011,8.2,40740,44389,3649
55071,WI,Manitowoc,,2012,7.6,40297,43634,3337
55071,WI,Manitowoc,,2013,7.3,39554,42680,3126
55071,WI,Manitowoc,,2014,6,39973,42506,2533
55071,WI,Manitowoc,,2015,4.9,39741,41789,2048
55071,WI,Manitowoc,,2016,4.2,39977,41731,1754
55071,WI,Manitowoc,,2017,3.5,40370,41833,1463
55071,WI,Manitowoc,,2018,3.1,40087,41355,1268
55071,WI,Manitowoc,,2019,3.2,39761,41088,1327
55071,WI,Manitowoc,,2020,6.2,38371,40918,2547
55071,WI,Manitowoc,,2021,3.4,39988,41403,1415
55073,WI,Marathon,,2007,4.3,72711,75973,3262
55073,WI,Marathon,,2008,4.6,72086,75565,3479
55073,WI,Marathon,,2009,9.2,68365,75251,6886
55073,WI,Marathon,,2010,9.1,66842,73558,6716
55073,WI,Marathon,,2011,7.7,66963,72541,5578
55073,WI,Marathon,,2012,7.2,66398,71558,5160
55073,WI,Marathon,,2013,6.7,67301,72105,4804
55073,WI,Marathon,,2014,5,69446,73076,3630
55073,WI,Marathon,,2015,3.9,70401,73287,2886
55073,WI,Marathon,,2016,3.5,70883,73437,2554
55073,WI,Marathon,,2017,2.9,71936,74098,2162
55073,WI,Marathon,,2018,2.6,72236,74184,1948
55073,WI,Marathon,,2019,2.8,71689,73718,2029
55073,WI,Marathon,,2020,5,69592,73260,3668
55073,WI,Marathon,,2021,3,72132,74339,2207
55075,WI,Marinette,,2007,6.1,20960,22331,1371
55075,WI,Marinette,,2008,6.2,20759,22125,1366
55075,WI,Marinette,,2009,12.1,19846,22571,2725
55075,WI,Marinette,,2010,10.9,19056,21383,2327
55075,WI,Marinette,,2011,9.5,19434,21464,2030
55075,WI,Marinette,,2012,8.2,19658,21419,1761
55075,WI,Marinette,,2013,7.9,19754,21441,1687
55075,WI,Marinette,,2014,6.7,19664,21067,1403
55075,WI,Marinette,,2015,5.7,19515,20691,1176
55075,WI,Marinette,,2016,5.3,19094,20173,1079
55075,WI,Marinette,,2017,4.4,18946,19816,870
55075,WI,Marinette,,2018,4,18887,19670,783
55075,WI,Marinette,,2019,4.4,18645,19494,849
55075,WI,Marinette,,2020,7.8,18215,19762,1547
55075,WI,Marinette,,2021,4.4,18777,19634,857
55077,WI,Marquette,,2007,6,7447,7923,476
55077,WI,Marquette,,2008,6.4,7339,7842,503
55077,WI,Marquette,,2009,10.7,6983,7823,840
55077,WI,Marquette,,2010,10.6,6870,7685,815
55077,WI,Marquette,,2011,9.7,6850,7583,733
55077,WI,Marquette,,2012,8.6,6910,7564,654
55077,WI,Marquette,,2013,8.4,6877,7505,628
55077,WI,Marquette,,2014,7.1,6799,7316,517
55077,WI,Marquette,,2015,6,7028,7476,448
55077,WI,Marquette,,2016,5,7159,7532,373
55077,WI,Marquette,,2017,3.8,7338,7628,290
55077,WI,Marquette,,2018,3.5,7450,7721,271
55077,WI,Marquette,,2019,3.7,7473,7763,290
55077,WI,Marquette,,2020,6.7,7235,7758,523
55077,WI,Marquette,,2021,4.4,7493,7840,347
55078,WI,Menominee,,2007,10.3,1479,1648,169
55078,WI,Menominee,,2008,10.7,1470,1647,177
55078,WI,Menominee,,2009,14.5,1411,1650,239
55078,WI,Menominee,,2010,17.2,1282,1548,266
55078,WI,Menominee,,2011,16.8,1327,1595,268
55078,WI,Menominee,,2012,16.1,1330,1585,255
55078,WI,Menominee,,2013,15.7,1324,1571,247
55078,WI,Menominee,,2014,12.2,1401,1596,195
55078,WI,Menominee,,2015,9.4,1447,1598,151
55078,WI,Menominee,,2016,7.5,1452,1569,117
55078,WI,Menominee,,2017,5.9,1517,1612,95
55078,WI,Menominee,,2018,5.8,1537,1631,94
55078,WI,Menominee,,2019,7.8,1473,1598,125
55078,WI,Menominee,,2020,15.5,1407,1666,259
55078,WI,Menominee,,2021,8.6,1456,1593,137
55079,WI,Milwaukee,,2007,5.7,442863,469623,26760
55079,WI,Milwaukee,,2008,5.7,443464,470352,26888
55079,WI,Milwaukee,,2009,9.9,423341,469652,46311
55079,WI,Milwaukee,,2010,9.8,429808,476599,46791
55079,WI,Milwaukee,,2011,9.1,433145,476301,43156
55079,WI,Milwaukee,,2012,8.5,435411,475758,40347
55079,WI,Milwaukee,,2013,8.3,438862,478784,39922
55079,WI,Milwaukee,,2014,6.8,445584,478001,32417
55079,WI,Milwaukee,,2015,5.6,448993,475735,26742
55079,WI,Milwaukee,,2016,4.9,452193,475320,23127
55079,WI,Milwaukee,,2017,4,457332,476413,19081
55079,WI,Milwaukee,,2018,3.6,453165,470208,17043
55079,WI,Milwaukee,,2019,3.8,449725,467554,17829
55079,WI,Milwaukee,,2020,8.3,429967,468910,38943
55079,WI,Milwaukee,,2021,5.4,443758,469201,25443
55081,WI,Monroe,,2007,4.5,22982,24073,1091
55081,WI,Monroe,,2008,4.7,23365,24518,1153
55081,WI,Monroe,,2009,8,22882,24868,1986
55081,WI,Monroe,,2010,7.8,21330,23140,1810
55081,WI,Monroe,,2011,7.2,21473,23132,1659
55081,WI,Monroe,,2012,7.2,21126,22759,1633
55081,WI,Monroe,,2013,6.8,21199,22756,1557
55081,WI,Monroe,,2014,5.3,21321,22520,1199
55081,WI,Monroe,,2015,4.4,21787,22778,991
55081,WI,Monroe,,2016,3.7,22110,22965,855
55081,WI,Monroe,,2017,2.9,22903,23591,688
55081,WI,Monroe,,2018,2.7,22985,23627,642
55081,WI,Monroe,,2019,2.9,22798,23468,670
55081,WI,Monroe,,2020,5.6,22318,23640,1322
55081,WI,Monroe,,2021,3.2,23013,23783,770
55083,WI,Oconto,,2007,6.1,19101,20346,1245
55083,WI,Oconto,,2008,6.4,19040,20337,1297
55083,WI,Oconto,,2009,11.8,18246,20688,2442
55083,WI,Oconto,,2010,10.6,19085,21337,2252
55083,WI,Oconto,,2011,9.4,19086,21058,1972
55083,WI,Oconto,,2012,8.3,18927,20629,1702
55083,WI,Oconto,,2013,7.7,18882,20447,1565
55083,WI,Oconto,,2014,6.1,19079,20321,1242
55083,WI,Oconto,,2015,5,19266,20288,1022
55083,WI,Oconto,,2016,4.3,19527,20406,879
55083,WI,Oconto,,2017,3.5,19980,20705,725
55083,WI,Oconto,,2018,3.3,20156,20837,681
55083,WI,Oconto,,2019,3.4,19876,20584,708
55083,WI,Oconto,,2020,6.3,19369,20670,1301
55083,WI,Oconto,,2021,3.7,20039,20816,777
55085,WI,Oneida,,2007,6.1,18247,19426,1179
55085,WI,Oneida,,2008,6.2,18055,19246,1191
55085,WI,Oneida,,2009,10.1,17124,19058,1934
55085,WI,Oneida,,2010,10,17161,19067,1906
55085,WI,Oneida,,2011,9.2,17111,18839,1728
55085,WI,Oneida,,2012,8.6,17473,19109,1636
55085,WI,Oneida,,2013,8.5,17004,18586,1582
55085,WI,Oneida,,2014,6.6,17497,18743,1246
55085,WI,Oneida,,2015,5.6,17536,18582,1046
55085,WI,Oneida,,2016,4.7,17654,18531,877
55085,WI,Oneida,,2017,3.8,17716,18413,697
55085,WI,Oneida,,2018,3.5,17570,18212,642
55085,WI,Oneida,,2019,4.1,17213,17948,735
55085,WI,Oneida,,2020,7.3,16774,18086,1312
55085,WI,Oneida,,2021,4.3,17422,18205,783
55087,WI,Outagamie,,2007,4.6,92720,97151,4431
55087,WI,Outagamie,,2008,4.7,93480,98099,4619
55087,WI,Outagamie,,2009,8.7,91058,99722,8664
55087,WI,Outagamie,,2010,7.9,92663,100664,8001
55087,WI,Outagamie,,2011,6.9,93255,100142,6887
55087,WI,Outagamie,,2012,6.3,93883,100212,6329
55087,WI,Outagamie,,2013,6.1,94378,100461,6083
55087,WI,Outagamie,,2014,4.7,96425,101176,4751
55087,WI,Outagamie,,2015,3.9,97778,101717,3939
55087,WI,Outagamie,,2016,3.5,100040,103617,3577
55087,WI,Outagamie,,2017,3,101177,104295,3118
55087,WI,Outagamie,,2018,2.8,100823,103706,2883
55087,WI,Outagamie,,2019,2.8,100792,103721,2929
55087,WI,Outagamie,,2020,5.5,98393,104152,5759
55087,WI,Outagamie,,2021,3.1,101769,105055,3286
55089,WI,Ozaukee,,2007,3.8,46054,47854,1800
55089,WI,Ozaukee,,2008,3.9,46162,48033,1871
55089,WI,Ozaukee,,2009,7.8,44006,47739,3733
55089,WI,Ozaukee,,2010,7,44157,47460,3303
55089,WI,Ozaukee,,2011,6,44532,47356,2824
55089,WI,Ozaukee,,2012,5.4,44774,47334,2560
55089,WI,Ozaukee,,2013,5.2,45048,47520,2472
55089,WI,Ozaukee,,2014,4.2,45896,47895,1999
55089,WI,Ozaukee,,2015,3.6,46393,48129,1736
55089,WI,Ozaukee,,2016,3.3,47327,48924,1597
55089,WI,Ozaukee,,2017,2.7,47960,49310,1350
55089,WI,Ozaukee,,2018,2.5,48192,49431,1239
55089,WI,Ozaukee,,2019,2.7,47943,49283,1340
55089,WI,Ozaukee,,2020,5.4,46310,48975,2665
55089,WI,Ozaukee,,2021,3.1,47882,49395,1513
55091,WI,Pepin,,2007,5,3915,4121,206
55091,WI,Pepin,,2008,4.8,3909,4105,196
55091,WI,Pepin,,2009,7.7,3829,4148,319
55091,WI,Pepin,,2010,7.3,3798,4098,300
55091,WI,Pepin,,2011,6.2,3838,4092,254
55091,WI,Pepin,,2012,5.6,3844,4073,229
55091,WI,Pepin,,2013,5.6,3803,4030,227
55091,WI,Pepin,,2014,4.7,3837,4026,189
55091,WI,Pepin,,2015,4.1,3930,4097,167
55091,WI,Pepin,,2016,3.7,4001,4155,154
55091,WI,Pepin,,2017,3.5,4081,4228,147
55091,WI,Pepin,,2018,3.2,4102,4238,136
55091,WI,Pepin,,2019,3.5,4020,4166,146
55091,WI,Pepin,,2020,5.9,3897,4140,243
55091,WI,Pepin,,2021,3.4,3990,4129,139
55093,WI,Pierce,,2007,4.3,22786,23807,1021
55093,WI,Pierce,,2008,4.4,23024,24088,1064
55093,WI,Pierce,,2009,8,21698,23573,1875
55093,WI,Pierce,,2010,6.8,22368,24002,1634
55093,WI,Pierce,,2011,5.9,22542,23950,1408
55093,WI,Pierce,,2012,5.4,22576,23874,1298
55093,WI,Pierce,,2013,5.2,22737,23993,1256
55093,WI,Pierce,,2014,4.4,22945,23991,1046
55093,WI,Pierce,,2015,3.8,23152,24077,925
55093,WI,Pierce,,2016,3.9,23645,24617,972
55093,WI,Pierce,,2017,3.3,24398,25238,840
55093,WI,Pierce,,2018,3.2,24743,25552,809
55093,WI,Pierce,,2019,3.2,24626,25445,819
55093,WI,Pierce,,2020,7,23256,25010,1754
55093,WI,Pierce,,2021,3.4,24184,25048,864
55095,WI,Polk,,2007,6.1,22734,24215,1481
55095,WI,Polk,,2008,6,22678,24118,1440
55095,WI,Polk,,2009,10.8,21766,24388,2622
55095,WI,Polk,,2010,9.8,21702,24054,2352
55095,WI,Polk,,2011,8.4,22063,24083,2020
55095,WI,Polk,,2012,7.9,22070,23969,1899
55095,WI,Polk,,2013,7.1,22582,24302,1720
55095,WI,Polk,,2014,5.6,23030,24408,1378
55095,WI,Polk,,2015,4.7,23386,24544,1158
55095,WI,Polk,,2016,4.5,23701,24806,1105
55095,WI,Polk,,2017,3.7,23984,24912,928
55095,WI,Polk,,2018,3.7,23758,24662,904
55095,WI,Polk,,2019,3.8,23700,24644,944
55095,WI,Polk,,2020,7.2,22992,24772,1780
55095,WI,Polk,,2021,4.2,23985,25025,1040
55097,WI,Portage,,2007,4.4,40106,41954,1848
55097,WI,Portage,,2008,4.6,40377,42312,1935
55097,WI,Portage,,2009,7.5,40057,43289,3232
55097,WI,Portage,,2010,7.9,36752,39885,3133
55097,WI,Portage,,2011,7.3,36062,38920,2858
55097,WI,Portage,,2012,7.2,36071,38872,2801
55097,WI,Portage,,2013,6.9,36266,38939,2673
55097,WI,Portage,,2014,5.5,37092,39247,2155
55097,WI,Portage,,2015,4.5,37715,39484,1769
55097,WI,Portage,,2016,3.7,37920,39386,1466
55097,WI,Portage,,2017,3,38527,39737,1210
55097,WI,Portage,,2018,3,38039,39206,1167
55097,WI,Portage,,2019,3.1,37481,38677,1196
55097,WI,Portage,,2020,5.4,35883,37941,2058
55097,WI,Portage,,2021,3.5,37021,38366,1345
55099,WI,Price,,2007,5,7817,8230,413
55099,WI,Price,,2008,5.1,7946,8373,427
55099,WI,Price,,2009,11.4,7430,8384,954
55099,WI,Price,,2010,10.7,6751,7564,813
55099,WI,Price,,2011,8.7,6579,7208,629
55099,WI,Price,,2012,7.4,6519,7040,521
55099,WI,Price,,2013,6.8,6384,6853,469
55099,WI,Price,,2014,5.3,6410,6770,360
55099,WI,Price,,2015,4.3,6537,6834,297
55099,WI,Price,,2016,4.2,6576,6864,288
55099,WI,Price,,2017,3.7,6561,6814,253
55099,WI,Price,,2018,3.7,6410,6655,245
55099,WI,Price,,2019,4.2,6208,6480,272
55099,WI,Price,,2020,6.8,5860,6289,429
55099,WI,Price,,2021,4.2,6075,6341,266
55101,WI,Racine,,2007,5.8,94452,100239,5787
55101,WI,Racine,,2008,5.9,94253,100113,5860
55101,WI,Racine,,2009,10.7,89191,99862,10671
55101,WI,Racine,,2010,10,90325,100315,9990
55101,WI,Racine,,2011,8.8,91402,100238,8836
55101,WI,Racine,,2012,8.2,92031,100290,8259
55101,WI,Racine,,2013,8.3,91452,99697,8245
55101,WI,Racine,,2014,6.5,93226,99713,6487
55101,WI,Racine,,2015,5.5,93644,99081,5437
55101,WI,Racine,,2016,4.8,94662,99453,4791
55101,WI,Racine,,2017,4,95938,99964,4026
55101,WI,Racine,,2018,3.6,95909,99492,3583
55101,WI,Racine,,2019,3.9,95042,98894,3852
55101,WI,Racine,,2020,7.3,91314,98515,7201
55101,WI,Racine,,2021,4.7,94312,98979,4667
55103,WI,Richland,,2007,5.1,9428,9939,511
55103,WI,Richland,,2008,4.8,9768,10257,489
55103,WI,Richland,,2009,9.2,9254,10195,941
55103,WI,Richland,,2010,8.9,8784,9637,853
55103,WI,Richland,,2011,7.3,8952,9652,700
55103,WI,Richland,,2012,6.2,9102,9699,597
55103,WI,Richland,,2013,6,8782,9346,564
55103,WI,Richland,,2014,5,8835,9298,463
55103,WI,Richland,,2015,4.1,8891,9271,380
55103,WI,Richland,,2016,3.7,8901,9240,339
55103,WI,Richland,,2017,3,9037,9313,276
55103,WI,Richland,,2018,2.6,9084,9326,242
55103,WI,Richland,,2019,3,8958,9234,276
55103,WI,Richland,,2020,5.1,8661,9129,468
55103,WI,Richland,,2021,3.5,8758,9076,318
55105,WI,Rock,,2007,5.5,79712,84369,4657
55105,WI,Rock,,2008,6.3,78444,83733,5289
55105,WI,Rock,,2009,13.1,72030,82897,10867
55105,WI,Rock,,2010,11.1,73550,82708,9158
55105,WI,Rock,,2011,9.3,73427,80950,7523
55105,WI,Rock,,2012,8.2,74650,81306,6656
55105,WI,Rock,,2013,7.7,75851,82138,6287
55105,WI,Rock,,2014,6,77215,82181,4966
55105,WI,Rock,,2015,5.1,78910,83122,4212
55105,WI,Rock,,2016,4.3,80279,83884,3605
55105,WI,Rock,,2017,3.7,82375,85513,3138
55105,WI,Rock,,2018,3.2,82522,85275,2753
55105,WI,Rock,,2019,3.5,82813,85861,3048
55105,WI,Rock,,2020,7.1,79829,85964,6135
55105,WI,Rock,,2021,4.4,82991,86855,3864
55107,WI,Rusk,,2007,7.2,6778,7303,525
55107,WI,Rusk,,2008,7.1,6751,7265,514
55107,WI,Rusk,,2009,13.5,6424,7427,1003
55107,WI,Rusk,,2010,12.1,6278,7140,862
55107,WI,Rusk,,2011,10.8,6125,6865,740
55107,WI,Rusk,,2012,8.9,6169,6772,603
55107,WI,Rusk,,2013,8.5,6161,6731,570
55107,WI,Rusk,,2014,6.5,6534,6985,451
55107,WI,Rusk,,2015,5.3,6605,6978,373
55107,WI,Rusk,,2016,5,6634,6983,349
55107,WI,Rusk,,2017,4.4,6700,7008,308
55107,WI,Rusk,,2018,3.9,6703,6978,275
55107,WI,Rusk,,2019,4.6,6433,6746,313
55107,WI,Rusk,,2020,6.7,6181,6623,442
55107,WI,Rusk,,2021,4.4,6340,6633,293
55109,WI,St. Croix,,2007,4.8,45041,47326,2285
55109,WI,St. Croix,,2008,4.5,45495,47650,2155
55109,WI,St. Croix,,2009,8.4,43509,47498,3989
55109,WI,St. Croix,,2010,7.5,43566,47093,3527
55109,WI,St. Croix,,2011,6.2,44459,47418,2959
55109,WI,St. Croix,,2012,5.7,44756,47437,2681
55109,WI,St. Croix,,2013,5.3,45251,47803,2552
55109,WI,St. Croix,,2014,4.4,46130,48256,2126
55109,WI,St. Croix,,2015,3.7,46875,48697,1822
55109,WI,St. Croix,,2016,3.7,47714,49537,1823
55109,WI,St. Croix,,2017,3.1,48755,50311,1556
55109,WI,St. Croix,,2018,3,49115,50635,1520
55109,WI,St. Croix,,2019,3.2,49302,50917,1615
55109,WI,St. Croix,,2020,7,47270,50854,3584
55109,WI,St. Croix,,2021,3.4,49212,50927,1715
55111,WI,Sauk,,2007,4.6,33423,35049,1626
55111,WI,Sauk,,2008,5,33619,35373,1754
55111,WI,Sauk,,2009,8.7,32744,35845,3101
55111,WI,Sauk,,2010,8.3,32906,35869,2963
55111,WI,Sauk,,2011,7.4,33260,35923,2663
55111,WI,Sauk,,2012,6.8,33177,35592,2415
55111,WI,Sauk,,2013,6.2,33181,35375,2194
55111,WI,Sauk,,2014,4.9,33229,34945,1716
55111,WI,Sauk,,2015,4,33806,35218,1412
55111,WI,Sauk,,2016,3.5,33921,35144,1223
55111,WI,Sauk,,2017,2.9,34615,35643,1028
55111,WI,Sauk,,2018,2.5,34777,35682,905
55111,WI,Sauk,,2019,2.8,34788,35779,991
55111,WI,Sauk,,2020,7.5,32125,34747,2622
55111,WI,Sauk,,2021,4,33522,34936,1414
55113,WI,Sawyer,,2007,6.7,8928,9566,638
55113,WI,Sawyer,,2008,7.1,8513,9161,648
55113,WI,Sawyer,,2009,10.4,8176,9130,954
55113,WI,Sawyer,,2010,11.1,7463,8394,931
55113,WI,Sawyer,,2011,10.8,7272,8156,884
55113,WI,Sawyer,,2012,10.6,7386,8261,875
55113,WI,Sawyer,,2013,10.9,7296,8184,888
55113,WI,Sawyer,,2014,8.8,7243,7942,699
55113,WI,Sawyer,,2015,7.7,7187,7787,600
55113,WI,Sawyer,,2016,6.1,7413,7893,480
55113,WI,Sawyer,,2017,4.6,7649,8019,370
55113,WI,Sawyer,,2018,4.3,7636,7977,341
55113,WI,Sawyer,,2019,4.5,7664,8026,362
55113,WI,Sawyer,,2020,7.9,7393,8027,634
55113,WI,Sawyer,,2021,5.1,7696,8109,413
55115,WI,Shawano,,2007,5.2,21018,22163,1145
55115,WI,Shawano,,2008,5.3,21049,22219,1170
55115,WI,Shawano,,2009,9.7,20565,22774,2209
55115,WI,Shawano,,2010,10.1,19689,21892,2203
55115,WI,Shawano,,2011,8.9,19784,21718,1934
55115,WI,Shawano,,2012,7.9,19894,21593,1699
55115,WI,Shawano,,2013,7.4,19869,21460,1591
55115,WI,Shawano,,2014,5.8,20026,21270,1244
55115,WI,Shawano,,2015,4.8,20221,21231,1010
55115,WI,Shawano,,2016,4,20375,21235,860
55115,WI,Shawano,,2017,3.2,20824,21510,686
55115,WI,Shawano,,2018,3,20834,21475,641
55115,WI,Shawano,,2019,3.1,20499,21147,648
55115,WI,Shawano,,2020,6.4,19627,20976,1349
55115,WI,Shawano,,2021,3.7,20394,21183,789
55117,WI,Sheboygan,,2007,4.1,63339,66079,2740
55117,WI,Sheboygan,,2008,4.5,62849,65838,2989
55117,WI,Sheboygan,,2009,9.6,58953,65203,6250
55117,WI,Sheboygan,,2010,9.1,56584,62269,5685
55117,WI,Sheboygan,,2011,8,56044,60899,4855
55117,WI,Sheboygan,,2012,6.7,56175,60238,4063
55117,WI,Sheboygan,,2013,6,57074,60745,3671
55117,WI,Sheboygan,,2014,4.5,58410,61151,2741
55117,WI,Sheboygan,,2015,3.7,58857,61110,2253
55117,WI,Sheboygan,,2016,3.3,59535,61579,2044
55117,WI,Sheboygan,,2017,2.8,61028,62758,1730
55117,WI,Sheboygan,,2018,2.5,61177,62736,1559
55117,WI,Sheboygan,,2019,2.6,60834,62462,1628
55117,WI,Sheboygan,,2020,5.8,58505,62077,3572
55117,WI,Sheboygan,,2021,3.1,60350,62287,1937
55119,WI,Taylor,,2007,5.6,9880,10469,589
55119,WI,Taylor,,2008,6.6,9780,10476,696
55119,WI,Taylor,,2009,12,9505,10804,1299
55119,WI,Taylor,,2010,10.1,10296,11450,1154
55119,WI,Taylor,,2011,8.2,10337,11266,929
55119,WI,Taylor,,2012,7.1,10283,11065,782
55119,WI,Taylor,,2013,6.4,10286,10985,699
55119,WI,Taylor,,2014,5.3,10067,10625,558
55119,WI,Taylor,,2015,4.3,10214,10672,458
55119,WI,Taylor,,2016,4,10605,11048,443
55119,WI,Taylor,,2017,3.4,10759,11141,382
55119,WI,Taylor,,2018,3.1,10729,11069,340
55119,WI,Taylor,,2019,3.5,10594,10977,383
55119,WI,Taylor,,2020,4.9,10555,11097,542
55119,WI,Taylor,,2021,3.3,10823,11197,374
55121,WI,Trempealeau,,2007,4.4,15590,16308,718
55121,WI,Trempealeau,,2008,4.6,15470,16219,749
55121,WI,Trempealeau,,2009,7.9,15075,16370,1295
55121,WI,Trempealeau,,2010,7.4,14810,15998,1188
55121,WI,Trempealeau,,2011,6.5,15119,16165,1046
55121,WI,Trempealeau,,2012,5.6,15432,16350,918
55121,WI,Trempealeau,,2013,5.5,15501,16411,910
55121,WI,Trempealeau,,2014,4.5,15767,16508,741
55121,WI,Trempealeau,,2015,3.8,15943,16576,633
55121,WI,Trempealeau,,2016,3.6,16024,16622,598
55121,WI,Trempealeau,,2017,3,16018,16519,501
55121,WI,Trempealeau,,2018,2.8,15906,16368,462
55121,WI,Trempealeau,,2019,3.4,15465,16013,548
55121,WI,Trempealeau,,2020,7,14690,15801,1111
55121,WI,Trempealeau,,2021,3.7,15033,15613,580
55123,WI,Vernon,,2007,5.1,13488,14215,727
55123,WI,Vernon,,2008,4.9,13969,14695,726
55123,WI,Vernon,,2009,8.2,14055,15303,1248
55123,WI,Vernon,,2010,7.8,13997,15173,1176
55123,WI,Vernon,,2011,6.8,14117,15146,1029
55123,WI,Vernon,,2012,6.3,14083,15026,943
55123,WI,Vernon,,2013,5.9,14235,15131,896
55123,WI,Vernon,,2014,4.8,14310,15026,716
55123,WI,Vernon,,2015,4,14836,15456,620
55123,WI,Vernon,,2016,3.6,15158,15716,558
55123,WI,Vernon,,2017,3.1,15294,15777,483
55123,WI,Vernon,,2018,2.8,15071,15513,442
55123,WI,Vernon,,2019,3.1,14975,15456,481
55123,WI,Vernon,,2020,5.2,14305,15096,791
55123,WI,Vernon,,2021,3.2,15029,15531,502
55125,WI,Vilas,,2007,6.3,10857,11585,728
55125,WI,Vilas,,2008,6.5,10545,11277,732
55125,WI,Vilas,,2009,10.3,9901,11043,1142
55125,WI,Vilas,,2010,11.1,9197,10343,1146
55125,WI,Vilas,,2011,10.7,9045,10126,1081
55125,WI,Vilas,,2012,9.9,9087,10080,993
55125,WI,Vilas,,2013,10.1,9152,10175,1023
55125,WI,Vilas,,2014,8.3,9228,10066,838
55125,WI,Vilas,,2015,6.9,9287,9970,683
55125,WI,Vilas,,2016,5.5,9394,9943,549
55125,WI,Vilas,,2017,4.3,9753,10191,438
55125,WI,Vilas,,2018,3.9,9785,10183,398
55125,WI,Vilas,,2019,4,9844,10255,411
55125,WI,Vilas,,2020,7.2,9667,10419,752
55125,WI,Vilas,,2021,4.7,10064,10564,500
55127,WI,Walworth,,2007,4.5,53531,56078,2547
55127,WI,Walworth,,2008,4.8,53942,56663,2721
55127,WI,Walworth,,2009,9.5,51080,56421,5341
55127,WI,Walworth,,2010,8.9,51392,56391,4999
55127,WI,Walworth,,2011,7.8,51754,56124,4370
55127,WI,Walworth,,2012,7.1,51974,55965,3991
55127,WI,Walworth,,2013,6.8,52919,56775,3856
55127,WI,Walworth,,2014,5.5,53825,56932,3107
55127,WI,Walworth,,2015,4.5,54266,56843,2577
55127,WI,Walworth,,2016,3.9,55307,57550,2243
55127,WI,Walworth,,2017,3.2,56223,58110,1887
55127,WI,Walworth,,2018,2.9,56744,58449,1705
55127,WI,Walworth,,2019,3.1,56215,58029,1814
55127,WI,Walworth,,2020,6.1,53583,57061,3478
55127,WI,Walworth,,2021,3.6,56288,58402,2114
55129,WI,Washburn,,2007,6.7,7367,7898,531
55129,WI,Washburn,,2008,6.7,7333,7861,528
55129,WI,Washburn,,2009,10.2,7173,7989,816
55129,WI,Washburn,,2010,9.5,7278,8046,768
55129,WI,Washburn,,2011,8.7,7271,7963,692
55129,WI,Washburn,,2012,7.8,7449,8077,628
55129,WI,Washburn,,2013,7.4,7406,7995,589
55129,WI,Washburn,,2014,6.1,7435,7921,486
55129,WI,Washburn,,2015,5.2,7519,7935,416
55129,WI,Washburn,,2016,4.9,7566,7952,386
55129,WI,Washburn,,2017,3.9,7629,7938,309
55129,WI,Washburn,,2018,3.9,7635,7941,306
55129,WI,Washburn,,2019,3.9,7546,7850,304
55129,WI,Washburn,,2020,6.9,7334,7878,544
55129,WI,Washburn,,2021,4.5,7621,7983,362
55131,WI,Washington,,2007,4.2,70721,73847,3126
55131,WI,Washington,,2008,4.4,71361,74643,3282
55131,WI,Washington,,2009,9.1,68312,75133,6821
55131,WI,Washington,,2010,7.9,69648,75652,6004
55131,WI,Washington,,2011,6.7,70108,75115,5007
55131,WI,Washington,,2012,6,70463,74981,4518
55131,WI,Washington,,2013,5.7,70976,75244,4268
55131,WI,Washington,,2014,4.5,72299,75688,3389
55131,WI,Washington,,2015,3.7,73109,75890,2781
55131,WI,Washington,,2016,3.3,74493,77012,2519
55131,WI,Washington,,2017,2.8,75813,77965,2152
55131,WI,Washington,,2018,2.5,75867,77835,1968
55131,WI,Washington,,2019,2.7,75579,77692,2113
55131,WI,Washington,,2020,5.7,72478,76822,4344
55131,WI,Washington,,2021,3.1,74781,77152,2371
55133,WI,Waukesha,,2007,4,205727,214237,8510
55133,WI,Waukesha,,2008,4,206260,214939,8679
55133,WI,Waukesha,,2009,7.9,196928,213797,16869
55133,WI,Waukesha,,2010,7.2,202455,218197,15742
55133,WI,Waukesha,,2011,6.3,203655,217340,13685
55133,WI,Waukesha,,2012,5.7,205067,217385,12318
55133,WI,Waukesha,,2013,5.5,207001,218987,11986
55133,WI,Waukesha,,2014,4.4,210721,220344,9623
55133,WI,Waukesha,,2015,3.7,212689,220891,8202
55133,WI,Waukesha,,2016,3.4,216710,224280,7570
55133,WI,Waukesha,,2017,2.9,220266,226787,6521
55133,WI,Waukesha,,2018,2.6,220529,226496,5967
55133,WI,Waukesha,,2019,2.8,220051,226336,6285
55133,WI,Waukesha,,2020,5.6,211634,224176,12542
55133,WI,Waukesha,,2021,3.1,218557,225548,6991
55135,WI,Waupaca,,2007,5.2,26716,28190,1474
55135,WI,Waupaca,,2008,5.4,26588,28106,1518
55135,WI,Waupaca,,2009,10,25655,28508,2853
55135,WI,Waupaca,,2010,9.3,25180,27748,2568
55135,WI,Waupaca,,2011,8.1,25392,27635,2243
55135,WI,Waupaca,,2012,7.5,25310,27351,2041
55135,WI,Waupaca,,2013,7.3,25362,27345,1983
55135,WI,Waupaca,,2014,5.6,25765,27287,1522
55135,WI,Waupaca,,2015,4.5,25748,26970,1222
55135,WI,Waupaca,,2016,3.9,25864,26902,1038
55135,WI,Waupaca,,2017,3.2,25833,26675,842
55135,WI,Waupaca,,2018,2.9,25575,26345,770
55135,WI,Waupaca,,2019,3.1,25207,26015,808
55135,WI,Waupaca,,2020,5.6,24368,25800,1432
55135,WI,Waupaca,,2021,3.5,25262,26182,920
55137,WI,Waushara,,2007,5.7,11985,12715,730
55137,WI,Waushara,,2008,5.9,11983,12740,757
55137,WI,Waushara,,2009,10.3,11574,12910,1336
55137,WI,Waushara,,2010,10.6,10755,12028,1273
55137,WI,Waushara,,2011,9.6,10749,11884,1135
55137,WI,Waushara,,2012,8.6,10968,12000,1032
55137,WI,Waushara,,2013,8.5,10816,11822,1006
55137,WI,Waushara,,2014,7.1,10782,11600,818
55137,WI,Waushara,,2015,6.1,10751,11454,703
55137,WI,Waushara,,2016,4.9,10886,11447,561
55137,WI,Waushara,,2017,3.9,10994,11445,451
55137,WI,Waushara,,2018,3.4,11240,11641,401
55137,WI,Waushara,,2019,3.9,11026,11470,444
55137,WI,Waushara,,2020,6.4,10404,11116,712
55137,WI,Waushara,,2021,4.2,10913,11394,481
55139,WI,Winnebago,,2007,4.5,89486,93680,4194
55139,WI,Winnebago,,2008,4.4,90394,94585,4191
55139,WI,Winnebago,,2009,8,87892,95576,7684
55139,WI,Winnebago,,2010,7.6,85419,92492,7073
55139,WI,Winnebago,,2011,6.9,85864,92192,6328
55139,WI,Winnebago,,2012,6.6,86346,92400,6054
55139,WI,Winnebago,,2013,6.3,85832,91645,5813
55139,WI,Winnebago,,2014,5.1,86781,91483,4702
55139,WI,Winnebago,,2015,4.1,87453,91233,3780
55139,WI,Winnebago,,2016,3.5,89604,92838,3234
55139,WI,Winnebago,,2017,3,91113,93894,2781
55139,WI,Winnebago,,2018,2.7,89949,92461,2512
55139,WI,Winnebago,,2019,2.9,89227,91860,2633
55139,WI,Winnebago,,2020,5.5,87328,92380,5052
55139,WI,Winnebago,,2021,3.2,90123,93109,2986
55141,WI,Wood,,2007,5.2,39738,41920,2182
55141,WI,Wood,,2008,5.5,39838,42148,2310
55141,WI,Wood,,2009,9.2,38187,42046,3859
55141,WI,Wood,,2010,9.1,36337,39985,3648
55141,WI,Wood,,2011,8.1,36663,39906,3243
55141,WI,Wood,,2012,7.4,36722,39666,2944
55141,WI,Wood,,2013,7.2,36178,38995,2817
55141,WI,Wood,,2014,6.6,32431,34716,2285
55141,WI,Wood,,2015,5.4,32481,34328,1847
55141,WI,Wood,,2016,4.6,32929,34518,1589
55141,WI,Wood,,2017,3.7,33816,35117,1301
55141,WI,Wood,,2018,3.4,34134,35339,1205
55141,WI,Wood,,2019,3.6,33968,35249,1281
55141,WI,Wood,,2020,6.7,32511,34855,2344
55141,WI,Wood,,2021,4.4,33241,34769,1528
56000,WY,Wyoming,,2007,2.6,283072,290748,7676
56000,WY,Wyoming,,2008,2.9,287909,296620,8711
56000,WY,Wyoming,,2009,6.3,281123,299893,18770
56000,WY,Wyoming,,2010,6.9,280953,301893,20940
56000,WY,Wyoming,,2011,6.2,284273,302932,18659
56000,WY,Wyoming,,2012,5.5,287110,303748,16638
56000,WY,Wyoming,,2013,4.8,287792,302201,14409
56000,WY,Wyoming,,2014,4.3,289694,302865,13171
56000,WY,Wyoming,,2015,4.2,288894,301608,12714
56000,WY,Wyoming,,2016,5.4,284439,300546,16107
56000,WY,Wyoming,,2017,4.3,281164,293802,12638
56000,WY,Wyoming,,2018,4.1,280909,292781,11872
56000,WY,Wyoming,,2019,3.7,283377,294380,11003
56000,WY,Wyoming,,2020,5.8,276739,293722,16983
56000,WY,Wyoming,,2021,4.5,277372,290404,13032
56001,WY,Albany,,2007,2.3,18386,18812,426
56001,WY,Albany,,2008,2.4,18669,19134,465
56001,WY,Albany,,2009,4.1,18880,19694,814
56001,WY,Albany,,2010,4.8,20224,21248,1024
56001,WY,Albany,,2011,4.5,20574,21536,962
56001,WY,Albany,,2012,4.4,19586,20493,907
56001,WY,Albany,,2013,3.8,19620,20392,772
56001,WY,Albany,,2014,3.6,19516,20251,735
56001,WY,Albany,,2015,3.1,19836,20471,635
56001,WY,Albany,,2016,3.2,20299,20975,676
56001,WY,Albany,,2017,3,19914,20520,606
56001,WY,Albany,,2018,3.3,19773,20450,677
56001,WY,Albany,,2019,3.2,19862,20511,649
56001,WY,Albany,,2020,3.7,19810,20572,762
56001,WY,Albany,,2021,3.3,20086,20767,681
56003,WY,Big Horn,,2007,3.8,4744,4931,187
56003,WY,Big Horn,,2008,3.9,4792,4984,192
56003,WY,Big Horn,,2009,8.6,4624,5059,435
56003,WY,Big Horn,,2010,7.2,5203,5606,403
56003,WY,Big Horn,,2011,6.5,5303,5669,366
56003,WY,Big Horn,,2012,5.8,5250,5573,323
56003,WY,Big Horn,,2013,5.2,5214,5502,288
56003,WY,Big Horn,,2014,4.7,5257,5517,260
56003,WY,Big Horn,,2015,4.4,5272,5513,241
56003,WY,Big Horn,,2016,5,5263,5540,277
56003,WY,Big Horn,,2017,4.4,5140,5375,235
56003,WY,Big Horn,,2018,4.7,5040,5290,250
56003,WY,Big Horn,,2019,4.5,4993,5226,233
56003,WY,Big Horn,,2020,5,5028,5293,265
56003,WY,Big Horn,,2021,4.4,5081,5316,235
56005,WY,Campbell,,2007,1.9,25859,26358,499
56005,WY,Campbell,,2008,1.9,27161,27681,520
56005,WY,Campbell,,2009,5.3,27262,28789,1527
56005,WY,Campbell,,2010,6.5,24466,26165,1699
56005,WY,Campbell,,2011,5.2,24202,25536,1334
56005,WY,Campbell,,2012,4.8,24580,25814,1234
56005,WY,Campbell,,2013,4.3,24242,25328,1086
56005,WY,Campbell,,2014,3.5,25033,25946,913
56005,WY,Campbell,,2015,3.9,24606,25599,993
56005,WY,Campbell,,2016,7.2,22648,24415,1767
56005,WY,Campbell,,2017,5,21934,23092,1158
56005,WY,Campbell,,2018,4.1,22156,23103,947
56005,WY,Campbell,,2019,3.8,22424,23314,890
56005,WY,Campbell,,2020,6.8,21591,23166,1575
56005,WY,Campbell,,2021,5.3,20842,22000,1158
56007,WY,Carbon,,2007,2.7,8128,8355,227
56007,WY,Carbon,,2008,3.1,8100,8360,260
56007,WY,Carbon,,2009,7.2,7375,7943,568
56007,WY,Carbon,,2010,7.2,7623,8218,595
56007,WY,Carbon,,2011,6.3,7544,8054,510
56007,WY,Carbon,,2012,5.3,7687,8120,433
56007,WY,Carbon,,2013,4.4,7897,8257,360
56007,WY,Carbon,,2014,4.2,7993,8342,349
56007,WY,Carbon,,2015,3.7,8061,8368,307
56007,WY,Carbon,,2016,4.7,7969,8363,394
56007,WY,Carbon,,2017,4.1,7597,7924,327
56007,WY,Carbon,,2018,3.7,7592,7887,295
56007,WY,Carbon,,2019,3.5,7527,7799,272
56007,WY,Carbon,,2020,4.6,7562,7925,363
56007,WY,Carbon,,2021,3.9,7579,7884,305
56009,WY,Converse,,2007,2.7,6806,6993,187
56009,WY,Converse,,2008,2.6,7232,7428,196
56009,WY,Converse,,2009,5.7,7196,7629,433
56009,WY,Converse,,2010,5.9,7085,7528,443
56009,WY,Converse,,2011,5.1,7170,7558,388
56009,WY,Converse,,2012,4.4,7534,7883,349
56009,WY,Converse,,2013,3.7,7695,7991,296
56009,WY,Converse,,2014,3.2,7980,8241,261
56009,WY,Converse,,2015,3.6,7949,8247,298
56009,WY,Converse,,2016,6.3,7385,7879,494
56009,WY,Converse,,2017,4.6,7159,7503,344
56009,WY,Converse,,2018,3.7,7390,7673,283
56009,WY,Converse,,2019,2.9,8406,8658,252
56009,WY,Converse,,2020,5.9,7528,8000,472
56009,WY,Converse,,2021,4.9,7132,7496,364
56011,WY,Crook,,2007,2.6,3358,3447,89
56011,WY,Crook,,2008,2.8,3422,3520,98
56011,WY,Crook,,2009,5.6,3391,3594,203
56011,WY,Crook,,2010,5.4,3678,3887,209
56011,WY,Crook,,2011,5.2,3636,3834,198
56011,WY,Crook,,2012,5,3580,3769,189
56011,WY,Crook,,2013,4.5,3475,3638,163
56011,WY,Crook,,2014,4.1,3519,3668,149
56011,WY,Crook,,2015,3.5,3552,3679,127
56011,WY,Crook,,2016,4.6,3567,3740,173
56011,WY,Crook,,2017,3.6,3560,3694,134
56011,WY,Crook,,2018,3.2,3620,3741,121
56011,WY,Crook,,2019,3.3,3622,3745,123
56011,WY,Crook,,2020,3.9,3693,3841,148
56011,WY,Crook,,2021,3.4,3704,3833,129
56013,WY,Fremont,,2007,3.5,17504,18142,638
56013,WY,Fremont,,2008,3.9,17865,18598,733
56013,WY,Fremont,,2009,7.6,17766,19235,1469
56013,WY,Fremont,,2010,7.5,19321,20890,1569
56013,WY,Fremont,,2011,6.9,19519,20955,1436
56013,WY,Fremont,,2012,6.2,19726,21034,1308
56013,WY,Fremont,,2013,5.8,19553,20746,1193
56013,WY,Fremont,,2014,5.2,19273,20333,1060
56013,WY,Fremont,,2015,5.5,18977,20074,1097
56013,WY,Fremont,,2016,7.2,18591,20040,1449
56013,WY,Fremont,,2017,5.7,18306,19414,1108
56013,WY,Fremont,,2018,5.2,17993,18986,993
56013,WY,Fremont,,2019,4.6,17941,18798,857
56013,WY,Fremont,,2020,6.2,17833,19017,1184
56013,WY,Fremont,,2021,4.7,18039,18927,888
56015,WY,Goshen,,2007,3,5765,5946,181
56015,WY,Goshen,,2008,3.4,5944,6153,209
56015,WY,Goshen,,2009,5.3,5974,6309,335
56015,WY,Goshen,,2010,5.3,7062,7456,394
56015,WY,Goshen,,2011,5.1,7156,7540,384
56015,WY,Goshen,,2012,4.8,7066,7424,358
56015,WY,Goshen,,2013,4.2,6921,7227,306
56015,WY,Goshen,,2014,3.8,6791,7057,266
56015,WY,Goshen,,2015,3.2,6795,7023,228
56015,WY,Goshen,,2016,3.5,6784,7029,245
56015,WY,Goshen,,2017,3,6734,6940,206
56015,WY,Goshen,,2018,3.3,6633,6861,228
56015,WY,Goshen,,2019,3.8,6232,6479,247
56015,WY,Goshen,,2020,4.3,6225,6505,280
56015,WY,Goshen,,2021,3.5,6304,6531,227
56017,WY,Hot Springs,,2007,3.1,2309,2383,74
56017,WY,Hot Springs,,2008,3.2,2364,2441,77
56017,WY,Hot Springs,,2009,5.8,2387,2535,148
56017,WY,Hot Springs,,2010,5.6,2411,2555,144
56017,WY,Hot Springs,,2011,5.4,2427,2565,138
56017,WY,Hot Springs,,2012,4.9,2424,2548,124
56017,WY,Hot Springs,,2013,4.8,2400,2520,120
56017,WY,Hot Springs,,2014,4.4,2352,2459,107
56017,WY,Hot Springs,,2015,4.1,2282,2380,98
56017,WY,Hot Springs,,2016,4.8,2308,2425,117
56017,WY,Hot Springs,,2017,4,2245,2339,94
56017,WY,Hot Springs,,2018,3.7,2157,2239,82
56017,WY,Hot Springs,,2019,3.6,2116,2194,78
56017,WY,Hot Springs,,2020,4.9,2119,2229,110
56017,WY,Hot Springs,,2021,3.9,2159,2246,87
56019,WY,Johnson,,2007,3.1,3821,3944,123
56019,WY,Johnson,,2008,3.2,3969,4099,130
56019,WY,Johnson,,2009,7.4,3791,4095,304
56019,WY,Johnson,,2010,7.4,4184,4516,332
56019,WY,Johnson,,2011,6.6,4163,4458,295
56019,WY,Johnson,,2012,5.5,4178,4420,242
56019,WY,Johnson,,2013,5.1,4187,4413,226
56019,WY,Johnson,,2014,4.7,4221,4430,209
56019,WY,Johnson,,2015,4.8,3966,4167,201
56019,WY,Johnson,,2016,5.4,3981,4207,226
56019,WY,Johnson,,2017,4.3,4027,4208,181
56019,WY,Johnson,,2018,4,4085,4255,170
56019,WY,Johnson,,2019,3.8,4012,4169,157
56019,WY,Johnson,,2020,5.5,3944,4173,229
56019,WY,Johnson,,2021,4.1,4068,4242,174
56021,WY,Laramie,,2007,3.3,41014,42425,1411
56021,WY,Laramie,,2008,3.8,41382,42995,1613
56021,WY,Laramie,,2009,6.4,40998,43806,2808
56021,WY,Laramie,,2010,7.2,42668,45971,3303
56021,WY,Laramie,,2011,6.6,43522,46585,3063
56021,WY,Laramie,,2012,5.9,44376,47168,2792
56021,WY,Laramie,,2013,4.8,45571,47889,2318
56021,WY,Laramie,,2014,4.5,46027,48216,2189
56021,WY,Laramie,,2015,3.9,46341,48225,1884
56021,WY,Laramie,,2016,4.2,46765,48803,2038
56021,WY,Laramie,,2017,3.8,46519,48342,1823
56021,WY,Laramie,,2018,3.9,46535,48410,1875
56021,WY,Laramie,,2019,3.6,47695,49452,1757
56021,WY,Laramie,,2020,5.1,47565,50114,2549
56021,WY,Laramie,,2021,4,47397,49373,1976
56023,WY,Lincoln,,2007,2.4,8811,9024,213
56023,WY,Lincoln,,2008,3.4,8184,8471,287
56023,WY,Lincoln,,2009,7.7,7756,8407,651
56023,WY,Lincoln,,2010,9,7869,8652,783
56023,WY,Lincoln,,2011,8.3,7921,8641,720
56023,WY,Lincoln,,2012,7.4,7583,8186,603
56023,WY,Lincoln,,2013,5.8,7583,8050,467
56023,WY,Lincoln,,2014,5.4,7706,8145,439
56023,WY,Lincoln,,2015,4.7,7955,8343,388
56023,WY,Lincoln,,2016,4.7,8313,8725,412
56023,WY,Lincoln,,2017,3.8,8440,8771,331
56023,WY,Lincoln,,2018,3.8,8488,8824,336
56023,WY,Lincoln,,2019,3.5,8727,9040,313
56023,WY,Lincoln,,2020,5,8831,9294,463
56023,WY,Lincoln,,2021,3.8,9154,9514,360
56025,WY,Natrona,,2007,2.4,39546,40533,987
56025,WY,Natrona,,2008,2.7,40047,41157,1110
56025,WY,Natrona,,2009,6.5,38545,41229,2684
56025,WY,Natrona,,2010,7.5,36745,39724,2979
56025,WY,Natrona,,2011,6.4,37995,40613,2618
56025,WY,Natrona,,2012,5.2,39714,41901,2187
56025,WY,Natrona,,2013,4.6,40539,42485,1946
56025,WY,Natrona,,2014,4.2,41051,42863,1812
56025,WY,Natrona,,2015,4.8,40431,42482,2051
56025,WY,Natrona,,2016,7.2,38073,41016,2943
56025,WY,Natrona,,2017,5.4,37509,39647,2138
56025,WY,Natrona,,2018,4.6,37622,39451,1829
56025,WY,Natrona,,2019,4,38500,40119,1619
56025,WY,Natrona,,2020,7.7,36982,40081,3099
56025,WY,Natrona,,2021,6.1,36688,39057,2369
56027,WY,Niobrara,,2007,2.8,1173,1207,34
56027,WY,Niobrara,,2008,3.2,1208,1248,40
56027,WY,Niobrara,,2009,4.9,1234,1298,64
56027,WY,Niobrara,,2010,4.9,1311,1379,68
56027,WY,Niobrara,,2011,4.4,1315,1375,60
56027,WY,Niobrara,,2012,4,1311,1365,54
56027,WY,Niobrara,,2013,3.5,1312,1360,48
56027,WY,Niobrara,,2014,3.5,1288,1335,47
56027,WY,Niobrara,,2015,3,1278,1317,39
56027,WY,Niobrara,,2016,3.3,1294,1338,44
56027,WY,Niobrara,,2017,2.8,1267,1304,37
56027,WY,Niobrara,,2018,2.8,1251,1287,36
56027,WY,Niobrara,,2019,2.9,1193,1228,35
56027,WY,Niobrara,,2020,3.6,1188,1233,45
56027,WY,Niobrara,,2021,3.6,1214,1259,45
56029,WY,Park,,2007,2.9,13871,14291,420
56029,WY,Park,,2008,3.4,14103,14597,494
56029,WY,Park,,2009,6.1,13987,14899,912
56029,WY,Park,,2010,6.6,14730,15772,1042
56029,WY,Park,,2011,6.1,14913,15888,975
56029,WY,Park,,2012,5.7,15157,16075,918
56029,WY,Park,,2013,5.1,14832,15636,804
56029,WY,Park,,2014,4.7,14842,15569,727
56029,WY,Park,,2015,4.2,14974,15637,663
56029,WY,Park,,2016,4.8,15174,15931,757
56029,WY,Park,,2017,4.4,15045,15735,690
56029,WY,Park,,2018,4.4,14979,15663,684
56029,WY,Park,,2019,4.2,14720,15366,646
56029,WY,Park,,2020,5.4,14385,15203,818
56029,WY,Park,,2021,4.1,14926,15562,636
56031,WY,Platte,,2007,3.8,3820,3969,149
56031,WY,Platte,,2008,3.9,3833,3988,155
56031,WY,Platte,,2009,6,3888,4136,248
56031,WY,Platte,,2010,6,4644,4938,294
56031,WY,Platte,,2011,5.3,4637,4898,261
56031,WY,Platte,,2012,5.1,4493,4732,239
56031,WY,Platte,,2013,4.4,4525,4735,210
56031,WY,Platte,,2014,4,4534,4725,191
56031,WY,Platte,,2015,3.9,4683,4871,188
56031,WY,Platte,,2016,4.8,4544,4775,231
56031,WY,Platte,,2017,3.8,4605,4787,182
56031,WY,Platte,,2018,3.7,4625,4805,180
56031,WY,Platte,,2019,3.6,4403,4567,164
56031,WY,Platte,,2020,5,4351,4580,229
56031,WY,Platte,,2021,4,4327,4508,181
56033,WY,Sheridan,,2007,2.7,15461,15883,422
56033,WY,Sheridan,,2008,3,15763,16244,481
56033,WY,Sheridan,,2009,6.7,15386,16494,1108
56033,WY,Sheridan,,2010,7.9,14804,16066,1262
56033,WY,Sheridan,,2011,7.3,14706,15869,1163
56033,WY,Sheridan,,2012,6.4,14720,15726,1006
56033,WY,Sheridan,,2013,5.6,14701,15565,864
56033,WY,Sheridan,,2014,4.9,14963,15726,763
56033,WY,Sheridan,,2015,4.2,15139,15799,660
56033,WY,Sheridan,,2016,4.7,15363,16127,764
56033,WY,Sheridan,,2017,4,15205,15843,638
56033,WY,Sheridan,,2018,4.1,15165,15806,641
56033,WY,Sheridan,,2019,3.7,15020,15592,572
56033,WY,Sheridan,,2020,4.9,15210,16002,792
56033,WY,Sheridan,,2021,4.2,15344,16018,674
56035,WY,Sublette,,2007,1.4,6619,6711,92
56035,WY,Sublette,,2008,1.6,6988,7099,111
56035,WY,Sublette,,2009,4.4,6972,7291,319
56035,WY,Sublette,,2010,6.3,5305,5662,357
56035,WY,Sublette,,2011,4.9,5540,5823,283
56035,WY,Sublette,,2012,5,5230,5507,277
56035,WY,Sublette,,2013,4.8,4770,5008,238
56035,WY,Sublette,,2014,4.5,4601,4817,216
56035,WY,Sublette,,2015,5.1,4298,4531,233
56035,WY,Sublette,,2016,6.5,3958,4232,274
56035,WY,Sublette,,2017,4.6,4071,4268,197
56035,WY,Sublette,,2018,4.3,4086,4269,183
56035,WY,Sublette,,2019,4.7,3891,4083,192
56035,WY,Sublette,,2020,7.2,3730,4020,290
56035,WY,Sublette,,2021,5.6,3766,3990,224
56037,WY,Sweetwater,,2007,2.1,23566,24068,502
56037,WY,Sweetwater,,2008,2.3,23997,24557,560
56037,WY,Sweetwater,,2009,6.3,22764,24307,1543
56037,WY,Sweetwater,,2010,7.1,21395,23023,1628
56037,WY,Sweetwater,,2011,5.6,22261,23578,1317
56037,WY,Sweetwater,,2012,4.9,22684,23856,1172
56037,WY,Sweetwater,,2013,4.4,22499,23539,1040
56037,WY,Sweetwater,,2014,4.2,22061,23026,965
56037,WY,Sweetwater,,2015,4.6,21509,22556,1047
56037,WY,Sweetwater,,2016,6.1,20794,22140,1346
56037,WY,Sweetwater,,2017,4.7,20612,21620,1008
56037,WY,Sweetwater,,2018,4.2,20486,21383,897
56037,WY,Sweetwater,,2019,4,20430,21285,855
56037,WY,Sweetwater,,2020,7.3,18998,20503,1505
56037,WY,Sweetwater,,2021,5.6,18360,19449,1089
56039,WY,Teton,,2007,2.1,14288,14589,301
56039,WY,Teton,,2008,2.8,14214,14623,409
56039,WY,Teton,,2009,6.9,12917,13874,957
56039,WY,Teton,,2010,8.3,12446,13568,1122
56039,WY,Teton,,2011,8,12404,13476,1072
56039,WY,Teton,,2012,6.9,12710,13650,940
56039,WY,Teton,,2013,5.7,13120,13906,786
56039,WY,Teton,,2014,4.9,13579,14272,693
56039,WY,Teton,,2015,3.8,14016,14574,558
56039,WY,Teton,,2016,3.5,14715,15247,532
56039,WY,Teton,,2017,2.9,15007,15457,450
56039,WY,Teton,,2018,3,15002,15467,465
56039,WY,Teton,,2019,2.8,15417,15867,450
56039,WY,Teton,,2020,5.9,14251,15138,887
56039,WY,Teton,,2021,3.2,15375,15886,511
56041,WY,Uinta,,2007,2.5,10996,11277,281
56041,WY,Uinta,,2008,2.8,11321,11645,324
56041,WY,Uinta,,2009,6.7,10788,11561,773
56041,WY,Uinta,,2010,7.6,9718,10512,794
56041,WY,Uinta,,2011,6.6,9380,10041,661
56041,WY,Uinta,,2012,5.8,9562,10146,584
56041,WY,Uinta,,2013,5.3,9295,9817,522
56041,WY,Uinta,,2014,5,9281,9774,493
56041,WY,Uinta,,2015,4.9,9120,9593,473
56041,WY,Uinta,,2016,5.8,8876,9426,550
56041,WY,Uinta,,2017,4.7,8703,9132,429
56041,WY,Uinta,,2018,4.3,8676,9070,394
56041,WY,Uinta,,2019,4,8852,9219,367
56041,WY,Uinta,,2020,6.3,8532,9102,570
56041,WY,Uinta,,2021,5,8389,8832,443
56043,WY,Washakie,,2007,3.2,4115,4253,138
56043,WY,Washakie,,2008,3.4,4191,4338,147
56043,WY,Washakie,,2009,6,4136,4400,264
56043,WY,Washakie,,2010,6.4,4276,4566,290
56043,WY,Washakie,,2011,5.9,4263,4530,267
56043,WY,Washakie,,2012,5.3,4198,4435,237
56043,WY,Washakie,,2013,5,4085,4300,215
56043,WY,Washakie,,2014,4.5,4036,4228,192
56043,WY,Washakie,,2015,4.1,4058,4233,175
56043,WY,Washakie,,2016,4.8,4013,4214,201
56043,WY,Washakie,,2017,4.1,3954,4125,171
56043,WY,Washakie,,2018,4.2,3904,4077,173
56043,WY,Washakie,,2019,4.2,3717,3878,161
56043,WY,Washakie,,2020,5.2,3739,3945,206
56043,WY,Washakie,,2021,4,3819,3978,159
56045,WY,Weston,,2007,3,3109,3204,95
56045,WY,Weston,,2008,3.1,3162,3262,100
56045,WY,Weston,,2009,6.2,3107,3311,204
56045,WY,Weston,,2010,5.2,3784,3992,208
56045,WY,Weston,,2011,4.8,3723,3911,188
56045,WY,Weston,,2012,4.2,3761,3925,164
56045,WY,Weston,,2013,3.6,3758,3899,141
56045,WY,Weston,,2014,3.5,3789,3925,136
56045,WY,Weston,,2015,3.4,3798,3930,132
56045,WY,Weston,,2016,5,3761,3960,199
56045,WY,Weston,,2017,4.1,3611,3765,154
56045,WY,Weston,,2018,3.5,3652,3786,134
56045,WY,Weston,,2019,3,3679,3793,114
56045,WY,Weston,,2020,3.8,3645,3789,144
56045,WY,Weston,,2021,3.2,3622,3741,119
